author,comments,downvotes,id,score,selftext,title,upvotes
Nerdikki,11734,8247,1qv6q6,2688,Collated list top  CPRhttpwwwredditcomrAskRedditcommentsqvqseriouswhatisaskillthatmostpeoplecouldcdgur Basic cooking skillshttpwwwredditcomrAskRedditcommentsqvqseriouswhatisaskillthatmostpeoplecouldcdgvp Routine car maintenancehttpwwwredditcomrAskRedditcommentsqvqseriouswhatisaskillthatmostpeoplecouldcdgts SwimminghttpwwwredditcomrAskRedditcommentsqvqseriouswhatisaskillthatmostpeoplecouldcdgutr How to type properlyhttpwwwredditcomrAskRedditcommentsqvqseriouswhatisaskillthatmostpeoplecouldcdguiz Basic economicshttpwwwredditcomrAskRedditcommentsqvqseriouswhatisaskillthatmostpeoplecouldcdgtz Basic lock pickinghttpwwwredditcomrAskRedditcommentsqvqseriouswhatisaskillthatmostpeoplecouldcdgvuex How to tie knotshttpwwwredditcomrAskRedditcommentsqvqseriouswhatisaskillthatmostpeoplecouldcdgy How to build a PChttpwwwredditcomrAskRedditcommentsqvqseriouswhatisaskillthatmostpeoplecouldcdgtyzi How to properly tie a tiehttpwwwredditcomrAskRedditcommentsqvqseriouswhatisaskillthatmostpeoplecouldcdgvml How to drive stick shifthttpwwwredditcomrAskRedditcommentsqvqseriouswhatisaskillthatmostpeoplecouldcdgutzf Good communicationhttpwwwredditcomrAskRedditcommentsqvqseriouswhatisaskillthatmostpeoplecouldcdhlg Effective use of Google searcheshttpwwwredditcomrAskRedditcommentsqvqseriouswhatisaskillthatmostpeoplecouldcdgyfz How to make one good cocktailhttpwwwredditcomrAskRedditcommentsqvqseriouswhatisaskillthatmostpeoplecouldcdgwlnr Cunnilingus ಠಠhttpwwwredditcomrAskRedditcommentsqvqseriouswhatisaskillthatmostpeoplecouldcdgum Learning to learnhttpwwwredditcomrAskRedditcommentsqvqseriouswhatisaskillthatmostpeoplecouldcdgzqc How to listenhttpwwwredditcomrAskRedditcommentsqvqseriouswhatisaskillthatmostpeoplecouldcdgui Recognizing basic logic rules and fallacieshttpwwwredditcomrAskRedditcommentsqvqseriouswhatisaskillthatmostpeoplecouldcdgybnx Sewing httpwwwredditcomrAskRedditcommentsqvqseriouswhatisaskillthatmostpeoplecouldcdhe How to be a good liarhttpwwwredditcomrAskRedditcommentsqvqseriouswhatisaskillthatmostpeoplecouldcdgy How to budgethttpwwwredditcomrAskRedditcommentsqvqseriouswhatisaskillthatmostpeoplecouldcdhgpe Critical thinkinghttpwwwredditcomrAskRedditcommentsqvqseriouswhatisaskillthatmostpeoplecouldcdgzozq How to talk to new peoplehttpwwwredditcomrAskRedditcommentsqvqseriouswhatisaskillthatmostpeoplecouldcdgzczs OrganizationhttpwwwredditcomrAskRedditcommentsqvqseriouswhatisaskillthatmostpeoplecouldcdgvxa Basic gun safetyhttpwwwredditcomrAskRedditcommentsqvqseriouswhatisaskillthatmostpeoplecouldcdgxgsx Knowing your rights during a police stophttpwwwredditcomrAskRedditcommentsqvqseriouswhatisaskillthatmostpeoplecouldcdgxgsx Basic mathhttpwwwredditcomrAskRedditcommentsqvqseriouswhatisaskillthatmostpeoplecouldcdgyhg Microsoft OfficehttpwwwredditcomrAskRedditcommentsqvqseriouswhatisaskillthatmostpeoplecouldcdgyc How to play  basic chords on guitarhttpwwwredditcomrAskRedditcommentsqvqseriouswhatisaskillthatmostpeoplecouldcdgzr Basic programmingscriptinghttpwwwredditcomrAskRedditcommentsqvqseriouswhatisaskillthatmostpeoplecouldcdgwx,Serious What is a skill that most people could learn within a matter of days that would prove the most useful,10935
holdingmyheart,24984,6410,1qr47w,2488,,What did you always assume was normal until you found out it wasnt,8898
callux,12217,7233,1qwcdl,2390,,Whats the luckiest thing thats ever happened to you,9623
StrikeAnywherePanda,16780,8043,1r21h6,2313,,What is something you wish you could experience again for the first time,10356
bigboy,10851,6805,1qz709,2314,,Whats your biggest I dodged a bullet moment,9119
caitlynne,7172,7281,1qr9hf,2290,Super late but obligatory edit Holy front page I was hoping for maybe  replies tops Thread turned into mostly bitching about siblings but I enjoyed reading everyones stories and sympathize ,Parents of Reddit when did you realize it wasnt just teenage hormones your kid is a legitimate asshole,9571
ThorsFather,3320,2639,1r28kb,2273,Your favourite drink  EDIT  Wow more responses I could have hoped for Ill be busy for the next months thanks for all the suggestions,Bartenders of Reddit Whats the best drink weve never had ,4912
BattleSausage,15608,3601,1r20ug,2259,Please add any alternatives you might recommend over the brand that lost its luster,What brands or products no longer have the quality they were once known for,5860
dDeoxyribo,10570,7680,1r7lxf,2253,,What is your favorite paradox,9933
minecraft,16794,14032,1r506o,2226,,What is the best quote you have ever seen read and or heard,16258
CaptainWatermelons,15025,5000,1qtm2h,2088,,What is the most noteworthy thing an ancestor of yours has done,7088
killerontheloose,13387,6612,1r2b9l,2162,,whats the most insulting thing you ever said to somebody,8774
bartha,14232,3640,1r57m0,2152,,What university degree do you have and what job position do you now hold,5792
JeffreyJackoff,10129,5485,1r3tf9,2126,I hate you all,Which sitcom from any era had a serious episode that particularly stood out to you,7611
KarmicCosmonaut,10029,5549,1qw43c,2079,,Redditors in a relationship what white lies do you tell your SO and why,7628
kkkisbad,8216,11320,1qu6is,2053,,SERIOUS Reddit what are stories about picture perfect families who do fked up stuff behind closed doors,13373
YogaButt,7739,10652,1r034d,2049,SERIOUS replies onlyEdit Thanks for up voting this to the front page guys And for all your creepy stories Even if youre all lying its still great entertainment Youre the best I feel like Im experiencing the greatest episode of Unsolved Mysteries ,Alien abductees of reddit or people who have claimed to see a UFO whats your story,12701
hitmanzulu,15963,11413,1r15p9,2032,,What is the most fucked up shit youve seen at a party,13445
JEZTURNER,13359,13439,1qyxjx,1982,EDIT Wow front page Did not expect this especially as this askreddit is only slightly different to one I did a few months ago Thanks everyone And a few people getting gold too nice ,Whats the most amusing new film we can come up with by adding a letter to an existing title,15421
Coolspot,4630,2216,1quekx,1961,,Who in your opinion has died the most horrible death in history,4177
Bhighkin,7259,6883,1qs3yr,1951,Obviously Im not asking for names of rock stars but I was thinking that if we hear stories about how many hundreds and even thousands of women these rock stars had sex with then there have to be some with a story or two  Im going to go ahead and make this NSFW to be on the safe side,Former groupies of Reddit what was your experience NSFW,8834
GiroudWheresMyCar,4846,4558,1qtdm0,1921,Front Page would like to dedicate this to Tom Giles for his continuing support and advice in all reddit related matters  ,Teachers of Reddit what is a teacherparent meeting that will haunt you for life,6479
Xinthose,6538,3045,1r2jz4,1797,,What is the most WTF thing you have seen in real life NSFW,4842
wixom,1978,1391,1qrvqx,1773,Wow thanks for all the feedback Ill have fun not sleeping tonight after reading them all,Whats the creepiest Wikipedia article youve ever read,3164
SerbuSauce,5891,12058,1qxr57,1735,Huh never knew about pansexuality TIL ,If sexual orientation was a choice what would be some of the recruitment slogans for each side,13793
smellsofrichmahogany,9625,7591,1qsz1j,1733,,Girls of reddit whats something guys think they do sneakily but you always notice,9324
clydesmooth,9431,5260,1qwcyt,1705,From basic etiquette to more obscure EDIT Obligatory front page edit I honestly didnt expect this to blow up First time on the front page ,What are some sex etiquette rules that you think everyone should be aware of,6965
aoifesuz,9385,2235,1qw707,1687,,What is a commonly said phrase that you consider to be complete bullshit,3922
freckleface,2158,1926,1qr8ps,1667,Honestly I should have probably asked this question in some people still write checks though right ,Bank Tellers of Reddit what is the funniest or most odd thing youve ever seen written on the for line of a check,3593
fokclown,1291,999,1qv6w0,1661,,What is the best answer for why should we hire you in a job interview,2660
peppermint,5553,2093,1r6176,1639,Edit My SO is going to be so surprised the next time were bored and I make a suggestion on what to do Im glad all of you found your quirky other half ,Whats the weirdest thing youve ever done with your SO NSFW,3732
jeremytatton,3874,1399,1qzatw,1637,,Bartenders of Reddit How do you deal with busting an under with a fake IDWhat is your funniest experience while taking one,3036
daphnebluestrat,6158,1725,1r2iy9,1608,This could be a zombie outbreak a nuclear holocaust whateverthefuckhappenedinTheRoad alien invasion whatever  What valuable skill or possessions do YOU have that would help a merry band of refugees surviveEdit Okay weve got zombie survival stuff down But what about if the world looks like it does in The RoadEdit ITT a lot of leaders And people with guns Thanks for playing all,In a postapocalyptic scenario what do YOU bring to the table,3333
gbpackers,5372,1982,1r7unf,2007,EDIT Wow front page Keep them coming guys ,What was a great idea until you actually did it,3989
ohrashid,2253,1308,1qw7oz,1536,,What are your stories of surprise parties gone wrong,2844
Gunski,2087,1702,1qtubn,1530,,What are some romantic things a guy can do for his girlfriend,3232
douchetree,8006,1948,1r4t8m,1525,Thanks for all the responses guys Im wiping away the tears as we speak,Whats your saddest video game moment,3473
jehoshua,3798,1355,1qus9v,1420,,What is something that you would never do even for billion,2775
literatecaveman,9437,1990,1qrpg4,1408,,If a man with a knife barged into where you are right now with the intention of murdering you whats something within  feet of you that you could use as a weapon,3398
phattykins,3079,1703,1r4xp5,1345,,If you were to sum up a famous movie plot for a five year old how would it go,3048
myers,2643,936,1r6hwg,1284,I always see posts about facts What are your best false facts This could be the most believable the most interesting the most ridiculous etc,Whats the best false fact you can come up with,2220
cmifsud,3694,3238,1qqir9,1268,Specifically hair in the pubic region,Women of Reddit what are your views on male body hair NSFW,4506
volleyballbenj,1550,1208,1r59ii,1261,,Teachers with  years of experience How have kids changed,2469
csamhane,2573,951,1qr6o1,1235,,If you died right this second how long would it take for anyone to realize that you are gone,2186
crackala,2127,615,1qro2j,1206,,What is the most awkward party you have ever attended,1821
ItsGamesDean,6395,1211,1r57br,1148,EDIT In the title replace of with or my thumbs are too fat for the phone,What is a gender stereotype male of female that really sets you off,2359
HOTDAWG,4998,3209,1qu80i,1134,,Men of Reddit if there is one other liquid you could ejaculate other than semen what would it be,4343
Jankub,1603,643,1r5172,1074,,What traits do you find admirable in other people,1717
turtleneck,5494,788,1r45xs,1066,,What is one discontinued product youd like to see brought back,1854
cherieish,2233,655,1qwgte,1049,,Men of Reddit help the ladies out  what do you think would be awesome to receive in your holiday stocking,1704
TheNaud,3210,766,1r7ynr,1335,EDIT Thank you all for your posts so far I am enjoying the stories and memoriesEDIT You guys just keep it rolling You honestly have my gratitude EDIT Alright guys Ive tried to upvote all posts that have come across with a story Thank you again for the entertainment today Stay cool or frozen for my midwesterners,What was your biggest I dont belong here moment,2101
ScootOverNao,1156,774,1qqwxr,995,I dont want to sound creepy not my intention at all Tagged serious because its a genuine curiosity of mine Moms what is it like seeing your sonsDads what is it like seeing your daughters ,Parents with older kids what is it like seeing your kids mature sexually and be sexually attractive serious,1769
nerfherdingcat,3330,577,1qww0h,974,Edit Wow I wasnt expecting so many comments thank you,Whats something an ex has said to you that still effects you,1551
dontcallmedavey,3329,413,1qzo9y,943,,Whats a word or phrase you cant believe people say with a straight face,1356
PotatoPataato,3057,597,1qz9lt,941,,What can you not just have one of,1538
jesterfraud,3449,672,1qr9me,941,A genie appears and grants everyone on earth a superpower provided noone else wishes for the same power What do you choose to gain an advantageEDIT Its not about being first its about being unique,Everyone on earth gets to pick a superpower but it must be unique What do you choose,1613
Unluckydragonborn,1039,530,1r6o32,959,,What is the funniest oneliner you have ever heard or read,1489
graaahh,2682,507,1qwe6g,935,,You can pick any superpower but everyone gets it not just you What do you choose,1442
bhizzel,3990,463,1r2mlo,933,,Reddit what is a product that cost entirely too much for what it is,1396
Magnesia,2352,463,1r2d90,923,,What are some of the nicknames you give people that you always see but dont know,1386
throwaway,2748,549,1r3dy0,915,,If you could choose any fictional job what would you be,1464
HighOnKarmajuana,2061,521,1r5g36,915,,What was the greatest lie ever told,1436
thewildslayer,1924,826,1r2xrf,912,If the show was offlimits with the content they are allowed to broadcast,What NSFW myth would you liked to see the Mythbusters test,1738
Bodangzz,2908,616,1r4ym2,895,Anything that really amazed you ,What is something that blows your mind,1511
neuronsynapse,1771,326,1qtr2t,846,,Whats a cheap amp stressrelieving hobby you would advise anyone to try,1172
ProSchmo,3421,428,1qtof3,783,,What is your most irrational pet peeve,1211
TheGuv,2590,354,1qxw2h,795,,If you were to wake up and realize that overnight you had become a billionaire what is the first thing you would do,1149
stonedstudent,2602,405,1r22g6,786,,In what ways do you notice yourself getting older How do you feel about that,1191
Monkeyboobler,624,562,1qtit3,712,Before I get downvoted into oblivion I am not a homophobe I am pro gay marriage gays giving blood but gays adopting worries me as I think society in some countries isnt ready which will effect the child growing upWere you bullied at school and did it effect youAny events that you and your parents went too were there obvious funny looks from people that didnt know youHonestly did you wish you had a male and female parentChildren with female parents do you think you needed a male role model in the household And vice versaWhen you were going through puberty were there certain things happening that you felt awkward asking your parents about ie Female child with  male parents having your first monthly visitorThe inevitable sex chat what was that likeEDIT Ok was not expecting so many comments on this and all pretty awesome and interesting to read  From what Ive read it seems to be all mainly positive with a few exceptions and your usual family bullshit  Any issues that people do have are mainly down to society and religion when people actually get to know the parents and how well their children are being raised they can accept it This has been mentioned a couple of times but worth a watch httpwwwyoutubecomwatchvFSQQKVufQIm assuming the majority of this is coming for the USA would be interesting to know if anyone has any experience of this in UK Europe and rest of the world,People who were brought up by gay parents male or female what was it like,1274
SpenserHire,3007,304,1qzfwr,688,Since we all seem to talk about video games that waste our time in a bad light What games have you played that your proud to have wasted your time,What video game were you proud to waste so much of your time in,992
Gordonacus,1106,380,1r7qgi,769,After watching the Washington Tornado video it made me realise how recent footage such as that is possible Before we had smart phones very few would load up a video camera and film an oncoming tornado going straight for their houseSo what events in history would be incredible to see through the camera of a normal person ,Serious If society had handheld cameras for the entirety of history which event would be incredible to witness through the camera of a normal person,1149
Secres,754,388,1quecq,679,,Officers of Reddit have you ever pulled over any famous people How did that turn out,1067
adviceanimorph,1239,233,1r4vs7,677,Were talking about real events things that happened to you short stories creepypastas anything really Cmon reddit make us not want to sleep tonightEdit Woohoo Reading material for days Those are GOOD,What are the creepiest scariest stories real or not youve ever heard,910
boonz,1844,380,1r1tj4,650,,What is the greatest Comeback youve ever come up with on the spot,1030
adversarial,3741,405,1qrgnu,653,Should be selfexplanatory but looking for something that is true that our society denies is true through taboos or other means of determining what is socially acceptable to say,Whats something thats true but not socially acceptable to say,1058
arztokal,1385,510,1qupge,619,,If you could replace one thing in history with a dildo what would you replace,1129
randoh,2083,281,1qzbi8,618,edit THANKS for so many hilarious responses There is such a vast number of different jobs of redditors Thanks for commenting Upvotes for all you wonderful peopleedit  Holy crap there are a lot of jobs here It an interesting cross section of the world seeing what you all do and how your job is viewed by you and your fellow workers Thank you so much for sharing I havent gone through all the comments but I think Im up to date on all the replies,If your occupation had a motto or tagline that was painfully truthful what would it be,899
austin,3128,544,1r0twb,608,,Men of Reddit whats the most annoying part about being a guy,1152
DudeWithAHighKD,1875,387,1r53nr,589,,What is your I should be dead story,976
ClownPornFanatic,1951,395,1qvz1w,587,,Who do you think the opposing sides will be in World War ,982
TheDuskDragon,1686,224,1qyl09,576,,What dark history lies within the neighborhood you live in,800
Iamsandonut,1186,252,1r03f2,565,,If it could rain any object occasionally what would be the most inconvenient weather report to hear in the morning,817
tyroneking,2332,401,1qwr9f,568,,Foul spoken redditors Whats your favourite swear word or phrase,969
brovanz,2695,270,1qqgh8,562,,Hey Reddit  what are you genetically gifted with,832
jordosaur,3786,530,1r3mg0,560,,Whats a double standard you hate,1090
LSasquatch,697,150,1quf6k,532,,When has your real excuse been so unbelievable that you had to make up a fake one anyway,682
NXTNaVi,3206,320,1r83gq,776,,Whats the most common way you see people waste money,1096
BouncingDBoobs,1183,453,1r57e0,505,I have heard horror stories about Detroit and the crime rate there Its so bad that I refuse to choose that citys airport even for transit I am just wondering if scenes like those in the movie Robocop where they brutally murder the cop are actually true or is it all fiction Of course this pertains to any city and not just Detroit in generalEDIT  As someone pointed out I left out military personnel in the title Stories from military people are relevant to the topic I just wasnt thinkingEDIT  Since pointed out over and over I now understand that the Detroit airport is not actually in Detroit and it is one of the nicest airports some of the redditors have been to Thanks for the clarification EDIT  Thanks all those who responded I really appreciate you taking the timeAlso a point of clarification It was not my intention to compare degrees of gruesome as might have come across in one of my comments about crimes committed by Jeffrey Dahmer I have lived through some pretty horrible stuff myself and seen and heard  even worse Though I do agree that I shouldnt have described some crimes as worse than what Jeffery Dahmer did just that I have heard enough to build some kind of immunity towards horrible crimes I am still scared but there is too much bad in this world that new things unfolding sometimes dont have that much of an adverse affect as they used to Its a coping mechanism and I dont want to go into too much detail but I felt like I should have clarified on this point,Cops FBI Agents and other law enforcement agents what are some of the most gruesome crimes that you have witnessed NSFW,958
FetusSoup,2261,348,1r29qa,487,Edit You guys are awesome really cheered me up a lot ,At this very moment how is your life going,835
HS,1969,187,1qrfuh,491,,What is your best contrary to popular belief fact,678
Dungeon,1585,228,1qw869,485,Just because Im sure most of us would say a loved ones voice or some sort of music,What is your favorite sound not made by the human voice or a musical instrument,713
ANALPOPCORN,3029,423,1r1r5h,445,,Reddit why do you have that scar,868
zipzap,1335,197,1qzwv7,450,,If all food was free and equally good for you what would you eat,647
indiannajnes,855,234,1r6koz,446,,Whats the most embarrassing thing youve done in the heat of the moment,680
umdmatto,1233,386,1qrwdc,431,,What famous movie line would be the worst to say after sex,817
austin,1191,349,1r3hyy,414,Edit Something really shitty other than just being fired,Whats something really shitty that happened to you while you were at work,763
Knoah,1389,455,1r1fsr,411,The student could be serious or joking,Sex Ed teachers of Reddit what is the weirdest question a student has asked,866
bluemoon,799,179,1r58nc,399, Have there been any reported problems  incidents involving Marijuana consumption More or less Marijuana consumption by young adults than before Is there still a stigma attached to smoking weed has it been lessened since the legalization took effect,Redditors living in Colorado how is legalized Marijuana working out,578
tookmytime,1272,182,1qtn8b,392,It will be more impressive if you were sober but all answers welcome ,What is the loudest biggest most crazy thing you have slept through,574
Usernameisntthatlong,2506,268,1r22i7,387,From boardgames to physical games to video gamesEDIT Lots of video games huh  ,What old game would once again be awesome if remade,655
peepingtm,521,260,1r6qp9,391,,People that have posted pictures of themselves on NSFW subreddits has anyone IRL mentioned that they saw your picture online what did they say and how did you react,651
hoyebr,1717,162,1qziy2,381,,What skill used to be common knowledge but has been dying out recently,543
sweetdeoderant,945,243,1qub7h,375,This weekend I witnessed a man and woman get into an altercation because the man accidentally spilled a bit of his drink onto her They both obviously had a bit to drink so you can imagine it got out of hand fastHe kept trying to leave and ignore her but out of drunken rage she wouldnt let him leave One thing led to another and she started smacking him He pushed her off of him and she fell to the ground easily because of the heels she was wearing It quickly turned into a huge scuffle between the two parties How can a guy get a violent woman off of him without hurting her,How should a male properly respond to a female physically attacking him,618
motherlover,503,248,1qture,376,,Former prostitutes of Reddit have you ever turned down a customer and why,624
helloimrory,1399,241,1qthoz,370,,What is something that isnt taught in schools that you feel should be,611
CapAmerica,3335,349,1r7vvs,467,Just because we are men doesnt mean we cry what was yours,Men of Reddit What movie made YOU cry,816
AThirdFoot,1047,416,1qwqkg,365,,What is the one question you can ask someone to find out if theyre a Redditor without referring to Reddit,781
chiteed,622,178,1qs7zt,365,,Teenagers of Reddit whats the worst most embarrassing thing your parents have done around your friends,543
Asdyc,1494,160,1qtgq6,361,,What is a personality trait that you have that piss a lot of people off,521
austin,809,210,1qqkn8,352,,What inventions are so great that theyll still be used  years down the line,562
Geschichtenerzaehler,361,144,1r4x20,338,,Teachers of Reddit what was the most intelligent most profound thing a student of yours ever asked or replied,482
MothaFuckinMrRogers,1463,149,1qysgn,328,And if you dont know a lot about any one thing in particular weep with me at the realization that you and I have wasted a lot of time in our livesedit wow youre all losers keep them coming,What is something that you know very much about but nobody else seems to know anything about,477
MrAdventures,651,236,1r2lai,318,,Whats one thing you would do for  but not ,554
SiriusLeeSam,1093,133,1r7n6u,342,,What otherwise boring movie is totally worth its ending ,475
SeargentMcTarget,1098,146,1qtg63,311,,What is the most random fact that you know and will never forget,457
ICheifCiggarettes,1482,240,1r51yy,307,Everybody hates advertising But what is the most annoying thing you hate about it,Whats do you hate most about advertising,547
Deceptolon,1579,234,1r7l1q,309,,Whats a threeword sentence you would never want to hear,543
CueTheTrumpets,1073,113,1qz8mj,289,What song no matter how stressed or sad or whatever you are makes you happy and feel better,What is your Everything is going to be fine song,402
ifoundmolly,1614,149,1r3orn,288,,What is the funniest name youve ever heard,437
chrisxcore,1008,594,1qx6k7,282,,Women of Reddit what are the sources of your most unconventional orgasms NSFW obviously,876
Copywrites,1205,115,1r05cf,270,,What is one aspect of internet culture that you cant stand,385
shlongvinoveritas,647,348,1qtodp,266,,Reddit Strippers What do you think of guys who are alone at the strip club,614
dakamon,1171,164,1r4hif,267,I wake up and its on the front of askreddit Thanks guys,What is the scariest truth in ten words or less,431
smellysk,324,106,1qww6z,262,,Redditors what is the best job interview tip you have,368
Scubadude,1099,133,1qwgs0,260,,What angers you most about society,393
billion,405,107,1qul65,247,How did you find out,Parents what secrets does your childteenager keep that you know about,354
lucasternhagen,499,145,1quypv,250,,What are some romantic things a girl can do for her boyfriend,395
SirWaffleMan,865,121,1qx94f,243,,Whats the worst physical pain youve accidentally caused someone,364
Fatmuffin,1420,226,1qxnok,243,Masturbating doesnt count and it can be anything at allEDIT apparently i cant have my answers in the post EDIT  my best post so far thanks guys Ill be reading this until i get through them all So far i love themEDIT   Holy Tofu that a lot of comments I look forward to reading these Thanks for sharing,What is the most amazing feeling thats not sexual,469
twovices,1577,327,1r8hns,572,,Based on your username what pun would Arnold Schwarzenegger make if he killed you in a movie,899
AerosolNinja,884,127,1qsqfb,238,What Ive taken from this thread Text messages are often not an appropriate form of communication and we seem to have great difficulty telling when this is so People find it much to easy to be cruel in this format All of you have been able to or are in the process of moving on Our exs suck I text too much,Worst text message youve ever received,365
uptree,1477,128,1qtmm8,238,,What is something bizarre that is still going on in your culture but shouldnt,366
Dennisjcj,715,93,1qsmw7,234,,What is something you regret doing every time but end up doing again and again,327
throwawayq,609,134,1qsg86,234,None of you have extremely weird fetishes Im disappointed,How did you discover your fetish,368
destinychanger,1156,94,1qwwhx,224,Edit I should have opened this thread sooner,What was your biggest holy moly why havent I done this sooner moment,318
FrankieCarbone,1271,118,1r0qmt,223,Let the hate flow through you,In  words or less what pisses you off more than anything else,341
earthtokylie,290,118,1qzp3m,228,Or conversely the best,Crime Scene Photographers what is the worst thing you have had to photograph,346
Amillusion,543,86,1qwkpo,221,edit All of these stories so far are really goodAlso a lot of arsonedit Thanks for all the replies Most of you guys did crazy cool stuff as a kid But you know as i read all of these I thought That a paddlin,What is the worst trouble you have gotten into as a child,307
HowDidThatFappen,1373,119,1r2bc3,226,,What elusive video game goal did you never quite achieve,345
wikifry,612,70,1qrcit,224,How messed up was your childhood,What are the weirdest lies your parents told you as a child,294
flylikeaturkey,883,124,1r2qz0,216,Edit Man I wish I knew some of you guys in person so I could help out But on that note Im inspired to do things for the people I do know Keep em coming And earn some real life karma by using this thread for inspiration,What small act of kindness would make your day,340
MrMcPoopypants,737,98,1r7lzf,230,,Have you ever been arrested And why,328
alexluprete,280,102,1qty3v,211,I know this isnt a super pointed question but I was hoping some under divorcees wouldnt mind sharing their experience going through a divorce at such a young age What happened  In this Redditors humble opinion it seems disheartening to realize that two young couples I personally know whove been married less than  years are already divorcedfiled for divorce Personally it creates such a sense of hopelessness that two people who were once so in love cant find that sparksettle their differences Despite that sad notion I still see so many of my facebook friends getting engaged and married at an alarming rateTLDR Was wondering young divorcees experience going through a divorce at such a young age yet still I see so many young people getting married Feels hopeless  ,Young divorcees of Reddit what happened,313
Cowdoy,917,152,1qz6ts,199,Im open to general answers or specific types or pretty much anything really,SeriousWhat advice would you give to someone who is about to turn  and has never consumed Alcohol,351
pspencer,818,154,1r3dkd,189,Runon sentences welcome,What single sentence would most upset the stereotypical redditor,343
ronswansoneatssteak,546,162,1qv3iq,190,,What is the most nsfw fraternitysorority initiation you have ever seen,352
Fabregasfan,766,108,1qv2kl,185,Im looking to expand my foreign playlist on iTunes,What are your favorite nonEnglish songs,293
vodkarox,814,111,1r81md,244,As an older redditor I can recall when I was a kid getting excited when the Wizard of Oz would come on television each year or the Christmas Cartoons  I was excited when our teacher read us James and the Giant Peach in class and let us draw pictures about what she read about  It seems that younger people dont really get excited over things except a picture or tweet on their cell phone or getting a new cell phone  Cell phone  Cell phone  Anyway please enlighten me  Thank you,Young people of AskReddit What excites you these days,355
Chradamw,540,103,1qrts6,186,,How did you lose your friends Was it your fault,289
imustbbored,522,79,1qyzpk,184,,What is a decision you have made in part after reading something on reddit,263
StillDreamin,693,172,1r5r11,182,Edit Holy shit Front page  I never thought this day would comeFirst Id like to thank my family  My friends whove always supported me  My grandparents for always believing in me  I wouldnt be here without any of youBut most of all I just want to thank my Lord and Savior Joe PesciEdit  Edit  was a joke,What sentence is a lie every time you say it,354
LookingGold,277,68,1qx3xi,183,Now that the holidays are coming lets share with each other our best ideas and hope our loved ones dont use reddit  ,What are your best gift ideas under ,251
StillDreamin,1161,115,1r886u,242,,What is a seemingly simple concept most people cant seem to grasp,357
racecarisbackwards,442,84,1qqtks,176,,As a teenager what is the dumbest thing youve done,260
toodamnloud,135,78,1qvefc,175,,Funeral directors of Reddit whats the most unusual request youve gotten from a mourner,253
mayyonayze,329,105,1qqcwe,174,I always seem to give great advice to people but can never follow it myself So I figure I cant be the only one ,Whats the best advice you always find yourself giving others that you never follow yourself,279
dutchlaw,930,88,1qzeti,170,,What is your favorite beer and why,258
Ellinion,1026,110,1qw852,170,,If you could add one amendment to the US Constitution and have it go into effect instantly what would you include in it,280
L,413,101,1r3ahw,169,I came here to ask how many comments on a thread before you might as well not even bother because nobody is going to read it all the way down there Then it just became this question Still curious on both though,What are your personal Redditing rules,270
giannainhellas,2585,152,1qz3ce,171,,What are your bottom  most downvoted non trollish opinions on Reddit that you still hold and express regardless,323
lex,473,81,1qsbhe,171,,What is the best story demonstrating how your pet is an asshole,252
friendofazombie,420,73,1qzsnb,165,The big bang theory had an episode that points out that Indiana Jones did nothing to change the outcome in Raiders of the lost arkWhat are other examples of thisEdit The big bang theory is not responsible for noticing this first it was a well known discussion point before the episodeI personally enjoyed Raiders of the lost ark and enjoyed the journey ,What movies have a main character that doesnt change the outcome of the movie SPOILERS,238
iamnotastroturfing,559,76,1qv4ti,166,,What did your first failed relationship teach you,242
happiestburger,644,102,1r58uw,167,,What was the weirdest thing you did while you were drunk,269
JaxonIsAwesome,320,72,1r2a0w,165,,What are some things people should know or be aware of before moving out of their parents house,237
anitya,145,80,1qu1cg,155,,Teachers of Reddit whats the most rewarding interaction youve ever had with a student,235
Blezerker,367,110,1r27l1,149,It could be funny astonishing or just plain WTF,Paramedics of reddit what is the biggest OMG moment youve had,259
SupGuyz,940,65,1qzegp,145,,What is something you dip food in that sounds gross but tastes good,210
wookiespit,970,84,1r1yyj,142,,What is something you will never understand,226
heisenburgerbuns,677,155,1qrmp2,143,,What  word status would make a large majority of your Facebook friends unfriend you NSFW,298
samsquanchin,534,62,1r2203,140,,Reddit what was your most awkward doctors visit,202
HirschyKiss,358,37,1qxy2l,146,,Have you ever met a stranger who you never saw again that you still think about on occasion,183
Zenpig,77,73,1qrdlx,139,And what was the bill,Taxi drivers of reddit  what is the longest trip youve had for a customer and what was the reason,212
JaydenLZW,409,77,1r57nc,135,,How long have you gone without sleeping and how was it like Serious,212
sandrobit,503,64,1qwtvo,138,,What is your strange obsession,202
thepkmncenter,418,131,1qquwe,137,,What is the weirdest thing you have masturbated to,268
djwest,438,59,1r243z,136,,What major life event molded you into the person that you are today,195
maciballz,506,148,1qqabm,134,The characters dont have to be from the same series ,Which fictional characters would have the best sex tape NSFW,282
worou,393,58,1r1qwa,135,,SERIOUS What according to you is the most important thing parents should teach their kids  your parents have taught you,193
PillDickles,394,62,1r5dcw,131,,If advertisements were blunt what would they say,193
SweepTheStardust,1009,65,1qz711,134,,What really bad movie do you actually enjoy and watch over and over,199
Kittydoggy,758,107,1r3w4e,130,,What TV show finale made you cry the most,237
dicarlok,866,57,1qqx0n,130,Go ahead let it outEdit wow I got through all the comments GuysI wanna give you all hugs Way more feels than I expected lt,If I were your ex what would you say to me,187
BoomCandy,757,71,1r4z9g,120,,If you could change add or remove a rule from any particular sport or game what would it be,191
Funkit,719,59,1r0ht8,122,Barring jolly ranchers of courseEDIT like  people said penis or my butt You guys are hilarious I tell you hwat,What is the one thing you wont eat,181
hubble,430,91,1r3x1i,117,Edit Some of you guys were wimps when you were kids it seems haha,What was one thing you were scared of as a child that you now realize was stupid to be afraid of,208
jKyril,1009,275,1qvbkf,115,That one song that gets you every time,Whats your feels song,390
kimjunguner,539,49,1qtr5g,118,Language barriers Culture shock,What was your biggest screw up in a foreign country ,167
eyeforaneye,321,67,1qu1gt,115,,What is one thing you appreciate as an adult that you had no cares for growing up,182
rudeboyskunk,943,185,1r4w40,115,,Reddit what nonsexual experience do you get the most pleasure from,300
anthonytorres,710,79,1r0myv,117,,What two things go absolutely perfect together,196
iamberlo,342,57,1qytwh,112,Interested to see everyones responsesMost favourite Being able to play World of Warcraft drunk while eating Doritos until amLeast favourite Putting kg on doing my favourite thing while being singleEdit Majority of people seem to miss cuddles at night Damn they are so good,Single people of Reddit whats your most favourite and least favourite thing about being single,169
JMcElhaney,420,125,1r4ahj,113,,What NSFW thing have you seen in public that you will NEVER forget,238
bradenroggow,549,55,1r84nh,173,,Whats something no one ever warned you about before you got married,228
AssbuttWinchester,337,49,1qzjdn,111,Wow I didnt think this post would get this much attention Thanks for the comments everyone Ill try to reply to as many of you as I can Plz dont think Im a bad OP if I dont reply c,Serious When did you realize you could not be friends with someone anymore,160
unclederrico,294,78,1qs8dc,105,For those unfamiliar with Harry Potter it is a magical mirror that shows us nothing more or less than the deepest most desperate desire of our hearts,You stand in front of Harry Potters Mirror of Erised What do you see,183
LittleThugWife,428,57,1qx6go,107,Current favorite Had a favorite growing up,Reddit what is your favorite board game,164
HomeOnReddit,140,40,1qzzl9,103,,What are subreddits you dont use for the sake of entertainment but improved your life,143
pipep,268,47,1r6zpy,103,,What is the funniest or most awkward thing you could say in an elevator full of people,150
RSoMKC,550,60,1qvypm,98,,Hey Reddit what is your most irrational fear,158
spetsnazcats,338,53,1qr7vz,100,,What was a phase you went through as a teenager that you look back on and think What was I doing,153
ericbyo,203,36,1r28zh,98,,Who is the scariest person you have ever met,134
QuotationStation,736,36,1qwada,96,,What genetic abnormalities do you have,132
Zehdari,376,46,1qw8z5,100,,What is a skill easy to learn but will impress people you show it to,146
runbradleyrun,198,61,1r41l4,98,,People who have found a dead body how did you find it how did you go about it the situation and how did it affect your life,159
ShreshkiBug,345,85,1qrdch,96,,What would you do if the Internet were to be permanently removed,181
crayzeeguy,434,72,1qs6hd,93,,What is the greatest single part of any song In the history of music,165
edyo,424,53,1qreha,93,Due to all of new technology what are some areas that we will see phased out in the next half century Thinking along the lines of how redbox took out the movie rental stores,What are some jobs that are slowly going to get phased out in the next  years,146
Kamelifarmari,535,58,1r5hkz,91,In videos there was this link to a youtubeflick in which Harvard students were asked to name the capital of Canada and quite a few had no idea Most of the people in the comments seemed to believe that if you are going to be a doctor for example you are just wasting your time learning geography like that  That got me thinking do you think that all the information can be found easily enough to make actually knowing stuff completely useless or do you judge people based on their general knowledge or the lack of it Would you consider someone stupid if they dont know the capital of you neighboring countries or the main sides of WWII for example Or if they cant name one composer artist or author Do you have some things from your own field that you always expect everyone to know Or do you think that its enough if everyone knows the stuff they are working with and theres really no useless information everyone in your country should be aware of,What do you consider to be basic knowledge everyone should know but they dont,149
BK,375,72,1r3q9q,93,,College graduates of Reddit what is a TLDR of your major field of study or classes,165
shadowireheart,450,61,1qrwmg,94,Anything and everything is acceptableedit Lets up to k,Reddit if someone gave you  to spend as absurdly as possible how would you do it,155
johnnysnipr,771,105,1qz06z,93,,What are some essential albums everyone should have listened to,198
icookmath,307,57,1qzb5n,93,,What is something that some animals do that would be extremely weirdawkward if humans did also,150
starstufft,456,54,1qw5dl,88,,What never fails to impress you,142
marley,609,52,1r7mcb,102,,What issue do you hear about often on Reddit but never actually experience in real life,154
Hendricksgin,479,142,1r7ssf,82,Im drinking tonight and keen to know whats the drunkest any redditor has beenEdit to much drank Keep with the stories yo,Whats the drunkest you have ever been,224
MeowingCows,303,40,1r7zne,104,Everybody has one of those oh shit moments now and then,What was your biggest I shouldnt have done that moment,144
iamZacWalker,267,29,1r7ux6,106,Tell us about it,Have you ever had a rule created because of your actions,135
princesswatermelon,620,42,1r00tg,85,,Reddit whats your worst physical feature,127
DJFabulous,223,24,1qznau,87,Edit  Just wanted to say thanks to everyone who had replied to this so far Ive  read every single one Theyve made me smile laugh out loud snort in the most unwomanly way and literally cringe to myself BrilliantMost surprised we didnt get any yet where people asked a woman who isnt pregnant when shes due ,What have you said to someone that came out wrong that still makes you cringe now,111
boxofkangaroos,327,59,1r3ky0,80,,What is your favorite notsowellknown song by very wellknown artist,139
BartholomewWhite,380,80,1qwm80,80,,Whats the unluckiest thing thats ever happened to you,160
alenak,348,52,1r55ry,81,,Whats a small even insignificant thing that never fails to make you smile,133
OstrichMadeOfClay,319,27,1qqw7t,81,,Which profession is the enemy of your profession,108
josephoc,483,49,1qqeoh,82,,What is the worstmost painful movie you have watched,131
jyssrocks,296,37,1qqcqm,79,,What is a common courtesy that is really weird when you think about it,116
eqzuestas,325,29,1qwoaz,79,,What experience should any person have at least once in their life time,108
xlizardcalibrex,160,51,1qxcqa,75,Example Im not a weatherman but I know that youre getting at least  inches tonight,What is best dirty pickup line that you know,126
ayerMatt,398,68,1qtm6i,76,Lets hear it,Ladies of reddit if you could marry one movie character based solely on their personality in the movie who would it be,144
JAIF,282,48,1qx5mo,73,,Whats one fact you wish you had never learned,121
nixolep,199,67,1r6r2p,74,Spill it,Whats your most ridiculous one night stand story NSFW,141
ayerz,176,23,1qwd4y,74,,What do you do to calm yourself when youre nervous,97
fluffpot,546,28,1qzq8g,69,,What is one bandartist that you could never get into despite them being really popular with people close to you,97
thatrotteneggsmell,374,48,1r7y5v,71,,What mythical creature would make the best pet,119
NuclearWaffelle,399,33,1qsxcr,70,Edit Showed the thread to my mom and she was cracking up Thanks for the comments everyoneEdit  Wow I guess a lot of us hated hearing the same things,Whats one sentence you hated hearing as a child,103
UnderFireCoolness,463,37,1qtb1s,66,,Whats your biggest I really dont care to what most people care about,103
vishalvc,442,52,1r7ttz,73,,What is the best song lyric you have ever heard,125
Thenovazz,103,30,1r1jhx,64,,Police Officers of reddit whats the nicest guy that you have ever met but still is a criminal,94
acacium,528,128,1r0zoa,67,,Most amusing movie title that can be created by REMOVING one letter of an existing title,195
JGG,399,34,1qzgti,66,Im in a comm class about film and Ive been exposed to so many great films that Ive never heard of before,Whats a movie many havent heard of but is definitely worth a watch,100
jonnyapplepie,393,71,1r89ih,82,store name band name etcEDIT WOWone front page of askreddit Id like to thank Albert Einstein for giving me  and pointing out that the condoms are under the sink,What are some clever store names that youve created that youll never be able to use,153
mar,395,67,1qt2xc,63,,Men of Reddit what do you think is the worst part of being a woman Women of Reddit what do you think is the worst part of being a man,130
aagpeng,263,44,1r6elm,61,,Women of reddit whats one thing that you do not want men to get you for Christmas,105
TroublesMeDeeply,96,45,1qwi87,58,,How did you realize that Reddit is one of the worst places to get advice from,103
Shnunny,291,45,1r2adw,58,Were you a loner A douchebag A looshbag ,What arewere you guys like in high school,103
Belshoviks,469,38,1qttz0,61,,What stereotype do you hate the most about your ethnicity,99
jaws,212,59,1qsdhd,56,,Redditors who are attracted to much larger people than themselves What about the size difference sparks your interest,115
WineWednesday,269,53,1qr03g,61,For instance you were  and slept with your friends dad you slept with your brothers wife you slept with your pastor etc Nothing illegal you weirdos,Redditors who have had a sexual encounter with someone forbidden what lead up to it What happened,114
JeremyKylesBrother,403,30,1r1wqh,59,,Hi Reddit what are the best perks of your job,89
ExcaliburX,282,39,1qzcjg,60,I prefer old school games,What are the some most addicting games that you keep coming back to,99
Cooptlock,164,19,1qy14t,62,,If you were about to lose all of your previous memories what is one thing you would want to remember,81
Fleetstreetkiller,93,23,1qy11z,61,Edit changed text to comment per mods,Reddit what are some things that you can get for free that most people have no idea about,84
DaNinjaKitten,168,32,1qwcu4,56,,Whats your greatest idea for a reality show that people would actually watch,88
notryan,214,47,1qsrsx,53,Was it a spur of the moment decision or did you consider a few options first ,Vegetarians who went back to eating meat what was the first thing you ate,100
sawfan,182,62,1qs4gv,59,NSFWhttpenwikipediaorgwikiSawfilm,NSFW Whats the worst Saw trap you can imagine,121
liveloveandplay,340,51,1r7p4g,62,,What spoken Idiom or Expression is annoyingly overused,113
GooLuster,207,34,1qwogk,60,,If you were in a FightWar and only had food as weapons what would you pick,94
TheDudeness,278,78,1qvbjb,54,Note this can be anything,Women of reddit What feature in a guy is a HUGE turn on for you,132
coldenoughya,213,24,1r40ge,55,,Whats a delicious snack endemic to your ethnic group or nationality that everyone else is missing out on,79
LazyCanadian,77,38,1qr54b,59,Occasionally I encounter a private subreddit It always happens to be a random topic I am mildly interested in but how do I gain access Why allow a private topic on an aggregation siteI am thoroughly confused by the concept there are fair more private places to talk bread than rbread,Why do private subreddits exist,97
grumpynutella,319,26,1r2avi,57,Edit Given the responses might as well get broader here Objectliving thingideaconcept and whatever else Im not thinking of One single thing you could erase for good what would that be,If you could eliminate a single object from the planet every copy of it with the guarantee that no one would invent it again what would it be,83
AWildFuckOffAppeared,52,34,1qu61d,54,,Postal workers of Reddit what do you do with the letters that kids send to Santa,88
QWOPscotch,254,36,1qra73,56,,What do you use not in its intended purpose,92
CollaWars,102,40,1qqkdk,53,,What are the bad sides to the good guys in history,93
TryingToContribute,338,42,1r7ikj,52,Could also extend to an ending or when the point where things come together blow my mind people,What is the best mind  blown scene in a movie,94
OldMonet,244,32,1r3cjs,56,I got thinking about this as my mind started wandering during a conference meeting at work,What fact sounds like complete nonsense,88
glove,257,25,1qw226,50,It can be a film a piece of music a tv show or what ever As long as it is a remake ,What is a remake that was better than the original,75
katms,266,67,1qrejj,55,,Men of Reddit what are your views on female body hair,122
Sykedelic,35,36,1qu8y5,51,,People who were cast to play a fat or ugly person in a movie or tv series was it embarrassing or awkward,87
jecmoore,394,46,1r8lv0,98,I think people are getting fact and opinion even if that opinion has some factual backing to it mixed up How about we start providing sources that support the facts we are saying ,What is your favorite fact to debunk,144
crazygoattoe,775,95,1qtte9,50,,If your username described how you would die what would the end of your life be like,145
JavaPants,125,25,1qvekk,48,,What is a word or phrase that makes a surprising amount of sense when you think about it literally,73
GigEmAggies,115,25,1quqr0,50,Im trying to find songs to drive to that just you pumped up I have lots of songs from the ss as well as many songs from the past few years Please no screamo classical or dubstep songs Thanks,What songs should I put in my get pumped up playlist,75
Taskari,130,23,1qr1tl,46,,Whats that one thing you could never refind on the internet,69
Greenkeeper,279,35,1r36zl,46,,What was the stupidest thing you got in trouble for at school,81
youslags,176,29,1r2iq0,49,,What are the most ridiculous pet names youve heard people use for their SO,78
sudhingr,197,28,1r86b5,48,,If you could change one thing about you what would it be,76
Marscy,294,30,1r54rc,47,,Whats a dumb question youve always wanted to ask,77
belgianaddict,139,26,1qzy48,46,TIME THAT FREEZES NOT FREEZING LIKE IN FREEZING COLD,If the world froze for  hours what would you do,72
Apcalypto,225,14,1qwjv4,47,,What is something that should be much cheaper than it currently is,61
LupeTheKiller,46,46,1qvf12,45,Im curious how you would bring that upI know you have been posting naked pictures because while browsing other naked pictures I found you ,Has anyone ever discovered their SO was posting on rgonewild or rladybonersgw or been caught by their SO for posting If so what happened,91
theyeticometh,251,28,1qqmvb,46,,What movie scene always leaves you in tears,74
ReedHimself,167,20,1r5qjn,45,I like to always hear about peoples first time,What was your first job,65
ItsTheJuggernaut,216,47,1qt8sz,47, ,If you could change the sound of your farts to any sound in the world what would you change it to and why,94
mrsmonroe,207,17,1r2dbo,47,,Reddit what are some genderbased products or items that actually work great for the opposite sex,64
scrappyjack,58,14,1qv605,43,What is the best way to invest a small amount of money and see profit  Stocks Mutual funds Land in Montana,What is the smartest investment you can make for under ,57
amnesia,631,84,1r2e9c,47,,Whats something about the American culture that you cannot stand,131
sayyestome,269,22,1qztcr,40,,Reddit what is your goto fun fact about yourself,62
sundogdayze,194,21,1qvmda,41,Real or fiction,What is the scariest sound,62
ShreshkiBug,143,35,1qrbgu,45,SERIOUS,Do you think world peace can ever be attained,80
OmarEasy,81,42,1r5x7p,44,Any perspective is great Introvert extrovert anyone ,Former shy persons of Reddit who have broken out of their shell is it worth breaking out,86
iamaquantumcomputer,152,22,1qywge,42,What is something you used to believe possibly when you were little that seems obvious now that you know better,What is something you once thought that seems ridiculous in hindsight now that you know its wrong,64
democi,121,29,1qw42m,42,,What can I do with almost  metal hangers,71
lordt,22,26,1qus40,41,I just saw a video of a wedding where the bride threatened to cry if the photographer didnt leave her alone This made me wonder what is the most dramatic wedding youve ever attended ,Wedding photographers of reddit what is the biggest wedding drama youve ever witnessed,67
StateSt,115,14,1qzzkh,42,,Question for retail workers What is one thing that us shoppers can do during the holiday season to make your day better,56
aaaahhh,52,16,1qqk82,42,,What was the exact moment when you realised you were in love for the first time,58
JumboSmooth,207,17,1qzf93,39,,What was your most expensive meal and was it worth the money,56
ThincNgKap,247,39,1qz205,42,,Whats on your Bucket List How attainable is your list Whats currently stopping you from doing what you want to do Can you help a fellow redditor achieve their dreams,81
schmoker,276,49,1qxlqr,39,,NSFW Where did you lose your virginity,88
basicshow,286,28,1qsjdv,40,,What is the worst name to choose for your child Why,68
thepraff,177,25,1r8mg4,73,For instance if it rained cats and dogs infrastructure would crumble ,Which idiom if taken literally would cost the most damage to humanity,98
swaginabag,149,45,1r3j2r,37,,What are your favorite pointless websites,82
techie,219,33,1qysfk,35,,If you could have an extra body part what would it be and why,68
loveiscloser,66,30,1qu7y4,38,,Deaf people of Reddit  whats the sound you wish you could hear the most,68
charlotts,195,27,1r5dr6,39,,What is the worst advice you were ever given,66
babystripper,148,28,1r44bb,40,,What is the weirdest thing that has ruined your date,68
DrDarling,181,30,1qv7r6,34,,What is the one thing you wish to hear from your ex,64
TyrRev,132,17,1r0v0i,36,Inspired by this comichttpwwwqwantzcomindexphpcomic and this bookhttpwwwbarnesandnoblecomwmachineofdeathryannorthcmmmcgoogleplabooktoqampcmmmcaplaampeanampisbnampr and this bookhttpwwwbarnesandnoblecomwthisishowyoudieryannorthean,There is a machine that tells you how you are going to die  but cryptically What would be the worst prediction to get,53
macflys,93,43,1qwxmo,36,I look around and see beautiful women somedays and occasionally a girl will look a certain way that I want to compliment how well she looks What is the best way for a male to do this without you assuming I want to get in your pants,Women of Reddit What is the best way to compliment you on your appearance without it coming off as being hit on,79
InfiniteAmbiguity,184,21,1qwoq9,36,A few years ago NPR had a national competition with this question  If I recall correctly the winning entries were  Bachelor party youtube video wedding canceled    For sale  baby clothes  never worn  So how would you describe your life in  or fewer words,How would you describe your life in  words or less,57
Ihopenoseethis,200,25,1qwhs3,41,,If you can have one TV dad be your dad who would you choose,66
IPlei,122,10,1qv2w4,37,,Whats the unhealthiest thing youve consumed this week,47
oscarjrs,190,14,1r7v3q,39,In other words a celebrity who is practically impossible to hate,Which celebrity dead or alive has the highest ratio of fans to haters,53
googe,163,17,1r6lns,37,,If everyone had to wear a shirt stating  facts you should know before meeting them what would your shirt say,54
wheelchairpilot,209,48,1r3xap,33,,Whats the worst experience youve had during sex NSFW,81
keeganlol,296,16,1qx80p,33,,What is your most extreme political view,49
btcowlishaw,10,16,1qt24e,37,Do you still or did you ever believe in their innocence ,Parents whose kids ended up being serious criminalsfelons how do you cope,53
essteeeeveeeeen,166,19,1r8j6m,44,,What do you feel bad about doing all the time but not bad enough to stop doing it,63
pacificcoasthighway,159,14,1r8ag9,45,,Whats the best thing youve said to a celebrity youve met,59
donnielehmkuhl,248,13,1r18gk,35,,What simple action or thing turns you off completely ,48
Pync,123,18,1qsuvd,34,Or may have had in the past I need some new time killers,Reddit what is the most entertaining game you have on your phone,52
MarkNutt,101,26,1qr4iy,33,,What is the most damage you have done to your body without realising,59
c,269,24,1r7oko,35,,Which country would you like to live in the most and why,59
sharksnax,101,23,1r5kej,34,,Whats the most bizarre thing to ever happen to you,57
dfoolio,110,15,1r387m,33,People who suffer from depression in your own words what does it feel like,People who suffer from depression in your own words what does it feel like,48
NamenRoodles,436,34,1r0slr,34,,In  words or less can you explain your first sexual encounter,68
QuotableIowa,4,14,1r0rsd,36,, operators of Reddit whats the most haunting call youve ever answered,50
GodRaine,15,18,1qv9s8,36,This hasnt happened to me but Ive always wondered if its ever happened to anyone else Usually a rejection to a proposal of marriage is final  meaning that not only is the person saying they wont marry you but implicitly the relationship is over  right in that moment Has anyone ever decided mutually obviously that it wouldnt be over yet either because one person wants more time or for another reason,Reddit have you ever continued dating a person that said no to your proposal of marriage What happened,54
Tigolovesbacon,126,21,1qsq0u,38,Protips advise on how to behave what to look out for while Im still young things I shouldnt fuck up or just a lovely story about your teenage years anything is appropriated Reddit showed me anything is possible and I have no idea where my life is going Maybe Im just getting a little paranoid hahaEDIT I knew I shouldnt have made this thread before going to sleep  in the morning already Ill check back in a few hoursEDIT EDIT Damn Thanks guys I couldnt have wished for better advise Ill try to do all of this,Any tips for a teen on how to become successful in life,59
corneliuswjohnson,51,11,1r3y5i,35,,Teachers how would you fix education,46
FutureAlcoholic,129,30,1r35ua,34,Most commercials just annoy people Fortunately theres a rare bird that comes along every once in a while and is absolutely wonderful Lets see em,What is your alltime favorite commercial,64
guessmyagenda,139,24,1r1yn2,32,,What would happen if everybody in the world was like you,56
Jabberminor,138,18,1r1v21,32,,What is one nonharmful habit youre trying to get out of,50
ItsTeaTimeBro,32,11,1r10rl,33,Paramedics of Reddit whats the most horrific thing youve encountered on the job,Paramedics of Reddit whats the most horrific thing youve encountered on the job,44
BigSackMoneyBag,98,14,1r1004,34,,Redditors that have shit themselves Whyhowwhere did it happen,48
JMANTAM,135,14,1qxzfs,30,,What would be the most terrifying thing if it became invisible,44
squidavenger,81,24,1qx6sb,33,So basically a quote that sounds good but doesnt make sense,Whats the most inspirational but nonsensical quote you can think up,57
VirulentWalrus,39,23,1qreyb,29,,What would you do to your favorite adult film R to turn it into a childrens movie while keeping the plot relatively close to what it is now,52
Gameface,132,14,1r3scl,34,,If you could give advice to the next person that dates one of your exes what would you tell them,48
batgirl,151,10,1qxr99,33,Specifically experiences during your high that freaked you out etc,Reddit what was your most uncomfortable drug experience NSFW,43
Agooddayforabaddeal,84,19,1qvgsz,34,,Reddit what movies will make you feel better about life,53
juliasbs,140,27,1qt3pj,28,,Men of reddit what is a scent that really turns you on,55
KnightSniper,61,22,1qstlr,33,It can be appropriate or not just list some good onesI E Bought the Farm for Diedand Beat the Bishop for masturbate,What is your favorite Euphemism NSFW,55
jumbycoke,104,19,1qssq7,34,Secrets behaviors things people,What do you keep from your SO,53
startingagainn,60,21,1qsdus,31,Im a veteran out of school for over  years going back in January  In high school I didnt care or try so now I have no idea what to do I literally have no idea what to expectany advice would be helpful  Study tips what towhat not to buy what to expect in the classes how older people get treated how to takes notes on a lecture how to organize a binderIm so scared Im going to mess this up I have two kids and theyre relying on me to be successful  Any advice helpsThanks,What do I need to do to be a successful student,52
PillDickles,250,18,1qrqzl,34,,What are you genetically cursed with,52
JBSchwab,48,12,1qroek,34,,Reddit what is your bad trip story,46
Simbrian,100,21,1r6fq5,30,,What single book if sent back one thousand years in time would have the greatest effect on the world,51
VerukoA,150,16,1r5nug,31,To clarify a name recognized by the general public not just casually mentioned in a textbook,Is there anyone who is alive today that will be remembered in  years,47
Urisk,37,19,1qs2gs,32,,What is the best way to handle parents that wont discipline their children in public when avoiding or ignoring them is impossible,51
ryanrows,104,15,1qqjd7,30,Lets assume you arent a protagonist but a regular person,What is the worst fictional book video game movie etc universe to live in,45
SteamApunk,63,15,1r5u12,32,,Does Reddit have any cool Hitchhiking stories,47
redread,216,44,1r509q,33,We can all hug it out after,Whats a scene from a movie or a tv show that never fails to make you tear up,77
deleted,200,10,1r1r4b,30,,What are some common misconceptions about your job,40
mrbojangos,183,27,1r4epa,25,Combine  words and make a terrible thing Edit no answer in post,What is the grossest  word combo,52
canadianclub,177,12,1r47j1,33,,Whats your never again drink,45
bigups,76,22,1r4264,27,,If countries had official video games like they have official birds and what not what would each countries official game be,49
ToMockAKillingBird,162,10,1r2n4c,30,,Whats something that your hometownregioncountry is known for that you really REALLY wish it wasnt,40
linzphun,8,6,1r12mh,28,,Craigslist Missed Connections users of Reddit have you ever succeeded in connecting with someone What happened,34
jezcrossland,104,10,1r0rw2,28,,What was the worst job in history,38
OcelotWolf,145,11,1qwmu4,29,,What situations make you feel very uncomfortable,40
skeezybeezy,241,37,1qufn1,31,,Reddit whats your favorite smell,68
Idonttkknow,49,9,1qsr50,33,Any philosophical redditors out there,Who is your favorite philosopher and what do you consider their most inspiring quote,42
Lepetitebunnie,29,13,1qsip5,33,Im about to start interviewing for jobs and I figured this could help some other people out as well Plus chance for good stories ,Hiring managers of Reddit what did the last person you interviewed say that made you decide to hire or not hire them,46
ZabCos,118,32,1r53ao,27,,Whats your best fake quote from someone,59
miurace,162,8,1r18et,28,Is there a reason for it Past experiences,What is your greatest fear,36
pfootie,89,23,1qrr89,32,People are so divided on the topic of nuclear energy What is your position on nuclear energy and why do you feel that way,People of Reddit what is your position on nuclear energy,55
SirHenry,38,20,1qr5nk,32,Were all so good and tolerant towards gay people how about transsexuals Also what happened to the serious tag I loved some of the more popular tagged conversations but seems that people stopped upvoting them,Serious What kind of prejudices do transsexual people face today,52
allymacster,96,10,1r88em,34,,Retail workers of Reddit what is the most pathetic complaint you have ever heard from a customer,44
ChairmanMeowza,76,2,1r79jf,29,,reddit what mistake do you keep making,31
adriannamanda,99,26,1r52ei,26,,Whats your favorite Disney movie and character,52
myrugwasstolen,51,34,1r4204,25,,What shower argument did you win in your head today,59
thatoneguyoverthere,123,12,1r1ztj,26,,What smell takes you back to your childhood,38
ModernDayRevolution,50,6,1qybq1,26,,What are the unwritten rules for dating Serious,32
Reperalib,93,12,1qxh9z,25,,If aliens ever were to visit us what would be the hardest to explain to them,37
neilfeeney,89,17,1qvfsh,27,Its starting to become a bit generic isnt it Survivors band together have power issues look out for raiders try to find food etc How would you change up the genre to make it a bit less cliché and shake things up a bit ,Hey Reddit how would you change up the zombie genre,44
sugarwaterpurple,171,23,1qrd83,25,,What do you hear right now,48
otherwiser,157,17,1qqusq,28,,What is one thing all your friends love but you are just not into whatsoever,45
veridiantrees,96,15,1r7dhj,27,We all have things that we need to let go of but have nobody to fall back on Ill try to help as best I can,What have you been dying to tell someone,42
ThisIsGabe,185,17,1r4blt,26,,What foreign luxury do you most wish you could have in your own country,43
kpressley,99,11,1r2773,27,,Serious What is something you do to lift your spirits when youre down in the dumps,38
bowlnspoon,147,6,1r267f,27,,Whats the one thing you refuse to compromise on,33
thebageljew,108,11,1r0i5j,25,,What is the scariest book you have ever read,36
letstacoboutyomama,45,14,1qt4jh,26,,What was the most fun you had with a person you only saw that one time,40
shwayze,94,10,1qrb2j,26,,What is your personal hell,36
,229,17,1r8q60,51,Maybe the studios disregard helmets on important cops because its inconvenient to have your star behind a helmet Maybe its the jargon in a scene is completely different from what you know from your job,What do TVmovies get wrong that bothers you,68
wvfan,129,16,1r5h14,26,I like hearing all of the stories behind them And who knows maybe someone here could help Life has a weird way of working,What is your biggest regret in life,42
kantoking,20,20,1r56zj,26, ,SOs of people who commited suicide how did their death affect you serious,46
sapperdeboere,82,11,1r4vt4,28,Many plots rely some part on technology As technology advances things can be done more easier so logically some moviesepisodes would be over quickly,Which realistic movie or tv plot would be very short or nonexistant if theyd use current technology,39
rupenscoop,62,4,1r19k8,25,,Reddit what is the oddest thing someone has said while you were having sex with them NSFW,29
tthlesstiger,96,11,1r0sb4,27,,Reddit what movies sounded promising in its premise but flopped or performed poorly at the box office,38
TheDrunkenSniper,84,10,1qy6wl,29,Edit Thanks for the quick replies Me and my friend are having a little debate about it ,Reddit do you believe in aliens Why or why not,39
romds,123,8,1qxpsu,24,,What is your favourite TV showMovie that is not from your country,32
Damoo,69,10,1qvlru,23,,What seemingly impossible to win things have you won,33
literatecaveman,22,11,1qrd39,24,,What was your funniest incident involving the police,35
RhythmRug,47,15,1qqegf,28,A childhood friend of mine is currently serving in Afghanistan and Id like to send a care package to him that would be useful in addition to letting him know were thinking of him,Iraq and Afghanistan Veterans of Reddit what are some things to include in a care package to a current serviceman that civilians wouldnt be aware of,43
UncertainAnswer,230,47,1r4zx2,25,,You wake up in front of your computer with amnesia what do you think when you see your reddit username,72
MuhdHazim,70,27,1r4tx2,21,,In your opinionWhat is the best Youtube video,48
Ezma,49,9,1r3iws,25,how long would we last,What would happen to America if the internet went down nation wide,34
kyhe,79,18,1r3730,28,,Why is your best friend your BEST friend,46
nyomythus,51,16,1r365i,22,,Restaurant workers when you go out to eat what are some tell tale signs that most people dont notice that make you thinkum maybe Im not going to eat here after all,38
FappetteThrowaway,130,22,1r3653,28,,Reddit what is the weirdest sexual thing youve ever doneseenbeen asked to do NSFW,50
TheNaud,164,14,1r2v48,23,,What invention has hurt society the most,37
MISTERCLEAN,105,16,1r055g,25,Absolutely ANYTHING is fair game,If you could change ONE thing about the human body what would it be and why,41
creativelybrownish,137,17,1r025g,24,,What do you love,41
GoTigers,24,17,1qz5xz,27,For those who have worked in the Cruise industry or even those who went on a cruise for vacation share your crazy stories from your time at sea,Cruise ship workers and passengers too What crazy stories can you share from your time at sea,44
ViralPandemic,247,33,1qxd2n,25,,If you got teleported anywhere in the world based on your username where would you be,58
yourchildhood,37,6,1qv81a,26,,What does love feel like,32
LoLShiroi,87,10,1qu8m5,26,,What are some things that are common knowledge for you that others commonly dont know but should know,36
shipallthethings,257,19,1qsxvo,27,,If you died right now what were the last words you spoke out loud,46
mrtuber,138,16,1r6nbn,26,,What is something you do that most people frown on but you dont give a damn,42
vishalvc,73,8,1r5fzl,23,,Which song gets you nostalgic and why,31
cptmerica,99,11,1r58af,23,,What subtle change would you make to a great movie to make it shitty,34
hollowneedle,132,11,1r41ey,22,,Reddit what are your unusual fears,33
bluebush,101,10,1r3s43,23,,What is your proudest video game achievement,33
MissLexxxi,127,6,1r1lvx,23,Im watching a pretty damn disturbing movie right now Im bored and Im curious,What is the most disturbing movie youve ever seen and what was so disturbing about it,29
EnsonAmata,105,15,1r020j,25,,Whats the best song to play at a bar that will encourage everyone to sing along,40
sumsum,142,11,1qwdkg,23,,What fact myth or belief are you afraid that people will associate with you,34
cptmerica,93,11,1qrplg,21,,What are some things people frequently say but never actually mean,32
MmathersIII,75,11,1qqx76,24,,Reddit what is an everyday item that needs to be improved,35
hbnoodles,129,11,1r8o3s,41,Was there some kind of personal experience that made you believe what you do or something else,Redditors who dislike police officers why do you have this view,52
Bridger,111,13,1r8lrt,27,,If you suddenly got switched to the opposite sex and abided by normal customs for that gender what would you miss most about your current sex,40
SunMoonTruth,68,8,1r83uo,24,,What is the worst or best gift youve ever received,32
ShermanMelonBalls,43,5,1r7e5t,21,,SERIOUS What has been the most surreal moment of your life so far,26
holdingmyheart,63,5,1r7apg,22,,What would be the funniestweirdestcreepiest thing to say to someone next to you at a urinal,27
Theriley,18,14,1r6yl6,23,,Redditors who have been kidnapped what is your story,37
jram,96,20,1r6vmb,21,,Whats the weirdest thing youve done with someone you just met NSFW,41
Graham,167,12,1r6s1m,24,,What is something about American culture that really freaks you out,36
wtfjen,47,9,1r6ihz,22,The surveillance camera has a direct stream back to present day and goes unnoticed,If you could go back in time and install a single surveillance camera where and when would you place it,31
radministator,83,20,1r4yh4,22,,What book have you read that was so inspiring that it had a transformational effect on your life,42
TheSheepGuy,79,9,1r3x8x,20,What fantasy job did you want as a kid How close have you come to achieving it,Reddit what did you want to be when you grew up,29
WorldsTallestMidget,48,18,1quxem,22,,What moment from your teenage years do you look back on and think damn I was an asshole,40
StarrkDreams,22,11,1quw2l,20,Edit God damn it guys stop the amnesia jokes already ,People of Reddit whove had amnesia how was it like temporarily losing your memories,31
SUICIDEORDIE,115,18,1quv6s,24,,Reddit what is the most useless object in your home right now,42
CG,69,9,1qu1bj,22,A weird accident or disease that lead to an awkward or strange trip to the doctorORStrange behavior by the hospital staff that made for a weird or funny visitEdit Your,What was you weirdest trip to the hospital,31
NinjaPirate,36,19,1qt1ou,24,Anything good weird or both,Fast food and cafe workers of Reddit whats on your secret menu,43
theflyingderp,180,31,1qsbep,24,,How do American people perceive Welsh people,55
jv,71,10,1qrlwh,23,I just realised  most of my internet time is spent on FB and reddit S ,If reddit facebook or twitter didnt exist What site would you spend the most time on,33
StellarView,128,14,1qr6ui,23,Any type of game video games playground games board games,Reddit whats a game that you miss playing,37
mattpiv,125,6,1qqtbg,22,Its weird the way our society holds onto nostalgic things from our distant past,Hey Reddit whats one thing in our society thats completely outdated and you wonder why we still use it,28
CF,27,20,1r8ii9,33,,Redditors who remember the JFK assasination what was hearing the news like Where were you What were peoples reactions,53
Rompeben,76,11,1r2f94,21,,If you were sent back in time a thousand years what could you contribute to society,32
cephalopodsandrum,22,4,1r0pjo,22,Particularly those who were adopted as very young childrenbabies how did you react How do you feel towards your adopted parents about when they told youEdit biological parentsrather than real Sorry,Adopted children of reddit how did you find out your adopted parents werent your real parents How did you feel after finding out,26
IMAMenlo,26,14,1qzzbw,19,I was asked to be the best man in a wedding last night It isnt until October of  but am curious other than planning a bachelor party and making sure the groomsman are getting fitted for their suits are there more responsibilities I should know about Any books I need to read Or good checklists or resources I am excited but also want to do a good job Thanks ,Best Men of Reddit what are some good tips for a first timer,33
pandapooping,155,11,1qyl56,20,,Whats the next big thing youre going to buy once you have the money to,31
McMier,183,17,1qxmzq,22,,What is a popular trendfad that has occurred during your lifetime that youre proud to say you didnt take part in,39
thenakedone,70,13,1qvqhb,21,,Serious What can you say that will ease my mind about death,34
trekbette,20,22,1qv8n8,20,,Have you found something weird about someone you know from Googling them,42
bctp,95,24,1quir9,21,What are some awkward situations youve been in with an unintentional or intentional boner,Guys whats the most awkward situation youve been in with a boner,45
KaBooYa,79,9,1qticb,22,,If you had the power to remove bad side effects from an object what would the object be,31
TailsGetsTrolled,55,9,1qrvck,21,,What is the most serious problem facing humanity right now,30
bigmackdaddy,5,4,1qqts3,23,Ive heard in some instances of other Indians treating members of lower castes differently even though they live in other countries besides India How seriously do Indian immigrants and the offspring of immigrants take the caste system Are members of lower castes less likely to live abroad ,Indian redditors from lower castes living in Europe and North America do other Indians from higher castes discriminate against you,27
Brokensoul,140,12,1r7xua,25,Past shows of course,Which television show do you feel had the perfect ending,37
Adog,136,15,1r6jwr,20,Could be anything interesting or cool about really anything in your state city or country D ,What are some cool facts about your state city or even country,35
deleted,40,8,1r693z,20,NSFW obv,Whats the most NSFW present youve gotten for Christmas,28
riginalPoser,74,13,1r59em,21,,When you were a kid what is something that you thought was magic,34
caalas,73,7,1r54sg,22,,If you could live in any city from a movie or book what would it be,29
speathed,24,16,1r2ufp,22,Some context on this question Yesterdays Whats your biggest I dodged a bullet momenthttpwwwredditcomrAskRedditcommentsqzwhatsyourbiggestidodgedabulletmoment got me thinking of an incident that happened in my youth Whilst perhaps not exactly dodging a bullet at that precise moment it brought back memories of when I met a monster When I was about  my high school started a boys after school sports club I lived out of town and had been home before so asked my father for a liftWe arrived about  minutes late and the first thing that struck me was that all the boys were running about with no tops on I headed for the changing rooms but wasnt too comfortable with the idea It was definitely not the norm at my school for thisAfter finally arriving at the changing rooms with my father the man running the club followed us in My father knew I wasnt comfortable with what appeared to be a very weird guy getting kids to run about half naked so he spoke to the man for a few minutes  Shortly after he returned and told me to get ready as we were leavingIm not sure what was said in their exchange but my father was creeped out He specifically told me not to attend the class as there was something not right with the guy running it This didnt matter in the end as the class only ran onceHis name was Thomas HamiltonhttpenwikipediaorgwikiDunblaneschoolmassacre and about  months later he walked into another school about  miles away and shot dead sixteen young children and their teacher,Serious Reddit have any of you guys ever met a serial killer or person who later committed a horrific act of atrocity before they became infamous What was your experience like,38
IAmAnAssassin,131,9,1r238w,19,,Which supporting actor or actress made a movietv show better,28
lolalodge,82,12,1r1x6o,19,,What is your accidental Whoops Im asshole moment,31
jesterK,59,10,1r1cks,18,,What goes through your mind when you ejaculate,28
Superbad,65,18,1r0i09,19,Please share your tips or experiences to help depressed redditors,What was the main reason you recovered from depression Serious,37
Masterfuzzfuzz,88,12,1r09py,19,Did a similar one about shows and thought games would be appropriate ,Whats the WORST thing about your favorite video game,31
SFWBryon,24,8,1qzn36,19,Not BPs Oil Well,What has the coolest or most clever FailSafe,27
callmeval,248,41,1qz75c,22,,For the guys of Reddit what is something that girls do that turn you off,63
ActionDan,113,15,1qyw7w,20,As someone who enjoyed the movies but never read the books What do you feel was missing from the movies that would have added either story or character development ,Harry Potter Fans Whats missing from the movie series,35
vmfillpot,53,7,1qyvhv,19,Weve been thinking about having children within the next few years but I want to make sure I can do everything possible to give our children the best possible chances in life,What can a person do to ensure their child grows up to be the best person they can,26
augspreadhead,14,16,1qyj71,20,,Parents of Reddit who have male and female children which were harder to raise and why,36
mchughtai,62,4,1qy1hl,21,,Reddit whats your best insult,25
dancingmonkey,171,13,1qxzm2,21,,What is something in your household you have an excessive amount of,34
lookupdiscover,30,11,1qva8q,20,I have always wondered this due to the emphasis placed on a mans sex drive  Womens sex drives are barely spoken of in the media society and in general Its not taboo for women to want sex as much as a man ,Women of Reddit how do you deal with a significant other with low libido,31
ItsNotMe,18,1,1quwpb,20,,EMTs of Reddit what is your least favorite type of call to have to respond to,21
AgentBeige,76,28,1qtm91,18,Im thinking besides the obvious discovery of a SOs handle or someone telling you their nickname ,Have you ever realized a post was made by a Redditor you knew If so what gave them away and did you let them know,46
Kennyh,51,5,1qtdpk,21,,What worldwide problem is the most significant,26
aMANescape,145,12,1qt70t,21,,How did you get your scars,33
TheAnemicOne,102,46,1qt361,20,So what if pokemon were real and they were used to fight wars with other countries What would be the most brutal attack to use on enemies,If pokemon were used for warfare what would be the most brutal attack to use on enemies,66
benxxrd,108,14,1qs97y,21,Can be anything Movie person country ANYTHING,Whats something that you wish didnt exist,35
Agent,83,13,1qs7z0,18,,What is something common that people should know but they dont,31
KoloheBird,64,9,1qrt5s,22,My husband and I are both gamers but because we have totally different tastes skills and skill levels there arent many games where we can play togetherSo what often happens is we watch each other play rather than playing together usually the one watching will be doing some other task on the sofa while the other is playingWe even help each other out by being a second pair of eyesWhat are yours some of your favorites and why,What is your favorite video game to WATCH someone else play,31
Spudgunhimself,83,14,1qr4wq,20,,What is a profession that could never possibly get replaced by robots in the future,34
Bouganvilla,26,2,1qqwsf,22,,Parents of reddit did you immediately love your child when they were born Or do you begin to love them over time Did you want kids,24
CaptainDirtyHook,96,11,1r8qrl,38,,What movie would make the worst musical,49
gingerpheonix,23,2,1r7h1d,21,,What did you get taught about being an adult when you were a kid that was complete bullst,23
drtreadwater,70,3,1r6yyt,19,,If your pet could suddenly talk to you tomorrow whats the first thing it would say,22
Discardodo,177,13,1r4c84,20,,Whats the best tv show that only lasted one season,33
condorama,29,9,1r45aa,18,I have no clue if anyone can answer this and it may very well be pointless conjecturing Sometimes the mind just wanders,If a human could live indefinitely how long if ever would it take for the brain to run out of capacity for new memories,27
YeahYeahNo,135,13,1r2m0w,21,,What is something you love to brag about but never get the chance to,34
catpat,77,19,1r1te6,20,Example An American urologist bought Napoleons penis for ,Reddit What is the most unusual fact you know,39
bloodycyclist,31,5,1r1s0z,19,,Whats the scariest dreamnightmare youve ever had,24
opticalpower,47,1,1r1ams,19,Context Never had pets growing up parents said no and now i have two kids teen and near teen and I feel theyre missing outIm afraid that Ill mess it up or not know what to do I dont want to hurt the dog through ignorance at the same time I feel scared about another life Id be responsible for,Dog Owners What one thing would you tell a person whos never owned a dog but wants to get one to be wary about,20
JeepGuy,35,13,1qzsxz,19,I am not musically talented in anyway shape or form so I am curious to know what a musician is feeling or thinking when they are singing on stage and close their eyes during a high note or a part of the song they feel strongly about I know there is a ton of emotion attached to the musiclyrics and I always wondered what a person was feeling that they would have to close their eyes to hit that line just right even when they are infront of a crowd of thousands ,Musicians of Reddit Why do you close your eyes periodically when singing on stage or hitting your high note,32
Cameramanmanman,150,12,1qwyd2,20,,If you could enter into any video game world which would you choose,32
plowerd,104,9,1qvvdc,18,,What is some small pointless thing that you get unusually proud of,27
JoseNotHose,63,18,1qveg9,18,What happened How did it go as in putting the dime in her jukebox,How awkward was your first time nsfw,36
ShinryuLives,22,4,1qvar5,21,Messed up title i ment to say do IN public Sorry folks,Whats the craziestweirdest thing youve seen someone do it public,25
thenevz,66,11,1qv9lq,20,,If you could replace your fart noise with any other noise what would it be,31
weezerluva,4,12,1qtjmm,19,,People of reddit with terminal illnesses how did your views of the afterlife or religion in general change after you accepted your diagnosis,31
DoctorWaluigiTime,106,12,1qrdao,19,,What word have you always pronounced in your head incorrectly until someone told you otherwise,31
Ifishyy,47,13,1qr3gq,19,What is something frowned upon in your culture but not so much in other cultures,What is something frowned upon in your culture but not so much in other cultures,32
JJean,152,19,1r8tj2,39,I have noticed that as I have gotten older the number and quality of books that I have read that dropped substantially  There are several thing about myself that I want to changeI do not even want to be recognizable as the same person by the end of next yearI want to know what your absolute favorite book is  It can be about any topic at all with the sole exception of religion there is just no interest there at all  In fact it does not even have to be your favorite book  Did you write a book that you are especially proud of  If I can find it I want to read itMy goal is to read every book that gets listed  Hopefully there will be a lot of responses and it will take me a while to get through them all  That would be a good problem to haveEdit  Thanks so much for all the suggestions so far  Keep em coming,What is your favorite book of all time,58
RedHeadedWonderChild,88,7,1r8ply,33,,What uncommon misconception did you have as a child that went uncorrected for an embarrassingly long time,40
larrythemariachibear,133,8,1r6q6e,19,,What bothers you more than it should,27
BladesofChaos,72,11,1r590y,18,,Programmers of Reddit how would you sum up a movie in just a few lines of fake code,29
hereiamhello,100,28,1r4qdf,15,,Reddit what is your holy crap this is a small freaking world moment,43
errorcode,71,7,1r42p1,18,Not including electronic devices such as cell phones ipods tablets etc,What is  thing that  years ago people would never thought of as cool or popular,25
LordBitington,44,5,1r1mp8,20,Some might have a completely different meaning if youre a male or femalesome might not Feel free to remove your pants or someone elses repeatedly as you read throughA couple I enjoy to kick things offTheyre little footballsor Its alive its aliiive,Whats a great movie quote to say while removing your pants,25
countryskyglow,109,4,1r1dqy,18,,What was your favorite book as a kid,22
TyBenschoter,71,13,1qzfg9,17,List your best and worst and your rationaleEdit Wow weve got nearly the whole globe covered Im suprised Canada did so well,What would be the best and worst countries to live in during the zombie apocalypse,30
TakeTheFuckingGum,98,9,1qz8wb,17,,Which is the saddest lyric you have ever heard in a song,26
videosmash,43,8,1qyl5f,19,,Whats your best cheesy joke,27
justinabsentia,62,12,1qxqdd,16,,Retail employees of reddit what is it like to work on black Friday,28
wdswds,41,10,1qx5p4,17,,Redditors in relationships whats something youve been wanting to tell your SO but have been too afraid to tell them,27
Gonadsoldier,60,8,1qw7to,17,,What is your favorite trailer for a moviegame,25
gatorly,73,8,1qw0k5,19,Irrational Unwarranted Plain silly I want to hear about it ,What is the dumbest thing you are worried about,27
ajlamoreau,47,16,1qv63v,17,Chicken fish cows None really stand out to me as my first choice to eat Is mankind missing out on something,Strictly based on appearance what animal would you guess to be most delicious And why,33
fionacinderella,5,5,1quw0s,18,,Doctors of reddit when did you start to feel like an actual doctor not just a med student,23
coppolapsu,35,20,1qsmf0,19,,Longshot but has anyone ever faked their death Howd it go,39
apartmentpantss,37,6,1qqzn2,19,Both my boyfriend and I have not lived with any significant relationships before each other He is  I am  What is your experience and advice for someone in this situation,What are your challenges of living with your SO,25
littlechristine,83,9,1qqwiz,18,,If you could jump into a giant bowl of anything what would it be,27
TheHeroicZ,92,5,1r7gbi,17,,What is your movie guilty pleasure,22
ArtichokeBatter,55,6,1r6jqx,19,,What is a concept that is impossible for you to wrap your brain around,25
nightpanda,86,8,1r5w0e,16,,If you could reset your life back to any point just once and retain all the knowledge you have acquired where would you go and why,24
SlothmanProphecy,51,13,1r54pl,17,,Reddit your life is to be condensed to one sentence how does it read,30
abenyishay,112,18,1r4sxc,18,,Whats the best piece of advice youve been given,36
Chrono,115,8,1r3i9r,17,,If you could be instantly good at one thing what would it be,25
ImmaGrownAssPigeon,71,11,1r3f1s,19,I dont necessarily believe that anything will happen after death but I think the idea of reincarnation seems be pretty neat I like the idea of getting another chance at life getting a new identity and everything It just sounds awesome unless you are reborn as a cockroach or somethingWhat would you like to happen after death,Reddit what would you like to happen after death,30
yeahLCD,91,22,1r3a0m,17,Go on then give us a story,Males of Reddit what typicallyfemale activity have you tried,39
ScottyFromScotland,84,6,1r35xk,18,,What is your favorite Saturday Night Live skit ever,24
ObviousBicycle,121,7,1r2526,17,,Which scene from which movie always always makes you tense upcry,24
stemh,54,7,1r22p1,19,,What great film has lost its charm because youve watched it too many times,26
LaxesGlasses,62,5,1r1p6e,18,,Reddit what do you think about at night,23
EarwaxPanties,79,4,1r1gij,18,,Whats a movie scene that gives you the chills no matter how many times you see it,22
kotula,55,4,1r1aow,18,,Whats the worst experience you had with racism,22
Throwaway,56,12,1r0r49,16,Edit Additionally how did you discover them,Reddit what are your strangest fetishes,28
DarwinDanger,64,5,1r0p4j,17,,What is a phrase you could say today that wouldnt have made any sense whatsoever just  years ago,22
Grabsy,92,9,1r0676,16,Be as descriptive as you likeEdit Thanks for all the replies guys keep them coming,What is the most pain youve ever been put through,25
dasfooksy,91,11,1qzz3e,15,,What is something you have experienced that was incredibly hyped up before you did it only to be meh,26
LonigroC,184,17,1qzmkz,21,,Whats one stereotype that you actually agree with,38
reckless,69,4,1qzj3w,19,,If you would own a classic car which one would you own,23
doorsdown,80,14,1qz78u,18,,What is one cool internet trick you know,32
trevics,75,14,1qypcj,16,This has likely been asked several times in the past but Ill ask again and start Ive done a lot of things Im my life that Im not proud of and have often times found myself in a tremendous funk because of it Ive owned a lot of animals in the past but after a particularly dark period in my life I adopted a dog that literally saved my life and became my best friend When I met my wife she had two large dogs as well and after an initial getting to know you period they all became a good pack One day after we had all moved to a new state  two of the dogs started fighting viciously but we were able to separate them  The third time this happened the fight was so bad that our kitchen looked like a murder scene  At one point as we struggled to pull them apart one had the other by the nose and punctured him near the eyes so that it was bubbling out My wife ended up with a broken finger due to the ordeal We loved those dogs like they were our children but she said mine had to go All of the shelters in LA were full and he was so injured that I couldnt find anyone to take him The vet reluctantly agreed to put him down  but I was so distraught I couldnt be in the room with him for it TLDR I wasnt able to be there for the dog who saved my life and I regret it more than anything every day ,Reddit what is the one thing you most regret doing in your life,30
buttholeballs,78,7,1qy6ad,16,,What is something you cant unseeunhear,23
DarkxAngel,130,14,1qy5ia,17,,Reddit if you were given an unlimited supply of your favorite food or beverage and there were no negative side effects from consuming your favorite food or drink what would it be,31
HippieIsHere,68,9,1qxbxe,17,Answer is in comments,What is the hardest thing for you to NOT do,26
Deathproofer,116,11,1qwk5p,15,,What will instantly make me unpopular in your country,26
mandywydnam,70,17,1qwerj,15,Some stores are opening earlier and earlier on Thanksgiving Day  Do you camp out overnight to hit the early morning sales,What are your thoughts on Black Friday shopping,32
seeyouinvancouver,40,6,1qwe11,17,,What is something that you unknowingly had in your possession which you had a hard time explaining to someone,23
Freeeshooter,128,13,1qvyyx,15,,What song is stuck in your head right now,28
pgabra,72,7,1qvrnv,17,,Who in your opinion is the greatest human being to walk on this earth,24
zsalloum,59,11,1qv8cm,19,,Reddit whats the ONE thing that you were tricked into doing that you will never do again,30
fuzzygoo,11,10,1qv40t,15,,Cops of reddit have you ever pulled over an off duty cop What was it like,25
goranistan,52,6,1qu833,19,Long ago a friend said to me The truth comes out when youre drunk just kinda in the middle of a sentence when we were at a bar To this day it pops in my head every time I witness drama on a night out drinking What are some eyeopening things people have said without even thinking much about that has made a difference in your life,What did someone say to you in passing that stuck with you your whole life,25
KFC,57,13,1qtjbq,19,,what is the funniest insult you know,32
rossallen,180,13,1qt9bt,17,,Girls of Reddit What items of clothing instantly turn you off a guy,30
NDepths,137,7,1qt4hg,18,Name only the quote ,Whats a quote from a movie you know in which others would have a tough time guessing,25
Thor,53,12,1qsk9v,17,,Reddit what is the best response in a job interview to the question What is your biggest weakness,29
pepsiguy,65,11,1qsix0,16,Fun things to do historical significance naturewildlife,Reddit what is the coolest thing about where you live,27
Elias,10,20,1qs95u,15,,in what way does a deaf person think,35
rkarwecki,54,6,1r8es6,21,,What song would have a completely different meaning if it was sung by a different artist,27
THallewell,69,4,1r7394,17,Sometimes people claim some experiences seem to slow time Has this happened to you If so what was the longest feeling  seconds of your life,What was the longest  seconds of your life,21
jeffreywriter,40,9,1r6n07,17,For example I was looking up a word in my dictionary and stumbled across sinistral which of course sounds dark and scary but just means lefthanded or on the left Etymology is definitely interesting  its derived from words like sinister meaning evil or unlucky  but current meaning isnt too sexy ,What is a word that sounds interesting but has a mundane definition,26
Hoggzeh,53,8,1r6jva,18,,What do you think is the single most influential decision of the th century,26
DeacanCheese,30,1,1r45pr,18,If so is it in positive or negative ways Please if any of you are still with your first loves Id love to hear your stories,Regardless of your love life right now do you ever still think about your first love,19
BenevolentTruculent,61,23,1r3q2w,17,,Men have you ever almost lost your genitals,40
Weed,146,9,1r3ky1,17,,What is the absolute worst movie you have watched in its entirety,26
Quartzee,67,10,1qz7ce,16,So you guys havent seen Brewsters Millions so here are the rules You cannot have any assets to show for the  million You cannot just waste the money in any wayIf you can follow those rules you will inherit  million,How would you spend  million in  days if you couldnt tell anyone about what you were doing aka Brewsters Millions,26
Haze,32,4,1qyleu,16,,What are the small acts of kindness that occur occasionally and make you smile,20
Chazele,115,17,1qy7ic,16,,What is the WORST superpower,33
DeEenhoorn,71,13,1qwis6,16,Someone always has a better story to tell but every one probably has this one story that cannot be beaten,What oneup category have you always won and with what story NSFW,29
doorsdown,67,15,1qwimf,15,,You can write a  sentence note to your past self from any point in your life What do you write and why,30
exotool,8,11,1qwhr5,18,Is there a trend in makes or models,Tow Truck Drivers What vehicle do you tow the most due to mechanical failure,29
Signitupben,81,7,1qwhgt,18,In a single word or sentence how would you describe or identify the person youve becomeThink outside the box,How would you identify yourself,25
AnalyticLunatic,113,9,1qwabs,15,,Reddit what is on your Christmas List,24
Cocainesamurai,159,11,1qvy60,15,,What is something that society frowns on that you think is acceptable,26
Eeclipse,7,4,1qvqe4,18,If you have won a substantial amount of money let us know when and what you did with it and if you still have any left ,Redditors that have won a substantial amount of money what did you do with it and do you still have any left,22
zippo,55,14,1qvjag,14,,Reddit what is your favorite movie quote of all time,28
missheatherfair,22,6,1quibt,16,,Is there a time where you absolutely did the right thing in a situation but regret it to this day,22
karmacomic,90,5,1qui6z,15,Lets hear it ,What is the one song or artist you absolutely hate and why,20
McLovinIt,102,12,1qu4dk,16,,What is something that you feel should be illegal but is completely legal to do,28
NamenRoodles,41,12,1qu183,18,,Reddit they are making a movie based on your life what actor plays you and why,30
invertedmatrix,40,17,1qtoqs,15,,Prison guards of reddit whats the craziest thing youve ever seen an inmate do,32
miladystark,49,16,1qtliu,16,,How do you cope from a breakup,32
Puz,50,5,1qt6gr,17,,What was your biggest what the fuck am I doing here moment,22
loganrunjack,80,11,1qsnxh,15,personally to name a few I would go with aliens shawshank redemption and the first ninja turtles movie,movie fans of reddit whats a movie you could watch over and over again no matter how many times youve seen it,26
roastedbagel,22,4,1qsm8t,15,,Serious Whats the smallest gesture that had the most profound effect on you,19
jjmastersword,31,5,1qs6bs,15,,Whats the sketchiest thing youve donesituation youve been in,20
Neosantana,79,9,1qrysr,16,The serious tag was just to avoid the inevitable Baby dont hurt me no more posts,Serious What is your personal definition of love,25
SteamySpoon,33,2,1qqyq8,16,,What is something a friend of yours does that you think they should feel guilty about but dont,18
derpydayz,47,2,1r8vlz,23,Doesnt matter wether or not you will be alive at the time,What is something you are NOT looking forward to in the future of mankind,25
Taybyrd,64,12,1r7opz,16,Assume there is an unlimited amount of material at your disposal Go,Whats the first thing you would make if you had a D printer,28
Hexodus,67,8,1r73fn,15,,What was the stupidest thing your SOex got mad about,23
redditoija,119,19,1r5rap,15,,Time travel is possible What band are you going to go see play live and why,34
EmersonikMusic,51,3,1r5jj1,16,,What is something you never see on Reddit,19
scarletsaint,128,13,1r4s8g,15,,What is the most insulting thing someone has said to YOU,28
JoeTuck,133,26,1r4j46,16,,Whats your favorite nonsexual feeling,42
CheifKief,42,2,1r3n6a,15,Just a general question of curiosity Maybe some people here can even help you out,Reddit what are you trying to get better at,17
DanMcallen,104,12,1r3lc6,17,,Men of Reddit who are your biggest man crushes,29
gogiroux,74,3,1r1beq,16,,Reddit what would you do if you caught an intruder in your house,19
Dubstyles,50,3,1r1236,15,,If you were to become a dinosaur what kind would you be and why,18
SDGuy,36,8,1r0xpq,15,My fiance said she would prefer it if I was cut Im considering it because I love her Tell me about it,Anyone been circumcised as an adult How was that,23
throwawaygult,44,10,1qzqn3,17,Hello seeing as I frequent this sub a lot I decided to give this question a try using a throwaway in no small part due to being ashamedIve been having a lot of issues as of a year or so when it comes to being a decent human being I dont like people at times I even despise them The only people I like are gone or unavailable to me Before things got like this however I was also a part of the herd doing stupid things without thinking of consequences I hurt someones feelings many years ago for no reason and never apologised for it The guilts been haunting me over this in particular next to a wall of other things for so long its almost always on my mind which is why I tend to keep busy in any way possible gotten to the point where Id rather do anything than think about the pastHeres my issue  apologising would fix nothing in my opinion Shes better off without me and Im not really a part of her life any more only a past thats irrelevant Opening up contact right now would do her no favours and I have no intention of causing her any more grief because shes a nice person unlike meTLDR Obvious solution to guilt is asking for forgiveness not an option available How do you  keyboard warriors gentlemen scholars and ladies  cope with your guilt no matter what the cause behind it Im having a tough time being a human being and could use a lesson,How do you get rid of guilt,27
pynchme,33,4,1qyz3o,16,This is a chance to share the wisdom of the ages,Do you have any pieces of wisdom that you gained from a parent or grandparent,20
SingOneForMe,22,5,1qyawu,14,,What is the best way youve found to make new close friendships posthigh school,19
RegretDesi,71,12,1qy4hc,15,If you dont have a pet cat pretend you doEDIT You do remember the dream and what it was like to be a humanEDIT PART TWO Dammit all of these make me want to be a cat Does anyone know where I can sign up,You suddenly wake up to find out that you are actually the pet cat of the person you believed to be yourself What is the first thing you do,27
killerontheloose,44,6,1qy42i,14,,What fictional situations do you put yourself in while thinking to yourself,20
noodletune,74,7,1qxysw,14,Preferably one that is available on Netflix or Amazon Prime ,What TV series do you and your SO watch together and both enjoy,21
kalifadyah,30,4,1qxuuk,16,,Have you ever had a near death experience,20
Selifa,49,6,1qxeqv,16,I have been reading askreddits all week and there are a lot of messed up stories about incest molestation sexual experimentation etc Do any of us get out of childhood unscathed ,Did Any One Out There Have A Happy Normal Childhood,22
tendsforgetstuff,30,15,1qwx75,15,,Why should lurkers stop lurking on Reddit and join in,30
Gfnation,35,3,1qwjms,14,,What is something weird that you do when youre nervous,17
CiliaMoss,61,4,1qvnyu,15,,Nonsmokers of reddit what do you think of people who smoke,19
Cshock,77,6,1qvhbg,15,I think Breakout Kings is what comes to mind for me I need new shows so lay em on me,What is the most underrated television show that you know of,21
GoopyChild,74,7,1qv7s3,16,,In  words or less what can you say to make someone punch or slap you,23
AzazelTheFox,31,6,1qv65h,15,Throwaways welcome as usual just be serious  Interested in what people consider to be their worst personal action and whether or not they feel regret,Serious What is the worst thing you have ever done and got away with,21
nateoroni,58,12,1qv5nt,16,Everyone has things about then that sucks,Whats the worst thing about yourself,28
slowwber,39,3,1qv08u,15,Most of your country will be watching you doing something famous but at the very end of your time on TV you have the chance to promote a particular product By doing so you get an unlimited supply of it for the rest of your life What would it be,You have  seconds of national TV time what product would you endorse so you get it free for life,18
durnsquiddly,38,9,1qsyig,14,,If we all threw our problems in a pile and saw everyone elses wed grab ours back Reddit whats your problem,23
Walnutterzz,24,5,1qs7ro,13,,Married redditors what is something youve done that you would never think about telling your SO,18
SpartasGreatest,25,5,1qrxev,14,Whether in public or when they thought no one was watching,What is the weirdest thing youve seen someone do,19
arshbot,49,19,1qrfpt,17,,What is the most fucked up thing youve ever accomplished in your life NSFW,36
ellendeclitoris,157,40,1r8mwd,14,Could be between you and a teacheretc,Reddit what is the most obscene dirty thing that a teacher you know of has been involved it NSFW,54
spartanau,95,11,1r7up5,13,,Whats something that seemingly everyone does but you find strange or weird,24
monsoonorchid,23,3,1r7ihz,14,Most atheists are thinkers on some level if not on many levels  And when unthinking dogmabreathing people of faith try to convince them of the existence and importance of the divine the arguments those individuals put forth are unlikely to be at all convincing to the atheist they hope to convert  More often than not  theyre just driving more nails into the coffin of the atheists growing conviction that religious people are stupid  I think you know the kind of arguments Im talking aboutBut not all religious people are dullminded superstitious and antiscientific If you are an atheist what are some points a spiritualreligious person could make that might pique your interest or gain them your respectIf you are a believer what are some intelligentuniversal points you like to make when discussing the matter with people who do not share your convictions     ,What are some spiritual arguments that appeal to atheists,17
JacobButterStick,46,15,1r6yzh,12,,What will be Reddits demise,27
sillycaramel,23,0,1r6y99,14,No matter the source whats the best headline youve come across,What is the best headline funny or serious that you have ever read,14
EspressoMagic,91,7,1r6umy,14,,What is your favorite video game soundtrack,21
dehrmann,97,14,1r6ml7,12,,What brands do you judge people for wearingusing,26
GoDucks,28,6,1r5utc,15,,What is the worst disgusting funny dangerously stupid etc thing youve ever done on a dare,21
ThatKidYouKnew,61,21,1r508h,13,What store What were they purchasing,Cahsiers of Reddit what is the most you have ever seen someone spend in one transaction,34
scarletsaint,61,9,1r4suv,14,,Those who were bullied What would you say to your bullybullies right now if you could speak to them,23
greenkoala,12,1,1r4ddq,15, ,Redditors who work drivethru windows fast food banks etc whats the strangest thing youve seen in someones vehicle,16
ObtuseRightTriangle,43,3,1r451g,15,Only ,If you could become the best at one skill what would it be,18
BAHMonkeyman,43,6,1r3w06,14,,What sentencelong quote will make me rethink my life,20
astit,80,8,1r3jsz,15,Who is the biggest jerk  Who was the nicest  Any other thoughts,Who is the most famous person youve ever met and how was your interaction with them,23
selfishcoffeebean,25,22,1r33d3,14,I find it fascinating that someone can go from not believing in a higher power to having complete faith in one  Can you explain what it feels like to believe  Was there a major life changing event or did you want to fill an emptinessSpecific religion doesnt matter but it would be interesting if youd write which one you chose ,SERIOUS Former nonbelievers how did you find religion,36
kvnmahan,107,14,1r25hi,14,,The the chronically late redditors why are you always late,28
smitty,64,2,1r131g,15,Just looking for some ideas to brighten random peoples days ,Hey Reddit What are some simple awesome things I can do for random others to make their day,17
ABlackwelly,57,6,1r0p6c,15, ,What are the the most significant words in human history,21
slyg,9,3,1r0nlx,14,Im particularly interested in people who got reasonably far or got some tv time in talent shows But im not sure how many people on reddit from this type of show so i kept it broad So here are some of the things im interested inDid the show help your career Do you have any interesting stories related to being on the showDid you get many people recognizing you from the showIf you won some money what did you spend it on,Ex tv show contestants what was it like after you left the show Serious,17
MickeyRooneyy,112,17,1qzhhq,13,,What is a small opinion you have that no matter what anyone on reddit says youll never change,30
PallandoTheBlue,75,8,1qz8dc,16,,What were you known for when you were in school,24
YetiGuy,235,9,1qz88o,16,You know everytime you hear somebody pronounce a word you wonder why it is pronounced that way ,What pronunciation annoysbaffles you,25
Greenmaxn,64,9,1qypwy,12,,What is something you took for granted as a childteenager but now think is highly valuable as an adult,21
marvinnohomo,53,4,1qyayk,14,EDIT If you guys could post a youtube link with your post thatd be for the best,If you could choose what song you hear when you die what song would it be,18
ACForLife,23,5,1qy23y,12,,Reddit what was you biggest what have I done moment serious,17
mxo,52,4,1qxy52,13,,Whats the dumbest thing someones ever gotten mad at you for,17
fredburma,34,4,1qxb92,15,I love it when everything clicks at the last minute and the final piece of the jigsaw slots into place so perfectly but you have to invest a lot of time into these things and you often end up being disappointed  So really this is a cheat sheet where should I go for my plot twist fix,Whats the most satisfying plot twist youve ever seenheardread,19
mooreseen,40,8,1qwhwx,16,For example original comment is I dont like the color red And people respond trying to sway your opinion ,What is an opinion you have that you want debated,24
LightOfVictory,19,4,1qwd5d,14,Those pictures or GIFs that keep you up all night change your views forever Stuff like that,Reddit what picture or GIF brings fear to your heart,18
BRICG,14,9,1qv4ck,13,,how do you know if youre thinking too far ahead in a relationship,22
Magickoolaid,73,9,1quvdh,14,,Which fictional character would you mostly likely want to have give an AMA,23
basicshow,69,6,1quv8d,16,,When you were a kid what did you want to be when you grow up,22
fanggoria,70,7,1qurde,13,,What is the most tragic way someone you knew died,20
fourboobs,130,28,1qua1t,14,,Your username is now a cocktail How do you make it,42
butterflypn,178,18,1qu696,15,Dont downvote people because they put up a belief that might offend you Im trying to get some interesting answers and I dont want any rSRS butthurt downvoting,Selfproclaimed nonracists of Reddit what is a view you hold that might be considered racist,33
LordOfAllGays,38,13,1qu116,14,,What racial stereotypes does your country have that American wouldnt know,27
Nicopm,48,13,1qt55c,13,,What is something that is taboo but shouldnt be,26
captainzoobydooby,95,8,1qsz5p,15,,What is the worst possible pain you could ever imagine experiencing,23
syntheticidols,91,10,1qs0c4,15,,Whats your party drink,25
SheZowRaisedByWolves,51,8,1qrexc,13,Im talking about questions like what if your skin was replaced with snapple What if avocados exploded with a football field radius when peeled What if you could shit happiness,What is your best what if question,21
Deathproofer,28,6,1qrehb,14,,How would you hold up in jail,20
Jefflello,50,9,1qqyfl,15,Maybe its the anonymity but Ive noticed people are absolutely brutal in their comments here Racial slursobscene insults rude remarks Is everyone just an asshole on this site or what,Why is everyone so mean on reddit,24
remotectrl,51,6,1qqkg5,14,,Assuming it was ethical and sustainable which animal would you most like to eat,20
Sirusavath,90,4,1r8ubg,24,,What is a sound in a video game that youve grown to hate,28
giraffaclops,62,2,1r8u92,17,,What is something you have to buy but you absolutely hate to,19
megadodgerfan,41,2,1r8p7p,18,,What are the best music videos you know of,20
JeremyTheMVP,104,6,1r86v8,14,,MoviesTV that scared you as a child,20
therealraybeam,79,11,1r7k48,12,,How did you discover reddit,23
calym,38,1,1r7dvy,14,,What book have you read that changed you,15
EmilyamI,50,9,1r7d63,14,The obvious response here being touch his penis but what are some specifics that you enjoy that you think might elude women or that you wish more ladies would do in bed that contrast some of the ridiculous Cosmo suggestions,Men of Reddit If You Wrote A How to Make Your Man Go Crazy In Bed Article for Cosmo What Tips Would You Include,23
MissLexxxi,106,7,1r7cjx,12,,What late night snack are you craving,19
DarklyGlass,56,2,1r7bps,14,I mean what points of view will get systematically downvoted and therefore less likely to get exposure,What opinionspoints of view are forbidden on Reddit,16
YOUWENTFAR,99,11,1r79jz,14,,Growing up what did you believe about the opposite sexs anatomy that turned out to be extremely wrong NSFW,25
souperglen,67,17,1r4xiq,12,,What are some taboos in your country,29
ChinaCatSunfIower,29,1,1r3yiq,13,,What is the grossest thing that has ever entered your body,14
LoveForChrist,42,5,1r3sy0,12,Im thinking about how people on my campus work themselves up easily over just about everything and Im wondering if I were to hold up a sign on campus with a literal scientific fact what fact would make the most people angrythink I was a terrible person,What scientific fact do you believe people would find most upsetting,17
overexposedrebel,35,32,1r3ete,13,,Men who have had your significant other give birth Honestly are you as attracted to your partner now as you were before she had kids,45
filosophikal,41,5,1r21hc,13,,If you were allowed to pass one law that everyone would have to obey what would it be,18
phattykins,34,3,1r1v69,12,,If you were allowed to create a public holiday what would you celebrate or commemorate,15
shibalover,31,3,1r1lp5,13,,Whats the most innocent thing youve seen go wrong,16
zoobyshoe,127,2,1r1ld2,14,Havent seen a show as addicting as Breaking Bad in a while and I want o pick up another series to watch Been recommended theseAmerican Horror StorySix Feet UnderHomelandThe WireScandal,Just finished Breaking Bad Any other engaging series I should watch,16
TheRealDropBear,19,10,1r1kda,13,,Porn Stars of Reddit How has your career affected your sex life NSFW,23
ONYXROC,23,2,1r1jpz,13,,What is the most awkward situation youve awaken in after a night of getting wasted,15
EmersonikMusic,41,7,1r1gmg,13,,What is your favourite obscure quote,20
atomicrectum,62,4,1r1bmo,14,,Whats something you wish you were exceptional at but currently suck,18
LordVectron,46,6,1qzup8,12,There are a lot of comedy and parody musicians out there Tim Minchin Flight of the Conchords Tripod Axis of Awesome to name a few Some of their songs are just silly some are silly and amazing to listen to at the same time I wanna talk about those ones ,What are the most musically impressive comedy songs,18
Meatsause,9,3,1qzcpq,12,For someone who has social anxiety,Where are the best places to meet people socially,15
SaidNil,62,7,1qyokd,11,If youve decided that one or more of those things are not for you why Please be respectful of the opinions of others,What is your personal reason for abstaining from sexdrugsalcohol Serious,18
apple,40,6,1qyjur,12,, of the population is dead what is the first thing you do,18
echtav,35,3,1qyffv,12,Could be nostalgic or tragic Go,What do you miss most about your childhood,15
Blahty,54,14,1qydg1,12,,Males of reddit What do you do while you are receiving a blowjob NSFW,26
deadball,64,7,1qyc2z,11,,What did you decide to study in college and why did you choose it,18
RLWSNOOK,44,3,1qyaho,14,,How do you get rid of a hangover,17
Mithost,34,2,1qy5sn,13,,Hey Redditors what was the WORST Christmas gift you have ever received,15
qwerb,30,2,1qvut4,13,,What makes you happy Reddit,15
pattyperk,10,4,1qvq1m,12,As a twin I know there are a shitload of things that people believe but are simply not true Help me relate,Twins of reddit what are some major misconceptions about being a twin,16
IchabongCrane,66,3,1qvpz0,13,,Tell me about you Reddit If you had to describe yourself in one word what would it be and why,16
atumbleweed,73,5,1qvkpu,13,,What was your last text,18
fuaA,29,8,1qv9w2,12,,What is a quick and easy meal that everyone should know how to make,20
thepkmncenter,24,1,1qv9to,12,,What is one topic that you embarrassingly know very little about,13
BiscuitBrown,87,9,1quzhc,13,,Reddit how do you get to sleep,22
ntb,62,8,1quxsm,13,,What sound do you just hate with all you have,21
actuallyno,33,11,1quwf8,14,,Married people of Reddit how did you meet your significant other,25
AriesAviator,40,3,1qutjg,13,,Computer techs of reddit what are some simple tricks to help keep your computers running smoothly,16
mufromdeneb,69,5,1qur3g,14,,Reddit what is both your gift and your curse,19
WolfFather,26,9,1queoy,13,As a university student applying to internships and jobs I would love some advice ,Hey reddit how do I write a stellar resume,22
cookiesmasher,48,5,1qub81,12,,What simple thing fascinates you,17
coconutelectron,78,10,1qu11m,12,Good experiences would help us live vicariously through you bad experiences would help us feel less envious,Tall Redditors Whats an experience you can share so we short people know what its like to walk in your large shoes,22
kabukistar,20,5,1qt5lw,15,And not just things that are considered abhorrent by small bitter sectors of society like homosexuality  But something that almost everyone agrees is wrong,Reddit whats one thing thats considered morally abhorrent now that will be considered totally normal in the future,20
thecuriousduck,16,6,1qsypt,13,,Is it weird to like to help people but when its you that needs help do you have problems accepting it or asking for it  Is it your pride or just plain shyness ,19
mpghjacket,47,15,1qss7c,13,For scienceof course,How did you ask your significant other out,28
wintonhowzer,37,11,1qsr2m,11,Things like number of highfives given or cats petted ,If after you die you get to see a stat sheet of your life which five stats would you want to see,22
nickharl,62,2,1r8shi,19,,Whats a method or technology that seems incredibly dated but that we still currently use,21
JackedDown,15,6,1r7mgl,12,I only ask because me and my father have a very distant relationship Ive asked all that I can from him but it hasnt really struck a nerve yet I really want to open conversation with him beyond us beind drunk and shooting the shit He and my mother seperated when I was young and even though sharing some beers has given me some answers I still feel like I want to know him more So reddit I come to you Single fathers divorced fathers step fathers father in laws anything what do you think a son should ask you,Fathers of reddit what question do you wish your son would ask you but he hasnt yet,18
ffrancescah,30,4,1r7f39,13,And has your experience helped you help others,Everyones been bullied at some point whats your story,17
MrRansom,43,5,1r7c3e,12,,What is one thing in your life that youve lost and wish you could have back,17
megalojake,35,4,1r6s77,12,What are some phrases that people say in a bunch of movies but just do not workhave any affect IRL,What phrase works in movies but doesnt work in real life,16
DerHammer,61,8,1r6pnz,13,Be it horrible or hilarious whats your bathroom incidentEdit Possibly NSFW,Reddit whats your bathroom incident,21
NamenRoodles,92,31,1r6pkp,11,,Reddit whos one celebrity that you know for a fact is gay but hasnt come out of the closet yet,42
Coolspot,74,13,1r68t0,12,,What should you never say to the opposite sex,25
DaBahoo,86,15,1r6482,14,,What has been the most frustrating worst experience you have had on reddit,29
ColligeRosas,58,5,1r63wq,12,,Which TV show has opening credits that never get old Which shows credits do you always skip,17
ZatarainsFood,104,17,1r60gu,11,,Youre on your deathbed and can only say  words before passing What are they,28
StillLifeWithDog,7,4,1r5tqf,12,,Seniors of Reddit Tomorrow is the th anniversary of John F Kennedys assassination Where were you and what were you doing when you heard that President Kennedy had just been shot and killed How did you and those around you respond,16
Lolliee,67,4,1r4rnx,14,And makes you want to shake your booty,What song puts you in a super happy mood,18
cuckoo,48,9,1r4qln,14,,Whats your tip of making conversation with people,23
chickensaurus,41,8,1r4k71,11,Since we are just about to see the th anniversary of a tragic event that changed the course of this country  I would probably have to choose JFKs file  I think it may contain information that could possibly help the future of America,If you could see one classified government filedocument and keep a copy what would it be and why,19
ChannelSERFER,87,2,1r4fik,12,,If you could summarize your morning routine in three words what would they be,14
otpyo,35,2,1r46jy,12,,What types of foodsdrinks should you never combine together,14
BlakeIsBlake,54,9,1r45l9,11,,Whats a phrase that you could say today that would make no sense fifty years ago,20
jazir,7,1,1r415j,11,There was a story just today about the twin prime conjecture which made me ask what use is there for extremely large primes especially prime pairs,What use is there for extremely large prime numbers,12
colorinpink,28,3,1r407t,11,,What is the best advice that a teacher has given you,14
thenewleader,27,4,1r3u1w,11,,Pizza deliverers of reddit whats the weirdest thing thats happened to you while delivering pizza,15
DrFire,28,2,1r3oa7,10,,What is the biggest regret youve ever made regarding money,12
AnotherDrunkCanadian,131,6,1r37mb,12,,Whats the worst name youve ever heard,18
morlokispecs,17,2,1r1j2m,12,Never knew how it felt like I wish I can try it once,Whats the worst sleep paralysis you have ever experienced,14
BenKovy,17,1,1r1bul,13,,What is the ballsiest thing you have ever said to your parents boss etc and do you wish you could take it back,14
logs,3,3,1r0uf2,12,,Teachers of Reddit what is the one horrible situation you have seen your students in but been unable to help,15
nessabessa,79,4,1r0tlw,12,,Reddit What is the worst pain you have ever felt,16
MollyEvelyn,46,10,1qzsvm,11,,What are the three best Christmas movies and why,21
vandamage,41,5,1qze0r,12,,Are you unhappy with your job and if you are what kind of job do you do,17
teenpirit,78,16,1qzbre,10,,What movie title best describes your sex life,26
ProSchmo,62,3,1qzbbz,13,,What is the funniest stupid joke you know,16
mitchellalbertz,177,14,1qzage,11,,Serious Whats your ACTUAL unpopular opinion,25
PandaDerZwote,108,9,1qyuyu,12,Or in other ways not viable to have And what do you say if there are discussions about that very topic,What are some opinions you have that you could never mention to others because they are viewed as backwards,21
laurenisahokie,76,9,1qyl7o,11,,Why do you or why do you not believe in an afterlife,20
Steininger,40,2,1qy607,12,,What is a little known television show that is a must watch,14
SillyPickle,60,11,1qy3e8,11,,Whats the most useless skill that youre remarkably good at,22
hawthandle,30,5,1qxwy2,11,,What are your worst roommate stories,16
Chickenwang,37,1,1qxuqz,14,,What is an insecurity of yours and how do you deal with it,15
ImCelestial,69,10,1qxqg8,13,,What is the weirdest thing you have used to pleasure yourself,23
shma,20,10,1qx0jd,11,For example taking the time to come in and fill out the application right there instead of calling on the phone and asking if the store is hiring firm handshake community service etc ,Employers of Reddit what do you admire in an applicant that usually leads to them getting the job,21
SamuraiRoNiN,57,8,1qww2l,12,Kind of like how Dexter takes a little bit of blood from a cut,Dear Reddit if you were a serial killer what trophy would you take from your victims,20
TheRGood,80,7,1qwugy,14,,What is something that no matter how much it is explained you will never understand,21
vanheltsing,69,7,1qw84t,12,Maybe nsfw,What is your biggest achievement that isnt something you can brag about,19
thesquabroll,40,7,1qvgqa,14,,Extroverts who were introverts what happened,21
IgnoranceReductase,18,2,1qv6dy,11,,Hi Reddit what awkward moment have you had that still haunts you to this day,13
NomFRENCHTOAST,41,2,1qum23,11,,What do you just not understand,13
NeonFights,13,7,1qugpt,10,,Game show contestants of Reddit what show were you on and what was your experience like,17
thespacesinbetween,174,19,1qtjh1,12,Is there anything about England Britain or the UK that you do not understand or get such as words lifestyles or attitude,American Redditors what strikes you as odd about the UKBritain What do you not understand,31
AlexOrozcoo,58,5,1qtdlb,12,Im scared of rippingtearing my frenulum I heard it makes a pop sound when it does,What type of things do you fear happening during sex,17
kdwhodat,24,5,1qsyj0,12,,What malicious advice have you given that was actually followed,17
jrgallag,88,5,1qswjl,13,,What is the best RPG video game of all time,18
meganlizzie,58,6,1qsmb3,11,,Reddit whats the most expensive item you own,17
Wingull,44,8,1qr87p,12,,What were some of your fictional character crushes,20
Dodendans,48,8,1qr6fu,13,Do you have a recurring superpower in your dreams Im not talking about  your Dream Superpower but rather the one that is most prominent,What Superpower do you most often dream you have,21
Iamzecomicgal,12,1,1qqzjf,11,title speaks for itself I cant think of one right nowRedditors I leave it to you,What habits have you instinctively picked up over the years that makes everyday life easier that might be helpful to others,12
isyourself,22,3,1qqq3a,14,,Who is a not commonly known person who really influenced history,17
lacesoutdannnnn,24,33,1qqaxe,9,I havent,Have any of you had sexual relations with a wellknown pornstar before they were famous,42
disproportion,50,6,1r8t2y,16,Im a small person And it seems that no matter how slowly I pace myself I always end up with the spins puking and a hangover the next day Its a buzzkill no pun intended Any tips,How do you avoid hangoversgetting sick after a night of drinking,22
Coverthestory,36,5,1r8flw,11,,Serious When youre sad what do you do to cheer yourself up,16
InMortsJewCave,19,6,1r8f9v,11,Anything that has made you or someone else go What the hell is that It can be anything from a sexual tragedy or just a horrifying moment,People of Reddit what is your best Oh my God what the hell is that story,17
thedmob,57,7,1r8e4u,11,,What is the funniest movie you have ever seen,18
asimpleguy,73,14,1r7ocw,10,,Reddit what is one thing that consistently blows your mind if you think about it even for a second,24
FapstronautOC,11,5,1r6z6m,11,,SelfMade Millionaires of Reddit what is the one thing you know now that you wish you knew when you were starting out,16
nehalwa,41,9,1r6wmm,10,,What are your favourite lyrics from a song and why,19
altuslamia,22,5,1r6uli,11,,Whats the best White Elephant gift youve ever given or received,16
booness,51,5,1r6rff,12,I joined Reddit to ask this question For me I have a constant runny nose out of one nostril only my right one One doctor told me it was a common allergy problem and prescribed a nasal spray that didnt really help Another told me it could be a fungal infection and wanted to pass a scope up my nose which she warned would be painful I didnt do it At this point I just deal with it but its really annoying because I have to carry tissues with me at all times,What is something you live with that is not lifethreatening but really annoying,17
TownIdiot,30,5,1r5x7d,11,Yes Another one of these questions,What is the creepiest andor least successful yet funniest pickup lines you know Boy or Girl,16
chochkem,53,6,1r5p8b,11,,If you could change one thing about the time you lost your virginity what would it be,17
mrsobby,54,10,1r5g5r,11,,Reddit what angers you most about the world of today,21
DragonStriker,43,6,1r4x7d,12,Especially when theres no internet And theoretically all your battery powered gadgets are low on power,What do you guys do to pass the time during a power outage,18
sjsharkgirl,68,2,1r4hu6,12,,What is your favorite quote from a TV show,14
jw,43,9,1r4gu5,10,Mine always seem to revolve around disconnecting my mind from the situation just wondered if this was pretty standard and if not what else do you do,Males of reddit what tricks do you employ to help you last longer in bed NSFW,19
jessk,85,9,1r34m9,13,Two words to guide your past self ,If you could write a note to your younger self what would you say in only two words,22
thewrongpath,43,6,1r30wy,12,Edit I want an example of a good guy company not the definition,What is a good guy big company,18
norrischrism,77,4,1r2ndr,13,,What is your Nobody believes me when I tell them Moment,17
LethalJizzle,39,10,1r2ffo,11,GO,What ridiculously untrue fact can you make up on the spot that sounds convincing,21
ThePuddingRifle,19,6,1r1xsb,12,Met a customer who divorce his wife and remarried again when they met a few years later ,Couples who divorced and remarried again Whats your story,18
WIENERPOOP,19,15,1r1x2u,10,I work with a couple of autistic patients and I want to better understand their struggle,Autistics of Reddit can you help me understand autism,25
bidnessdeals,24,4,1r1tgk,13,Crashes highway ghosts a cow driving a bike etc Whos got the best,Reddit whats your craziest driving experience,17
jivins,23,4,1r1ovs,11,,If you were given  lives and had to use all but one what are some of the top ways you would choose to go out,15
SolidSilk,46,4,1r1cnh,13,,What would be your most mediocre superpower,17
ksuit,48,2,1r16py,11,,Serious Whats your age gender and what about you physically are you most self conscious about,13
Relic,40,5,1r0kar,11,,Out of anyone in the world who do you think should run the planet,16
XavsEatFerns,19,7,1r00h7,13,,What is the saddest story a stranger has told you,20
Ismellawesome,68,11,1r00d1,11,,Whats the worst concert youve ever been to,22
GramatiklyCorrekt,63,6,1qzlxh,11,,Do you have any quirks or irrational things you feel you just HAVE to do,17
Grabsy,17,5,1qyz09,10,Thank for all your replies guys ,What was the post that made you fall in love with reddit,15
CuriouslyBaked,23,2,1qxwey,12,,If you could take any fictional film and make it a part of real world history what would it be,14
Music,60,2,1qxvy9,11,,What food do you REFUSE to eat without condiments,13
opheliadernt,52,4,1qxv1s,12,,What Television commercial do you hate the most,16
Czechmate,79,11,1qxetv,11,Like hawking loogies or something,Redditors What is the least attractive nonsexual thing a person can do,22
agentcoco,57,9,1qwz7e,10,I am considering going in for a LASIK consult to find out if I am a candidate I would love to be able to wake up in the morning and see clearly but I am wondering if it is worth the risk What if something goes wrong and I damage my eyes I will be going to a doctor a few colleagues have recommended and my work provides a discount forWas it worth the risk for you Did you have any problems afterwards Did you regret it I am also studying for some examinations so I dont know if this is the best time to do it Any advice would be appreciated Thank youEdit thank you so much everyone I really appreciate you taking out time to answer my questions I am going in on dec  for the consult I will post an update on how it went ,Have you gotten LASIK done Is it worth it,19
weeekendwarrior,45,5,1qwo63,12,Help me help you ,As a waitress how can I improve your dining experience,17
excynimphica,75,11,1qw325,11,,What is your favorite acronym,22
SexyPenguinth,12,2,1qvt51,10,Title says it all ,What is the closest youve gotten to ruining someone elses life,12
lordinvain,26,9,1qvp6f,11,,What was the best comeback youve ever heard without any swear words,20
BaconIsMyLastName,40,2,1qvmyk,11,Mine are dissescooksburns and then racial slurs,What is something that offends others but not you,13
samuelcrake,22,3,1qvk7n,10,Getting home at  only gives me and my SO a couple of hours together in the evening What interesting things do other people do besides the obvious ,Redditors in relationships  what interesting things do you do in the evening with your SO besides TVMovies and sex,13
liQuidx,71,4,1qvg43,12,,What is THE sound that you hate the most,16
GreenEyesMakeMeHorny,18,3,1qvbrv,9,,Reddit What was the most embarassing phase you had growing up,12
gonzosinferno,24,3,1qvawx,11,Probably gonna have to repost this during better hours but well see what we get Thank you in advance for all responsesEdit I have eclectic taste if that helps,Reddit What are some great songs I probably dont know of,14
enfenry,15,2,1qvaa9,11,,Reddit what are the best subreddits with misleading names,13
MaGiiKStudios,25,3,1qv59v,13,,Reddit whats your best method to make a crappy day into a better one,16
Meatmehalfway,17,0,1qv3sl,13,,Whats it gonna take to get animals back on Animal Planet history back on History Channel and discovery back Discovery Channel,13
foxintheboxdan,22,3,1qupti,11,,How did you ask out your first potential gfbf and what was their reaction,14
MikeyHatesIt,36,4,1qucef,9,,What is an old timey word or phrase that people dont really use any more,13
Princessply,62,5,1qu9ob,12,,What three items in your house do you grab if your house is about to be destroyed,17
Fourleafcolin,36,1,1qu93h,11,,What one question could you ask someone upon meeting them to find out the most about them,12
smugglerscreed,83,9,1qtuy8,13,,What moment from a video game with stick with you forever,22
sinigangnaube,31,6,1qtskt,11,,Which subreddits never degrade in quality,17
rx,17,10,1qtp14,13,,Dear reddit what is your best story of karma biting someone in the ass,23
otterlyadorable,32,6,1qtoht,11,,Redditors who went to college what was your worst dorm experience,17
Jdubs,31,11,1qtntt,9,Ok Im  and have no college education I got a job at one of the most hated banks in America to financially take care of my mom The place makes me absolutely miserable Im grateful it pays our bills but my dream has been to travel the world I dont make enough to even really save money At this point I just want to bail and start traveling but I have no money and it would take me at least a decade at this rate to save anywhere near enough to take time off and travel the way I want to So is it possible to travel absolutely brokeEdit I wanted to start in Greenland and make my way over towards IrelandEnglandScotland I was thinking maybe a boat from the US to Greenland and then a boat to wherever in the UK From there I could do the train to France and from there by foot ,Is it possible to travel the world with no money,20
gatorly,11,10,1qsz1w,10,I feel like constantly trying to be Supermom makes me dwell on my mistakes What are some things you guys wish you had done better or differently in raising your kids,Parents of Reddit what is the worst mistake you made raising your child,20
TheRingleader,17,3,1qss8f,12,Like I really miss running around in the tunnels at Chuck E Cheese but Id probably get arrested or stuck if I tried doing that again,Whats an activity from your childhood that you miss doing but cant do again as an adult,15
allstar,24,4,1qs8ej,11,I have webbed toes My dad brother and I all have them so I think it might be genetically linked to males If I ever have a son I have a built in paternity test ,Whats the weirdest thing about your body that youre oddly proud of,15
BackJurden,56,13,1qqipx,10,,You get to pick two people to fight to the death whether historical or from the present day who do you choose and why,23
Adammit,27,8,1qq6kv,10,Ive got  lying around on a prepaid master card thought it would be interesting to hear your ideas,Reddit whats the coolest thing to buy online for under ,18
wellitlookslike,17,3,1r7lxx,12,,Whats the worst thing youve heard from a wedding speech,15
allforthekarma,11,8,1r7c7c,10,This doesnt necessarily have to be sex related Any instance where a safe word was designated and had to be used is acceptable,What made you say your safe word,18
Whalley,65,4,1r7avj,9,For me I have an essay project test and event due tomorrow All of which are either completed or prepared for I have GAD General Anxiety Disorder when so much is going on I tend to have a difficult time sleeping ,Nighthawks of Reddit What is keeping you up tonight,13
adventuresmith,93,7,1r6trm,10,,What fictional character is the most intellectual badass,17
PLeighton,41,5,1r6llx,12,,Reddit community what is on top of your Christmas list this year What do you want more than anything else,17
whatdidyoudotomyroom,53,7,1r6gye,11,I was going to provide an example but my username is a question soGo,If your username is the answer then what was the question,18
jewsdoitbest,83,7,1r63wg,10,Other than cheating which is probably generally the biggest thing people dont want their SO to do what actsbehaviours would your SO have to do to make you break up with them,Other than cheating what is your biggest dealbreaker for romantic relationships,17
dustinsmusings,34,7,1r5jlw,10,I assume that all men by the age of  understand that there is an unwritten rule by which you do not start conversations while standing at a urinal  Were there to do our business not chat However some men seem to be habitual offenders  To those men Why do you ignore this unwritten rule  I really didnt want to talk,Male redditors who start conversations at urinals why do you ignore the rule,17
uploadking,38,8,1r51ed,12,,Whats the best tongue twister you know,20
defroach,98,12,1r50lp,9,As someone who is on unemployment after getting laid off why do people have an issue with drug testing people who are receiving extra benefits from the governmentI do all of the required searches and everything required of me by the government to receive my benefits but it seems like there are very little that they require of me and I go well beyond what is required  I am just having a hard time justifying why these requirements should not be in place it if is done at completely random increments to ensure that people are not wasting benefits on illegal activities,Serious What is the argument against drug testing welfareunemployment recipients,21
iamjetblack,48,6,1r4kxf,11,,Whats an acquired taste that I should acquire,17
HeathaRainbows,24,4,1r48ry,10,,Hey people of reddit whats something youve done in high school that when looked back on makes you cringe to this day,14
Kermitnirmit,44,5,1r46vp,9,What is the one item something able to be bought in a store that you need to live and work in the same manner as you do now,What is one item that you cant live without,14
happydoorman,4,3,1r41we,9,If not can we make one,Are there any subreddits dedicated to finding fun things to do in real life If so what are they,12
NewHampshireGanja,15,2,1r3not,10,,What is your best dont tell mom story,12
remjensen,17,3,1r3nh6,9,,Be it saved or bookmarked  what is your own personal favorite Reddit post,12
ben,18,5,1r3dq2,10,,What is the most surreal experience youve ever had,15
nakedbobcat,20,2,1r3af3,11,,What is a question that you need to forfeit your dignity to ask,13
playmatet,18,5,1r2q48,10,If we had discovered things like mobile phones computers and the internet  years ago instead of in the past say  years how would things have changed Historically speaking ,How would historical events played out differently if we had discovered technology like cell phones and the internet  years ago,15
BSantry,51,7,1r2jaa,10,,What is something that gets under your skin and annoys you far more than it rightfully should,17
giantpizza,50,11,1r1ye8,9,Admit it you cried to at least one,Which characters did you cry over the most in any moviebook,20
smw,84,4,1r1vf5,10,Through out the nineties especially early ninties there were some unique television series I like Northern Exposure tried to get through Twin Peaks really liked OZ What are some other series from the nineties I should watch,What is a TV series from the nineties I should see,14
catinbag,41,7,1r1uk3,11,,If you could create one law what would it be What would be the punishment for breaking it,18
Lunarberry,65,4,1r1ugm,12,,Whats the worst way you have ever been woken up,16
CornishPaddy,31,2,1r1r5i,10,,Whats the silliest thing youve done while drunk,12
hgBen,3,2,1r1q0x,9,Im looking for the cringeworthy stories and the successes ,Makers and Receivers of Grand Romantic Gestures What Was It and How Did it Go Over,11
kingmario,31,5,1r1lzi,11,Maybe after a night of partying a night of nightmares or maybe just after any old regular night,Whats the most shocking disturbing or scariest thing youve woken up to,16
TheeNick,31,3,1r1l67,12,Just wondering what you all thought about thisI created my username before I really knew what reddit was I dont judge by user name because of this but I wanted to get everyone elses opinion,Do you consider user names when giving updown votes,15
Jmcothran,37,1,1r1f6u,10,As I was looking through my massive library of music that ive been collecting over the past  years I found it interesting to see how my tastes and likes have changed as Ive gotten older So what about the rest of you Do you still like the music you used to listen to What do you like now compared to what you used to like ,How have your music tastes changed over the years,11
kendroidica,21,1,1r1aal,11,,Whats a great joke in a showmovie that most people completely miss,12
AlGoreRhythm,14,1,1r19oj,11,,What is the one experience in your life that forever changed you as a person,12
rumhouse,29,2,1r15i0,10,Once I feel comfortable I will post my own guilty pleasures,What is the guilty pleasure that you keep from your SO,12
IAmKingJebus,38,0,1r0vxo,11,,If you could experience any TV Show for the first time again what would it be,11
JEZTURNER,47,4,1r0u1w,10,,Whats your favourite film that everyone else hates,14
ChillFlow,20,1,1r0rl9,11,,Whats your way of cheating the system,12
braden,8,1,1r0huq,11,I find that no matter how much sleep I get or dont get no matter what I eat or try to avoid I generally only have around  hours a day where I feel fully awake or motivated to do anything  These  hours usually go wasted as it comes at different times each day  The rest of my day is spent being drowsy and at times pretty irritable  I want to change this as I really do enjoy the rare days that I spend most of the day feeling well rested and happy,Motivatedenergetic people of Reddit how do you keep your energy levels and optimism high throughout the day,12
AssbuttWinchester,61,13,1r05bt,12,,Only using a TLDR how would you describe you or your life,25
Choppingwood,8,12,1r02lf,11,Just curious It seems like a likely place to get noticed if you were looking for a career in nude modeling,Has anyone ever been contacted for a modelingporn casting call after posting to rgonewild,23
AXGates,51,4,1qzm83,10,What is something so bad that you never want to experience it yourself Something so bad you might not even wish it upon your worst enemy Or it could be something you already experienced that qualifies,What is something that you NEVER want to experience,14
SarcasticDevil,34,8,1qzggj,10,,What is your least favourite common AskReddit question,18
mooseman,21,2,1qzdfs,9,Police officers judges wardens prison guards etc etc edit Reversed versions of this are completely acceptable as well,Has any police officer or authority figure who has jailed someone ever bumped into that person once they were released How did that go,11
Skyr,57,7,1qzaiw,11,,What is something that pisses you off more than it should,18
coolusernamesgone,53,8,1qz0uj,9,,If you could choose what was inscribed on your tombstone what would you choose,17
jewdogg,27,4,1qyvex,10,,Ever foundseen a dead body in unusual circumstances,14
Arentweet,69,10,1qytzk,9,,Whats the worst pain you have ever felt on your body,19
Stryxic,28,1,1qytg2,11,,Reddit whats the simplest most delicious meal you can make,12
yazzl,44,2,1qyrw3,9,,What nonfrightening animal would be scary as hell if it were x bigger,11
Oysterchild,54,9,1qypuz,8,,What is the weirdest thing someone with a crush on you has done to or for you,17
Mistahgrape,25,2,1qympi,9,,If to somehow become literal what common sayingsanalogies would be hilarious or tragic,11
rileygmeier,67,3,1qym2x,11,,What is something the majority of people like that you just cant stand,14
kitcatnotarat,32,1,1qyb1l,9,,Whats a free game everyone should play,10
SpenserHire,89,7,1qyap0,10,,What is a social norm you just dont understand,17
edrafaelcruz,31,3,1qy9or,11,What do you find offensive Why Whats the worst time someone has ever saiddone that to you And lastly how do you personally define offensive Also its getting late but I will try to read them all if not today tomorrow,Serious Reddit what do you find offensive,14
AlphaOmegaPx,20,3,1qy7zb,11,I am getting married December th and am looking for gift ideas I dont have a lot of cash but shoot me whatever you got,Married Men of Reddit What gifts did you give your groomsmen,14
TroublesMeDeeply,19,2,1qy7mm,12,,What is your favorite Yahoo Answers question,14
EndOfTheDream,15,4,1qy2nz,10,,Retail workers of Reddit what can consumers do to make your job easier this holiday season,14
chubbs,2,1,1qxyx6,9,,Housekeepers of Reddit whats the craziest thing you found while cleaning a room,10
kyldunn,18,5,1qxt2k,10,I used to think this was a stereotype but more and more posts are making me wonder this for exampleHow feminism is viewed The anger towards women turning them downcalling them creepyPlease serious answers only,Do a large portion of male redditors have a problem with women why or why notserious only,15
thatoneawesomedude,71,5,1qxr8x,9,,What is the stupidest thing you have gotten Reddit gold for,14
TurtleAnimals,37,2,1qxokn,11,,What part of the human body amazes you the most,13
jdsabel,32,6,1qxm99,10,,Whats something you halfassed but for whatever reason people thought it was amazing,16
JNC,28,3,1qxgqm,11,I ask myself why I dont want to be in one all the time and I cant answer for myself ,Redditors who dont want to be in a relationship why,14
lithiun,23,8,1qwxw1,9,My personal favorite was cut for justin bieber,What is an example of natural selection in modern society,17
Mbouray,15,5,1qww4k,9,One happened to me yesterday I was in Walmart to buy deodorant I picked out Old Spice Wolfhornwhich to me kinda smells like fruit loops I then looked at the guy next to me and said I like smelling like fruit loops And I just walked away,What was one of the weirdestawkward things you have unintentionally done in public,14
kaninglamig,82,6,1qvzs2,10,,What is your most useless skill,16
kittyxbutts,26,1,1qvv03,11,,If the need for sleep was no longer necessary what would you do with the extra time,12
Jellyfishingg,27,3,1qvuyo,9,So I just went through a break up not too long ago It was my first boyfriend after the father of my child who is about to be  and the relationship was horrible He was immature It didnt go well So do I lay off dating for a while Or do I get back on the horse And how,How do I go about dating if I have a kid,12
kathydcool,31,1,1qvr47,12,Yesterday was the first day I needed to wear specs to read a text message,What are the signs that prove to you youre getting old,13
ctwoods,36,4,1qvpfd,9,,What method of torture wouldnt work on anybody but you,13
jaybo,1,1,1qvp0u,10,,Handicapped People of Reddit what should I do if I see you struggling with a task that I could easily help you with,11
RASion,16,3,1qvm9a,9,,What lesser known sport would you include in the XGames or Olympics,12
PenisMcMuffinHands,42,5,1qvkqy,11,,What is the most disturbing or fucked up song you know,16
GreenEyesMakeMeHorny,43,4,1qvgpl,9,,If you could put your worst enemy in a room for all eternity what song would you choose for them to listen to on repeat,13
chrisqt,46,3,1qvcyh,11,,If you had to live in a community with the subscribers of a certain subreddit which subreddit would you choose and why,14
pmmeyourtits,30,1,1qv2s9,10,,Reddit what have you witnessed someone do that has warranted the response what the fuck is wrong with that person,11
alhart,22,2,1qumm8,8,,Hey Reddit what should you be doing right now,10
bweatbrook,16,4,1quj2b,10,,What is one time in your life where you regretted doing the right thing,14
asteriuss,75,7,1qtonb,9,,What is a gift that youd be glad to receive but you would never actually buy by yourself,16
timbrejo,16,5,1qtbra,10,,Who heres been hypnotized What was it really like Was it real,15
tunda,2,6,1qt1oy,9,Today I woke up with a guy hanging outside cleaning my window My curtain was closed but it got my roommate and I thinking that window cleaners must see quite a lot of stuff on the clock ,Window cleaners of reddit  whats the most awkward thing youve stumbled across on the job,15
msmls,50,6,1qswxb,12,Hey Reddit  Give me your best rules that rhyme  you got time to lean you got time to clean,What are some Rules That Rhyme,18
iareguypls,60,8,1qsuqz,9,,Whats the maddest youve ever gotten with a video game,17
donteatsoap,3,7,1qssal,11,Stories are welcome,Redditors who have dropped everything to go on a journey of self discovery what was the impetus of your journey and how did it change you,18
StrangerDelta,30,2,1qsneo,10,,What is the most horrible thing youve done to someone,12
antondkg,16,9,1qsn4w,11,names are encouraged but not requiredEDIT please dont lie for Karma its just not cool and takes the excitement out of it this will probably achieve nothing,Men and women of Reddit what are some sexual encounters youve had with celebrities,20
OlivesRose,25,3,1qskn1,10,As a young person I see my peers claiming maturity or branding others immature That got me thinking what does it really mean Can a teenager ever rightfully claim maturity  And bigger than that what is your personal definition of maturity TLDR Your perspective on maturity would be appreciated,Reddit what is your definition of maturity,13
shelbydavis,42,6,1qs9fp,11,It could be your favorite movie growing up one that is similar to your upbringing or just a movie that sparks memories,What movie reminds you of your childhood,17
cptmerica,24,5,1qrsnw,10,,Redditors what is your very first memory,15
TheOber,23,3,1qrhlx,11,,Reddit what movie or book needs a sequel the most,14
Temporaryaccountfor,35,6,1qr83a,8,,Which real person living now or an historical figure is the personification of evil ,14
MilkyWayAndAndromeda,7,5,1qr742,11,,Reddit do you ever forget about outer space How much do you think about the cosmos,16
bearrito,42,6,1qr5f1,12,I work in a bar that shows all the fights I feel fighters need to mix it up Stop trying to be tough or pump up the crowd Lets make it interesting ,If you were an MMA fighter what song would you walk out to,18
GustavusAdolphus,13,10,1qr0ti,12,Help ,Do catapilliars know that theyre gonna become butterflies or nah,22
SammichHQ,26,3,1qqia8,10,My roommate fell off the back of his truck put his arms out behind him and long story short fractured his radius in both arms tore ligaments dislocated both elbows and shoulders and has since had surgery on both arms He is in for at least  weeks in casts plus another few months in physical therapy He is a really active and independent guy most of the time and this is really hard on him and me as his only caretaker so if it were you what would you do to keep from going crazy over the next few monthsEDIT It might help to add that he does have his fingertips free so he can still slowly push buttons on his laptop and phone ,Reddit if you suddenly broke both arms what could you do to stay relatively sane and a little independent,13
younglang,34,6,1qqe5j,8,,Hey Reddit What are some of the most romantic songs that you know that are underrated,14
Quickman,35,5,1qqaye,11,And did you believe it ,Whats the biggest lie someone told you,16
swedishchefette,33,5,1qq4gs,9,,Whats something wildly inappropriate you said as a kid knowingly or unknowingly that still makes you cringe,14
UnbeatableUsername,39,3,1r8y3q,18,,What replacement actor in a movie  television series portrayed the character better than the original actor,21
xmckauge,51,7,1r7z0g,10,,What do you want your last words to be,17
HorowitzdaJew,25,1,1r7paj,9,,What is something that you do everyday that others probably never do at all,10
ChelseaChelsea,42,3,1r7esv,10,,What was your worst excuse to avoid or get out of a date,13
Prisoner,54,5,1r7e7z,10,,If an alien race visited Earth what would they find strangest about human culture,15
bamalamp,31,5,1r72es,11,,if your life were a film what do you imagine critics saying about it,16
kemiro,15,2,1r6z9f,9,,What is a moment you realized you were going to die but survived,11
aagpeng,57,12,1r6u4b,8,,Men of reddit what are somethings you have always wanted to tell women but are too afraid to say to their face,20
PeckerPoker,30,2,1r6ruq,11,My husband and I are arguing about the fact that we use separate blankets at night I claim that it is normal for a married couple to use separate blankets He claims that most married couples share the same blanket or comforterSo how to you and your SO sleep with blankets,People that live with their SO what is your blanket situation,13
spunkyasian,4,4,1r6p01,9,,Teachers of Reddit what is the strangest parentteacher conference youve ever had,13
Befoul,38,8,1r6kyi,10,What did you do out of rage in response,At what point in what title were you at your absolute angriest at a video game,18
circuitbreak,91,9,1r6ehn,10,And whats the most hurtful thing someone has said about it,Whats your biggest insecurity,19
koko,78,8,1r680c,8,My votes moist ointment and treat Ugggh,Reddit what word do you loathe,16
TheStabbingHobo,76,13,1r66t3,9,,Reddit which video game do you wish you could experience again for the first time,22
BlueDesire,79,9,1r5kwd,9,,How would you summarize your life up to this point using TLDR,18
luckytouch,24,5,1r5hoq,8,I am interested to see technological singularity which is estimate to be around the year  which will make me about  years old unless I die because of unforeseen eventsFor those that dont know what Technological Singularity is  httpenwikipediaorgwikiTechnologicalsingularityhttpenwikipediaorgwikiTechnologicalsingularity,What is one thing you are looking forward to in the future for our lifetime,13
TheNaud,46,3,1r5fd9,9,,If you could turn into any fictional character for a while who would you like to be,12
Shadowclaimer,36,4,1r5edf,11,,What technological advancement leaves you thinking Its amazing how far weve come,15
cyndarious,36,6,1r5d9q,8,Dont be shy I really want to see what youre capable of Surprise me,Reddit what are you good at and how can you prove it in this post,14
rockitscience,90,13,1r5634,8,,What cancelled TV shows would you like to see recontinued,21
mangyoldpony,29,12,1r4zz0,11,,What is the best job to do in prison,23
MileysBieber,11,8,1r4kjy,9,,Im leaving my mom for a trip tomorrow night with my dads side of the family leaving her alone on thanksgiving What cool things can I do tomorrow to make up for missing thanksgiving with her,17
manbiteswolf,44,5,1r4kdi,10,,What small change would you make to everyday life if you wanted to cause the most pandemonium,15
frecklesmcgeee,24,1,1r4jui,9,,Did going to a therapistpsychiatrist actually help you,10
LietKynes,53,2,1r48rm,9,,Transgender members receiving hormone therapy What was it like getting estrogentestosterone for the first time serious,11
ede,16,5,1r41i4,8,,What are the funniest or most embarrassing stories your family tells about you,13
MDCRP,25,2,1r40hp,9,,Who was the worst teacher you have had and why,11
MyOwnPrivateDomicile,12,2,1r3rnw,9,,Do other countries have Little America,11
alexisleach,8,0,1r3irm,9,What is one thing that youve taken for granted in your relationships,What is one thing that youve taken for granted in your relationships,9
machoman,33,5,1r3gez,8,, years from now what is something people will miss about the early st century,13
OperatorM,34,4,1r3aad,10,,Whats the most insulting thing someone has ever said to YOU,14
MrMojorisin,100,22,1r3838,9,,Whats a circlejerk that annoys you,31
isuperduper,44,2,1r34g1,10,,Moment you realized your SO iswas nuts,12
flubbaman,14,9,1r2zfw,10,,Have any of you ever proposed and been told no What happened next,19
llSpektrll,41,11,1r2tiq,10,Dont fuck with people who make your food,What is the worst thing youve seen someone do to someones food in a restaurant,21
JusticeSolforge,75,10,1r2r76,9,Any suggestions please Need to wallow in my misery ,Best breakup song to listen to on repeat after a bad breakup,19
ntheg,46,7,1r2lop,9,,What as you grew older did you realize is not called that and only your family called it that,16
QuotationStation,35,3,1r1wbg,9,,Who is someone that the internet often hates on but you actually either like or have no problem with,12
Mortis,60,4,1r1vr7,9,Yesterday the radio was playing oldies i remember lots of the songs they played that afternoon coming out What makes you feel old Reddit,What makes you feel old,13
trevormatic,24,11,1r1td0,8,,Whats a smaller subreddit that you think deserves more attention,19
djron,30,3,1r1q7q,10,,What movies made you root for the antagonist,13
prplemoos,25,1,1r1pjb,9,,What do you wish someone had warned you about in respect to your body,10
reginaldtato,51,3,1r1kfl,10,,Whats some fact that is completely true but pisses most people off if you say it,13
Schrankb,41,3,1r1hjn,9,,What movie titles sound like they should already be a porno,12
drepduselv,22,2,1r1akv,9,Like finding a  dollar bill at the grocery store,What is the most amout of money you have ever found and where,11
LTLARRY,58,0,1r0ys1,10,Initial comments too,What is the one reply to a comment that always seems to get upvoted,10
Intoxicatedmermaid,39,1,1r0xgc,11,,Hey guys of Reddit what made you finally realize that a girl had a crush on you,12
lth,71,1,1r0vyn,10,,Reddit what makes YOU unique,11
OMFGDude,17,1,1r0syo,8,,If you could designate your yearly income tax dollars to be spent on a single government program of your choosing which would you select and why,9
NinjaMonkey,30,1,1r0rd1,10,,What jobs did you have in high school,11
Comassion,7,2,1r0r16,10,,This holiday season dollar for dollar which charity or cause will do the most good with my donation,12
Migchao,14,11,1r05da,9, What was your experience Why did you choose to terminate the pregnancy Do you regret your decision to have an abortion If so why If theres one suggestion or piece of advice you would give to a young woman whos considering abortion what would it beAbortion is a very controversial subject and we hear a lot about it from political pundits religious people and people we know And its no surprise either its a subject that brings up when life begins when is a human legally considered a person with rights whether government intrusion is justified But with all the yelling and fighting that goes on between the prochoice and prolife sides we often dont get to hear about it from the perspective of someone whos actually experienced it firsthand Well I  and many other people  want to hear that perspectiveIm also hoping that this thread can help clear up the misconceptions that people often have about women who choose to terminate their pregnancy Misconceptions like Women who get abortions are selfish Women who get abortions dont give it any thought before they do it and Women who get abortions just dont want to deal with the consequences of their actionsIf you yourself havent had an abortion but your girlfriendfiancewife has feel free to answer Same for those of you who have a close friend or family member whos had an abortion Just please dont attack anyone for their own decisions or their opinion on abortion I want this to be a safe place where everyone feels comfortable opening up about their experiences and feelings If you want to have an argument about abortion and reproductive rights there are many other threadssubreddits you can go to ,Serious Redditors who have had an abortion What was your experience like what were your reasons for doing it and do you have any regrets,20
walkinthecow,40,7,1qzyw7,11,The one that inspired this question is the time when an acquaintance of mine who was about  at the time claimed that his sister lives in Hawaii and can get the best Hawaiian weed She works at the Dole Pineapple factory and puts it in pineapple cans so the dogs cant smell it and mails it to himEDIT It seems I didnt do a great job of explaining my question I didnt mean from an adult as in when you were a kid I meant it to mean From someone who should have long outgrown making shit up Its all good though still some good replies,What is the most ridiculous bold faced lie or talltale you have ever heard from an adult,18
southmshavoc,30,2,1qzmbh,9,,If you wanted a new beginning what city would you move to and why,11
Jona,38,9,1qzete,8,,If there was a  step program for people who wanted to quit reddit what would the st step be,17
tenrapid,68,11,1qze9f,8,,In our push toward gender equality are there any gender roles we should preserve,19
ProfessionalDoofus,35,3,1qz93l,9,I was just curious if anyone has tried out different types of sleep patterns segmented sleephttpenwikipediaorgwikiSegmentedsleep or polyphasic sleephttpenwikipediaorgwikiPolyphasicsleep What were your experiences and would you recommend it,Has anyone ever experimented with a sleep cycle that was not the traditional  hours per night,12
koczkowski,33,8,1qz7vo,8,,Have you recieved any sexual battle scars,16
JDL,31,3,1qz7fy,9,,A private jet is waiting to take you anywhere in the world for a  week vacation Where are you going Reddit and who would you take with you,12
unclearbeer,19,3,1qz5qd,11,,What is something positive that has come out of your worst experience Serious,14
dacria,71,1,1qz3wq,10,,Whats something that if removed from your life would make it feel infinitely better,11
Ant,61,16,1qyu57,7,I want something unique,Reddit what invention would you like to see in the next  years,23
Kairos,31,0,1qytck,10,I was thinking today about how much time I used to spend as a kid drawing detailed maps on A paper of kingdoms based off of a history Id write on this made up kingdom This was an activity inspired by the maps in fantasy books and I enjoyed it immenselyNow Id like to know dear Reddit what did you do to entertain yourself as a kid besides video games and TV,What weird dorky odd things did you enjoy doing as a kid,10
dcthrowaway,23,5,1qyof0,7,I was thinking of all the aspects of modern life that we take for granted and was wondering what is the most dangerous assumption we make in our daytoday lives,What are the most potentially dangerous assumptions you make in your everyday life,12
guthran,4,2,1qyoc5,8,What happened What did they say,Parents of reddit have you ever cancelled your childs sleepover after talking to the parents of the other child because of something they said,10
jeanlouisescout,52,4,1qyloa,10,,What Is The Best Thing About Your state,14
kilalareno,19,1,1qylk9,10,,What is your worst memory from elementary school,11
NotADoucheNinja,89,8,1qydnm,9, ,Your username determines your serial killer trademark What do you do to your victims,17
lawlsquid,54,3,1qy6rl,10,,Reddit What video game do you feel should become a movie,13
Machinecity,36,2,1qy0yc,8,Pretty straight forward question  ,What TV series do you wish had a nd season,10
itsahalamaker,20,6,1qxy3q,9,As in if the only thing that I knew about you was that you dated X Y and Z what would I be able to draw from that,If all anyone had to go on you was your past relationships what would they learn about you,15
Abrandnewme,18,1,1qxy30,10,,Why is it so hard for some people to get things off their chest and say how they really feel And do you struggle with this problem,11
