author,comments,downvotes,id,score,selftext,title,upvotes
intothewilder,732,3322,1f86yl,4185,"I work as a loans officer in a rural branch of a small Canadian bank.
 
Sorry for your suddenly-sodden panties, ladies. 

Definitely not my dream career as a kid – the Fisher Price Banking Is Fun! playset is not a big seller – but when I lost my job selling computers in my early 20s I got this job and it stuck like soiled underwear. I’m okay at it and I’m a well-liked mentor to many of the staff, but I’m definitely a goofy round peg in a humourless square hole which is what ultimately led to my WTF shitstorm.

If I have to work in an office I’m gonna have a bit of fun. I love ThinkGeek. In my office I have a [Conan the Barbarian letter opener](http://i.imgur.com/xwQpqAjh.jpg), a [Salvador Dali melting clock](http://i.imgur.com/hG0OT5q.jpg) and a [magnetic levitating world globe](http://i.imgur.com/rm1luHbh.jpg) among other things purchased there, and as fate would have it this past Christmas in my stocking I discovered that my kids bought me an [Annoy-a-Tron](http://i.imgur.com/vfO4Usi.jpg). It’s a small device that makes maddeningly short, faint noises at totally random intervals and can run for 3 months on a watch battery, designed to be hidden to drive someone harmlessly bonkers. Here’s the description [from ThinkGeek’s site:](http://www.thinkgeek.com/product/b278/?pfm=Search&amp;t=the%20thinkgeek%20annoy-a-tron%202.0)

*“The Annoy-a-tron will do its part to drive your co-workers slowly mad with its short and seemingly random beeps. And when someone does locate the Annoy-a-tron, they're not going to know what it is - which is almost as much fun as watching them search for it. Muahaha...”*

And hilarity will ensue!

Right?

As it turns out, much less than zero.

I came in early on a Monday and placed it behind a metal poster frame hanging on the wall in the office of one of my co-workers. I flipped the ON switch and went blithely about my day, waiting for a reaction and to share a few chuckles.

Monday came and went. Nothing.

Tuesday, nothing.

Wednesday and Thursday, not a peep. At that point I figured it was broken. Frankly, I kinda forgot about it. I had Friday off and I suppose I would’ve checked it when I got back the following week.

Monday comes, lurching out of the weekend like a reanimated corpse. As soon as everyone arrives, the manager calls all 16 of us into her office for an unscheduled conference call. I end up standing at the back of the group near the office door. She dials in and our district VP announces herself through the little speaker. I stifle a yawn. The VP then introduces our company’s head of security. My brow furrows. This is unusual.

“By now,” the VP says, “some of you know about the device that was found at your branch last week.”

*Device? What the hell? What kind of device could they possibly be talking--* 

*Oh holy Jesus fuck nuggets.*

“When it was found it on Thursday nobody knew what it was, so it was brought to the branch manager, who then sent pictures of the device to me—“

*Fuck.*

“—and I forwarded the images to our head of security. He couldn’t identify it but guessed it might be a listening device so he sent the pictures to the RCMP corporate crimes division—“

*Oh fuck me.*

“—as well as the Canadian Security Intelligence Services in Ottawa. They suspected it could potentially be a bomb—“

*Fuckity grand fucking canyon of fuck.*

“—so we closed the branch, told all staff to stay home and hired a team of investigators to search every square inch of the building over the weekend for any additional devices.”

If I had sat down ahead of time to brainstorm a worst-case scenario, I wouldn’t have even come close to this epic corporate craptastrophe.
I had no choice. I took a shaky breath, steeled my nerve, clenched my ass cheeks tight and tried to say “Excuse me” but choked out a pubescent squeak instead. I cleared my throat, interrupted the conference call in that stuffy room full of my coworkers and spoke up, telling them it’s a harmless noisemaker, taking responsibility and apologizing profusely.

The room was dead quiet. The VP slowly says thank you for speaking up, they’ll stop the investigation, and the call ends. Everyone files out. I ask the manager if she wants me to stay, but she says she can’t talk to me right now. She doesn’t talk to me for three weeks. 

I found out later that she was in her car with the device on the passenger seat when she got the call that it might be a bomb. She apparently burst into tears and nearly drove into a ditch.

The district VP threw a fit and despite my 17-year unblemished work record she tried really, really hard to have me fired. Ultimately a senior executive in the company understood my benign intent and overruled her. Luckily they didn’t charge me the $50,000+ in lost business, staff wages and other miscellaneous costs.

No, I don’t know why my manager didn’t just ASK HER STAFF IF ANYONE KNEW ABOUT IT INSTEAD OF SENDING A FUCKING URGENT MEMO TO THE ENTIRE FUCKING UNIVERSE. My office is full of a lot of things but common sense isn’t one of them.

**tl;dr: ThinkGeek + corporate zombies = fail.**

**EDIT:**
So *this* is what it's like to be the bottom in an upvoted Reddit relationship. My god... it's full of *stars*. 

Some clarifications:

* I don't work for ThinkGeek. I doubt they'd be allowed to use the term ""suddenly-sodden panties"" in their attempts at viral marketing.
* My post is as accurate as I remember (it happened a few months ago). I can only relate what was told to us during the conference call about the theories about the device and the involvement of the authorities, but I can't and wont verify if that's what they actually did. I'm not going to poke that particular dog with a pointy stick.
* Although my post focuses on my frustration about the overreaction to my prank, there's a reason I posted this in TIFU after I found out this subreddit exists. 'Cause I fucked up. As I mentioned somewhere in the comment deluge below, had I given a modicum of thought to the type of risk-adverse industry I work in, I never would've placed the Annoy-a-Tron at my work at all. There would've been no overreaction to have if I hadn't done this to begin with. And my office pranking days are dead and buried - my wife will make damn sure of that. If I even *think* about trying something like this again, my wife will shove an Annoy-a-Tron so far up my ass that I'd have Daft Punk vocoder farts.",TIFU by playing a ThinkGeek practical joke. The Canadian FBI was called and I nearly killed my 17-year career.,7507
zayetz,372,2567,1i5l52,3770,"Last night, I was on the bus coming home from visiting a friend in a nearby town, and I fell asleep. So I start dreaming about her, and before I know it, it turns sexual. A slow, lustrous tension builds up as, in my dream, I slowly slide my hand up her naked thigh. The second I reach her privates, all the muscles in my body release in a wonderful spasm of ecstasy.

It's enough to wake me up. Of course, with a sinking stomach, I realize instantly what is happening; My dick is happily pumping cum into my underwear like it's waving freely in an open field. Except I'm sitting in the window seat on a fully packed bus with two hours left to go, and the bathroom is out of order. To my horror, as I'm contemplating my pitiful existence, I feel the cum start to slide into the crack of my ass. There's no way to move to make it better. Water finds the fastest, most efficient route to succumb to gravity, and any way I move gets my cum deeper into my ass. 

If that wasn't bad enough, by the time I eventually got to a bathroom, it had crusted most of my ass hairs together. Pulling my cheeks apart has never been more painful - both physically and emotionally. I cried all kinds of tears last night.

TL;DR: I had a wet dream and came in my own ass.",TIFU by having a wet dream.,6337
[deleted],533,1919,16913n,3579,"So, this happened two weeks ago, but I'm only getting out of the hospital yesterday.

Here goes, with a throwaway cause you'll see..

Here I am, day 6, the pipes are clogged, not even gas is able to escape this. Doctor (on day 5) said to take some laxatives, no effect, the urge is great, the pressure is extreme, and the pain, my god the pain. But he said, whatever you do, let it come naturally, and don't force, you don't want to hurt yourself. (He also said go to the ER if nothing after morning attempt)

So here I am, morning after taking a ton of laxatives the doc gave me the day before, still nothing, except the laxatives, overnight made things way worst, I swear to god my stomach was twice it's size, and I felt like it was going to explode.

So I'm sitting on the can, approaching hour 3, I felt a bit of movement, and decided to ""push"", and low and behold, after 15 minutes of pushing, I get this HUGE relief. I finally had a crap! Then came the spine chilling feeling, my inards felt like ice, my spine went numb, my legs go numb. Thinking I was just sitting there too long, i go to wipe, and I hit something. I stand up a bit to see something dangling from me.

It was my colon. I forced my asshole right out of my body. Freaked out by having a 1.5ft piece of asshole hanging out of me, I called an ambulance, and off to the hospital I went.

I was in the hospital from new years eve until yesterday night. On new years day I seen my doctor who told me not to force. I told him what happened, and he said, that's why I didn't want you to force, you have a chance on big blockages like that to detatch parts of your intestines and it can come out with the poo. Well shit.

So here I am, 3 operations later, sitting on a doughnut for the next 6-8 weeks, shitting in a bag for the next 3. All because I forced when I shouldn't of.

TIL: Don't force out a crap when you are extremely constipated, you might shit out your own ass.

TL;DR: I shit out my own asshole.

So, lots of people are telling me my spelling is shit. It's shit cause it's my 3rd language, and I don't give two shits. Please realize that some people in this world speak different languages before English. ",TIFU: Didn't listen to the doctor and forced...,5498
gerbillionaire,593,4118,1hegg5,3265,"Today started as normal as any other, with a typical lazy Sunday morning routine. Wake up at 11. Get showered. Apple for breakfast. Look around my apartment, and realize there's a lot to do. 

Today is my laundry/deep clean/shop/redecorate/reorganize day. I'm typically used to putting DVDs on the big screen in the living room and just passively watching as I wandered about on these types of days. I threw on 'Better Off Dead' and got started. Within about 45 minutes I found an old DVD case (the ones that hold DVDs in a grid of 4 per page, I think 88 discs total). Score! New movies to watch that I hadn't watched a million times recently. 

I scope through, and decided on V For Vendetta for some reason. It was dirty, though. The whole page of the DVD case had specks and chunks of something on it, not just the disc. So I fogged on it with some hot breath and wiped it off on my shirt. Voilà! Good as new. Little did I realize the little chunks of stuff were stuck to my shirt still. 

Well, 20 minutes later I wiped my face with that same section of shirt, and all the little crusty specks fell off, and a few went in my mouth, which I promptly spit out. As I wondered what it was, I remembered the DVD. I wish I would have left it at that, but for some reason I remembered where the DVD case itself came from:

A buddy of mine committed suicide by gunshot to the head last year. His wife couldn't afford the professional cleaning service (which I believe is required), so she chose to do it herself. We were all very close, so I joined her to assist, along with another friend. This DVD case, along with a handful of other things she requested I take and that she never wants to see them again. I remember folding it closed from its opened position on the floor not too far from where he sat. 

I then realized I had just ingested the crusty/dried remnants of a friends brain matter/blood/whatever. Frequent and vigorous vomiting soon followed, along with a very uneasy feeling, but it's slowly fading away. 

I don't know if this is a traditional 'TIFU', but it's definitely left me feeling like I fucked up in a strange way. 

",TIFU by ingesting my friends brain matter,7383
harhemostry,161,648,zrjij,3061,"I meant to post this yesterday!

--------------------------------------------------------
  I am a high schooler and we have a weekly test in geometry. The person with the highest score on this test gets to bring in a board game of his/her choice to play with whomever they like during class on a day chosen by the teacher.

 Anyways, it was my day. I have always been a HUGE fan of the game 'Jenga!' The game of falling towers. So, I chose to bring this game to school on my designated day.

9-10-12
 My teacher tells me my day will be tomorrow due to her being absent Wednesday. I thank her and finish my work.

9-11-12
 Without thinking I walk into the classroom, with 'Jenga!', on 9/11...
 I'm muslim.
",TIFU by playing my favorite board game,3709
gosailor,275,779,1byfs4,3043,"Not using a throwaway because, fuck it...

pics http://imgur.com/a/Mq0p9

I've lived in europe for the last three years and haven't been to one of my favorite stores ever since I moved. Well one week into being in the states I'm walking through target holding a basket by the holes on the side rather than the handle. (Imagine the basket as a comically oversized set of novelty brass knucks).

I try to slip my fingers out of the holes to grab something off a shelf and they wont come out.  Eventually I get my pointer and ring finger out but my middle finger is still stuck. So my wife goes and gets a cart not really believing me that my hand is stuck and I walk around trying to nonchalantly get my finger out of the basket, which is now sitting in the cart. My wife gets me some sampler lotion from the makeup section and puts it on my finger. Still won't budge. I get another idea and we go over to the travel-sized toiletry section and we pop open a small pack of baby oil. My finger is good and oiled by it still will not come out. At this point my finger is starting to turn blue and fat from constantly struggling to get out.

At this point I'm starting to give up on the idea of escaping this finger trap silently and I get the attention of a passing loss prevention officer. I go over all the things I tried and he suggets using some vaseline. So he's over here being a real bro and slathering my finger with vaseline. If I didn't need his help so badly I would have closed my eyes and licked my lips while he was rubbing vaseline up and down my finger to be funny...

Anyway my finger still will not come loose.  So he tries to get a manager on the radio and it takes a long time for him to get to us. In the meantime people are starting to notice what's going on with me and yeah, people are openly laughing.

The manager finally shows up and suggests we call the fire department, I was really hoping it wouldn't come to this but it did. I ask if there's somewhere I can sit where I wont be such a spectacle and I get seated between the starbucks area and pharmacy and sit on a bench trying my best to pretend I'm just holding the basket when people walk by.

Eventually the fire department arrives and they have to use medical scissors to cut all the rings around my finger to get me loose. They then cut one line through the ring my finger is in and I'm able to pull the whole thing apart with my hand.

My finger hurts and I love Target so I'm going to have to face these people who know what a stupid man-child I am constantly.

TL;DR  Local 27 year old man gets finger stuck in target basket, has to be cut out by fire dept.

",TIFU by getting my finger stuck in a Target basket...(PICS),3822
Dinzaklek,230,2337,1d51ly,3004,"Last night I was up until 4 am playing counter strike on my laptop, eating doritos and drinking orange crush until I eventually fell asleep mid game.

I wake up this morning to find a terrible smell of cancer-oranges and my shirt stuck to the bed, as well as sheets that were stained a lovely shade of piss yellow. Apparently the cap on my crush was not on tightly so it leaked all over my laptop mousepad, sheets, shirt, and soaked into my matress which will likely now become moldy. To add to that my doritos also spilled everywhere and now there are ants.

**TL:DR sleeping with your crush is a bad idea**",TIFU by sleeping with my crush.,5341
Spagster,270,2627,1p554s,2959,"I work a few miles away from where I live so I usually go home for lunch.  I've saved tons of money, I get some time to myself, and generally it's just an enjoyable hour.  I was in a pretty good mood today and when I'm in good mood I love to have jam sessions in my car.  Today was the Foo Fighters.  I'm cruising down the road, blasting some tunes, paying attention to where I'm going but not much else.  There is a somewhat dangerous turn that I have to make to go home.  It's a stop sign about 100 feet away from a pretty curvy turn through some thick tree/bush/overgrowth stuff.  Basically you look both ways and get to scootin' and hope for the best.  

I looked to my left, didn't see anyone, took that as my cue and made a right hand turn.  I'm having a great time with the radio cranked up, anticipating some delicious sandwich that I wanted to make, and that's when I realized what was going on.

I caught up to a car in front of me and started noticing that there were a bunch of cars in front of that one...all with little flags on them.  Oh, shit.  It's a funeral procession.  ""Well at least I'm a the back of it!  I'll slow down, give them some space out of respect and I'll be on my way.""

For about a minute or two everything seemed fine.  The funeral procession took a turn down a different road, and I continued on my way...then I noticed there were cars behind me.  A lot of cars behind me.

I don't know how it happened because I always thought that funeral processions drove pretty tight together.  I thought cops were always hanging out with these things, but I didn't see any.  I'm not sure if it was the curvy road, a stop light, or what...but the damn thing got split in half...and I was in the middle!  AND I AM LEADING IT NOW!

I have a flag on my car.  It's an Ohio State antenna flag (Go Bucks!) and I love it, but today it fucked me over. [Looks kind of like this one](http://images.footballfanatics.com/FFImage/thumb.aspx?i=/productImages/_186000/FF_186124_xl.jpg&amp;w=180).  It was close enough in color to the maroon/red/some-color-that-I'm-sure-has-a-name that the others had on their flags I suppose, and maybe people got confused, because that whole line of cars was following me.

I turned into my neighborhood, and so did they.

I turned onto my street, and so did my following.  I was leading these people off track and there was nothing I could do about it.  I was the shepherd and they were my sheep.  Poor sheep.

I'll be honest guys, I took the cowards way out.  I really did.  I opened my garage door when I was a house away, pulled into my garage, and closed the door.  The line of cars was basically stopped in front of my house.  They eventually drove off, aimlessly wandering, looking for the rest of their herd.

I ate my sandwich is silence.  It was a pretty fucking delicious sandwich - sourdough, turkey, avocado, cheddar cheese, hot sauce and some Doritos for that extra crunch - but I'm sure it would have been even better had I not ruined that damn procession.

I feel like shit about it.",TIFU by ruining a funeral procession.,5586
XxgeekxX,398,1024,1dcuxc,2811,"It's my birthday, so my mum says she is going out to get something for my birthday surprise and will be back in about an hour, so I decide to shower and get ready for my birthday surprise. So I get out of the shower, and I don't have a towel but since I was home alone I walk to the dining room where there is a laundry basket full of clothes and towels, because that's where my mum usually does the ironing. So yeah I skip down stairs naked, singing to Taylor Swift - I knew you were trouble.
So I skip into the dining room, naked, singing. All of a sudden.. ""SURPRISE!"". ALMOST MY WHOLE CLASS FROM SCHOOL WAS THERE, AND SOME FAMILY MEMBERS, INCLUDING MY GRANDPARENTS, MY MOTHER, COUSINS AND MY AUNTIE AND UNCLE, AND I JUST BASICALLY SKIP IN SINGING MY HEART OUT, LOUDLY THINKING I WAS HOME ALONE, COMPLETELY NAKED, DRIPPING WET. I am now in my room on my own crying my eyes out, my crush was there as well, and they all saw me naked..",TIFU,3835
MarshingMyMellow,142,1346,1dslkx,2652,"I haven't played soccer in years, but some of my buddies were
playing one morning so I joined up with them. After a few minutes of kicking the ball around
I'm standing near the mid-field line, maybe 40-50 yards from the goal, and the guy
playing goalie shouts to me, ""Hey, 100 bucks if you can score on me from there!"". I
played a lot of soccer in my younger years, so I know it's within my range. He was playing way
off the line so I just had to get it over his head. So I start taking my steps to the ball,
then put all my effort into kicking the ball as hard as I could. As soon as I strike the ball,
I yell ""FUCK!!!"" in excruciating pain, open my eyes, and realize I was still in my bed, dreaming.
I had kicked the wall barefoot with full force in my sleep; pretty sure I broke two toes. 
Never did find out if I won that 100 bucks. 

**TL;DR:** Don't trust a goalie early in the morning.",TIFU by playing soccer too early in the morning.,3998
nukelauncher95,174,1247,1ax8x8,2648,"My best friend was sent home from school because she had an upset stomach. I went over her house today to see how she was doing. She still wasn't feeling good, but I stuck around and chatted with her for a few hours since both of her parents were at still work. 

When I was leaving, I gave her a big hug and said that I hope she feels better. As soon as I did, she simultaneously projectile vomited down my back and had explosive diarrhea in her pants. She backed away from me before I could react, tripped over the rug, and split her head open on a table. Blood was everywhere, I'm covered in puke, and there is shit in her pants. Great.

I carried her to my car and raced to the hospital. I called her parents and told them what happened also. She needed 20 stitches in her head and a change of clothes. TIFU


EDIT: Thanks for the gold, anonymous user!",TIFU By Hugging My Best Friend,3895
scatking69,470,868,1an9bh,2508,"This is not a fucking joke or a god damn game.  I ate 3 boxes of ""Fiber one bars"" as my exclusive food due to extreme laziness in the last 2 days and I cannot even understand how much I am fucking farting.  This is beyond insanity, and I am NOT exaggerating.  I am farting at least 2 loud boisterous farts out of my ass per 1 minute.  I have been farting incessantly for the last 18 hours.  I want to die, it's like I'm inhaling through my mouth and exhaling through my ASS.  Continuous loud yelling moans are destroying my asshole.

I know this is a bold claim, but if you don't believe it, try it yourself - you will regret.  This is worse than the time I ate an entire box of sugar free cookies.",TIFU by eating 3 boxes of fiber one bars,3376
FabulousFlavor,354,842,1krqof,2457,"I had just gotten back from the gym and decided that a shower would be pertinent. Soon after the shower began, I got a little horny. The showerhead and I are *intimate* friends. I set it to pulse, lay on my back on the tub floor, and reintroduced my clitoris to her watery lover. As I got close, I decided that if the water were just a tad hotter, it would significantly improve my orgasm. Being on the edge of cumming, and thus disinclined to sit up and turn the temperature knob a little warmer, I decided to use my foot. Predictably, my foot slipped and I sent the water temperature from warm to thermal vent. I now have  an icepack between my legs.

TLDR; I wanted to cum, got cooked instead.",TIFU by masturbating with the showerhead.,3299
issuesmayexist,536,531,13uidx,2309,"I am the luckiest dumbass ever to live.
So I had the weekend at home to myself. My flatmate had gone away, a little me-time was scheduled.
Now, I like to experiment. I'd heard about sounding (sticking things into the urethra) and thought I'd give it a go. Initial experiments were unsuccessful- chopsticks were a little large for my virgin pee-hole. No big deal, I'm sure I can find something else.

Now, a little history. Do you know what Buckyballs are? They are a type of office toy, really popular a couple of years back. They are small, spherical, strong magnets. Pretty neat, they can be combined into all sorts of cool shapes. Also, they form into a lovely string.

Can you see where this is going?

Well, wouldn't you know it, a string of buckyballs slides up the urethra just perfectly. Like it was made for it. It's a beautiful thing. I pass away a happy afternoon plumbing the depths; these things can go a long way! And the further they go, believe me, the better it feels.

Readers. Readers who have owned Buckyballs. Do you see my error? Do you see how this delicate chain of balls, so exquisitely suited to its purpose, holds my doom?

So, evening rolls around. I decide on one last plunge. This cop is a day from retirement. This space miner has discovered a nest of funny-looking eggs. This hitchhiker is rolling up to the Bates Motel. And this is one last plunge. In they go. Ten, twenty, thirty beads. More. Forty? Fifty? I don't count. I don't care. It feels good.

I feel at this point I must explain a little more about buckyballs. I have described them as a chain; this is not so. Each ball is separate, only held to the next by its magnetism. And what do magnets love to do? They love to stick together. Remember this. I did not.

My last plunge, my final dive continues. Soon, better than half a metre of magnets is inside me. I am through the prostate, through the sphincter, in the bladder. I push on. I hit the top of the bladder. I am possessed. I push on. The buckyballs, the magnets, start to bend and curve back towards themselves. Still, I push on.

-click-

I hear a sound from deep within me.

The sound of two magnets meeting and mating.

Suddenly my beautiful chain of balls is a tangled magnetized lump. In my bladder.

This is the worst possible thing.

But now I have lengthened my tale overlong. Panic stations were activated, rationality and sobrerity returned, and I started to pull. Gently, oh so gently I pulled. This chain, this thin chain of balls was still held together only by magnetism and hope, and now there was resistance. At any moment the chain could break, would break, was certain to break. And if it did, there would be no hope. Nothing short of surgery would remove them.

Still the chain held. All the way down, right down to the penis. Did you know, the smallest diameter part of the whole system is the end of the penis? I do. Oh, I do. It stuck. A magnetic lump of steel, a centimetre wide, stuck an inch from freedom. Locked behind my penile gates. The chain broke. Many times, the chain broke. But the blockage was so close to the end that, with care, it could be reattached. Only to break again.

Of note here is the pinching. I hope you do not know the pain of a thin layer of penile skin being pinched repeatedly between two powerful magnets. There was blood. Even now it throbs.

The end, however, was in sight. The magnet clump was out of the danger zone, the operation zone; it was in my penis. I could control it. I could win. And, with the help of a knife and a ballpoint pen lid, I did.

**TL;DR: I'm not sure I'd advise sticking 74 magnets up your dick.**

EDIT:
*To my eternal surprise and gratitude, Shadekitty has made a beautiful and stirring audio recording of this harrowing tale of mine. [The Sounding Saga!](http://soundcloud.com/rac91790/the-sounding-saga#)*

EDIT 2: 

[Update!](http://www.reddit.com/r/tifu/comments/14cjnb/tifupdate_by_combining_magnets_with_my_urethra/)",TIFU by combining magnets with my urethra [NSFW],2840
stupid-enabler,605,1587,1dhqpg,2291,"This happened Saturday night/Sunday morning but I only just found out what really happened so the TI part still applies right?

My (22F) boyfriend (25M) and I have been seeing each other for almost two years and living with each other for most of that time. He moved in with me early in the relationship and yes I know that was dumb but he was being kicked out of the place he was staying and I was so totally in love. Only later did I find out why his roommates were kicking him out, he had been stealing from them. He was basically taking small things at first and pawning them and was only caught when he moved up to a brand new lap-top which obviously didn't go unnoticed. I did not know about any of this at the time.

Turns out he's a junkie addicted to pain killers. I only found this out when I came home from work one day and found him completely passed out on the sofa and totally unresponsive, not even breathing right. His skin felt cold and nothing I did could rouse him. I ended up calling 911 and that turned out to be his big wake up call. After getting out of the hospital he confessed his addiction to me and all the things he'd done like stealing from his roommates, his parents, all the people who he had always said were just assholes who hated him for no reason. Well he went into treatment and has supposedly been clean for almost a year.

Now to Saturday night. We were hanging out at a friend's house, his friend not mine. We were drinking (yes yes I know he shouldn't be using ANYTHING while in recovery but alcohol has seriously never been a problem for him he rarely ever even gets drunk). I like drinking but rarely get the chance due to my job so I decided to take advantage. I didn't get trashed or anything but it was the first time I'd been buzzed/drunk in a long time.

At around midnight his best friend (the guy whose house it was), me, and my boyfriend were the only people left (there had been another couple earlier). once they were gone my BF said he needed to speak with me outside in private. That's when he asked if I'd be willing to have sex with his friend.

The request was out of the blue but not too crazy for us because we're both a little kinky and have been involved in two three-ways since getting together. What was unusual was that he wanted me to have sex with his friend by myself. He'd leave, I'd have sex with the friend and then he would come pick me up in the morning. I'm not blaming being intoxicated for agreeing to do it. I wasn't that hammered. Looking back I now blame my boyfriend who manipulated me so well I just couldn't say no. He told me about how his friend thought I was so hot and how he thought he could never get a girl like me, he hadn't had a girlfriend in over a year since his last breakup, the reason we never saw him (I had just met him that night) was he had become a shut-in, all that. Eventually I felt so sorry for the guy and my boyfriend assured me he was fine with it and I believed him because hey he's seen me have sex with another guy (one of our three-ways was with another guy) and it didn't affect our relationship. So I said sure and my boyfriend left.

Proceed to sexy times. The best-friend surprised me by immediately asking if we were going to do it. I thought I had to seduce him or something but it turned out my boyfriend had told him he'd ask me. When I said yes we basically just got down to business. It should have occurred to me that for a supposed shut-in who hadn't been with a woman in over a year it was strange how bold and how confident this guy was. But I was tipsy, I was aroused (yes, I was, I admit), so I just enjoyed it. We actually ended up having sex several times that night and neither of us really ever slept. We talked a lot between bouts but he avoided talk of his supposed ex girlfriend and instead we just talked about common interests, how weird this was, how cool my boyfriend was, things like that. At about 9am Sunday morning my boyfriend picked me up and we went out to breakfast. I paid, as usual. 

Why do I always pay? Because I'm the only person who has access to my boyfriend's bank account. He doesn't make much money and there's never much more than a few hundred dollars in it anyway but when he first got into recovery he asked if I'd help him by taking over his account and monitoring his spending. Eventually that led to me just giving him an allowance every week from his own account, in cash, because he said he couldn't even trust himself with his own PIN. I monitor his account closly to make sure his bills get paid (car payment, insurance, etc.) and transfer a certain amount every month to my own account for his half of the rent and utilities. That leaves him with very little money so I usually pay for everything.

This morning while getting ready for work I was trying to find my cell phone. My BF was still asleep (he works a late shift) but I know that he sometimes uses my phone to play his stupid app games (he doesn't have a smartphone). When I checked his jeans pockets I was surprised to find not my phone but $30 in cash. It's currently Wednesday, the day I usually give him his ""allowance"". He never has any cash left over come Wednesday. Paranoid, I went and checked both my and his bank accounts online: no unusual activity. So where did this extra money come from?

With him still snoring in bed I began searching around the room, paranoid about drugs and whatever. Finally I checked the place he had once told me early on in his treatment was his favorite place to hide his pills: in a regular pill bottle in the medicine cabinet. He's on a legit medication for a something I won't mention but I know what those pills look like since I've seen him take them many times. I checked the bottle in the medicine cabinet and yep, there they were: two pills that were definitely not like the others.

That's when I called in sick to work and then woke his stupid ass up. I told him I knew he was using again and of course he denied it at first. I asked him what he'd stolen to pay for the pills, how he'd gotten the extra money. He denied it all, said he'd just been thrifty that week. He concocted a huge story of bullshit that explained everything. He was holding onto those two pills for a friend in the program (NA). Of course he wasn'tusing I was just being paranoid!

If I've learned anything from all the NA meetings I've been to with him it's that addicts are liars. They just are, you hear about it all the time. So I kept calling him out for his bullshit, demanding to know the truth, pointing out all the flaws in his excuses/stories/etc. When he started to cry I told him to get off the fucking pity-pot and just tell me the truth.

Finally he snapped and said FINE! Yes I've been using a little."". When I insisted he tell me where he got the money for the pills he confessed the whole thing in a very angry, accusatory way. 

That best friend of his? His dealer. He met him two months ago at work. He paid for his pills at first by giving him what cash he could but then he needed more so he started giving him things like his PS3 (he told me it broke), games, a gold chain he said he'd lost. Finally, me.

Yes, turns out Saturday night had been a set-up from the beginning. He had told his dealer that he could get me to fuck him in exchange for some pills and $100 cash. I don't know how many pills and I don't know how much they cost but that sounds pretty fucking cheap to me. Then he had the audacity to say that it was MY fault for being a whore, saying I hadn't even tried to resist the chance to be with ""yet another"" man. I asked what he meant and he acted like I knew, he even said I must have known that that MMF three-way we had a long time ago, back when he was using, was for the same reason. When I freaked out he called me a drama queen and an enabler, that I liked being both, that I liked controlling him and fucking other men so why shouldn't he make some money off of it?

I told him to get the fuck out of the apartment right then. I was terrified and upset, screaming at him and begging him to just leave. Eventually he gathered up some clothes, called me a whore one last time, and took off.

Now I just feel like such complete shit. Like he pointed out, the first three-way we had (the FFM one) was my idea. My kinks had given him the idea to use me to feed his habit. I also feel stupid for not seeing the signs earlier. The PS3 broke so he just tossed it? The gold chain he'd been so proud of being able to buy back after his first three months of sobriety was simply ""lost"" and he didn't care? His strange, detached demeanor these last few months? 

I fucked up big time everyone. Not just for being tricked into being a prostitute which is basically what happened but also for enabling my junkie boyfriend. I thought everything I was doing was really helping him but it wasn't. Right now I feel stupid and used and I can't tell anyone about it because I'm too embarrassed. The only person I told so far is my best friend and all I told her was that I kicked him out because he's using again. And you guys. Thanks for being here for me if you've read this far. I'm sorry for the novel length post but I just had to get it all off my chest because this has truly been the biggest fuck up of mine ever.

","TIFU by agreeing to have sex with my boyfriend's ""best friend""",3878
whathappenedwas,185,1188,1p7qu3,2253,"This JUST happened--agh I'm so embarrassed!

Ok, so my back has been stiff recently. I work at a desk. After sitting with clients all morning, my back was really hurting, and I needed somewhere to stretch it out. I first tried to do it standing up in the bathroom, but those stretches didn't reach the right muscles, so I knew I needed to lie down to do it. Clients are always coming in and out of my office, so I knew I had to find a place that was out-of-view. I decided to do it underneath this big conference table because no matter where you walk, you can't see underneath it, unless you're bending down.

My break was an hour long, so as soon as it started, I got under the table and stretched. It was awesome; after a few minutes, my muscles finally relaxed, which felt amazing. I still had like 45 minutes left, and no one had bothered me, so I thought ""what the hell,"" and decided to close my eyes [edit] and sleep [/edit] for a bit. 

When my alarm vibrated in my pocket, signaling the end of the hour, I opened my eyes to see a bunch of legs sitting around the table--THERE WAS A CONFERENCE GOING ON!!

I had a client at the top of the hour, so I knew I had to leave, and in my head I'm like *nononononono how am I going to explain this*, but I couldn't wait for them to finish--it was clear that they were in the middle of it and weren't ending anytime soon.

Very slowly, I pushed one of the empty chairs out from the table. Everyone above stopped speaking--I could tell they were looking at the chair, seemingly moving of its own volition. I stood up from the floor to a group of aghast-looking businesspeople, and said ""there was no way to do this without it being awkward, so... my back was really hurting... sorry to interrupt.""

There was dead silence as I walked out of the room.

**TL;DR** Took a nap under a conference table, woke up to a conference going on above me. Was forced to interrupt the conference to go back to work.",TIFU by taking a nap under a table at work,3441
CouchEnthusiast,327,914,1fpbyt,2192,"I have a summer job working with insects in a lab. I do a lot of repetitive lab technician type work that includes changing the foliage (i.e. bug food) we have in a bunch of these modified plastic slushie cups that we've turned into cages, each with a pair of insects in them that we're mating. 

Before we can actually take the old foliage out of the cup and put the fresh stuff in, we need to take the insects out and put them in a different cage so that they don't escape while we're changing stuff over. These bugs actually hold onto leaves surprisingly tight and its always a bit of a balance between pulling hard enough to get them off the old leaves and into the new cage while making sure that you don't just squish them with your tweezers.

Anyways, I'm mindlessly picking bugs out of cups and putting them into other cups when I come across this one insect that is holding onto this leaf strangely tighter than usual. After 30 seconds or so of trying to gently pick this insect off with my tweezers I get frustrated and give it a good hard pull, right as I realize that it isnt holding onto a leaf, its holding onto another insect, mating.

Well it came off allright, with it's dick still attached to the female and no longer attached to it's body. 

I mean, it's only an insect, but I still felt pretty bad about it. 

**TL;DR** accidentally pull two mating insects apart, the male's penis gets ripped off in the process and is left hanging out of the female. I feel pretty bad about the whole thing.

Update: It died. Natural causes I assume.

No, I dont have pictures of the bugs dick. I did [take some pictures](http://imgur.com/a/QkZHY) of a couple of the other bugs though, in case anyone is curious

holy shit fuck up of the week? wow.",TIFU by accidentally ripping the dick off an insect,3106
bean_flicker_fuckup,406,1204,1mz0af,2176,"Throwaway for obvious reasons, but I thought you guys might find more humor in what happened to me than I do.



Today I've been feeling particularly horny. I think it's a combination of PMS (which makes me want to have a dick inside me in the worst way), and just thinking about the incredible sex I had this past weekend. 



Well, my boss was in a meeting all day today so I let the horny-ness get the best of me. I pulled up pictures of my boyfriend's dong and I knew I just had to slip my pants down to mid-thigh level and get to it.



I was really close to coming when I heard someone start walking up the stairs but I figured, fuck it, it *can't* be my boss..he's down in the meeting room all day! It has to be someone else going to their office. At that moment, I heard the door to my office open. Fuuuuuck.



I quickly pulled my pants up, but he walked around the corner in time to see me doing some buttoning up. Having been so close to orgasm, just the seam of the pants touching there made me come. As he's trying to talk to me acting like he didn't know what I had been doing.



As I tried my darndest to *not* show any signs of orgasm-occurence, I couldn't help my voice trembling. I could feel the flush color of my cheeks as well. But worst of all, I could see my boss getting a boner. My 68-year old boss turned on by my masturbation/orgasm. He then went into the bathroom for a few minutes, and we haven't exchanged words since the incident.



Hello Monday. This will be an awesomely awkward week at work.



tl;dr: Boss walked in, I orgasmed, he got hard. Pretty sure he fapped too.",TIFU by flicking my bean at work.,3380
XxBleedOutxX,288,1401,1incfq,2156,"(21/M) It was a standard Wednesday night, just got home from work and was flopping around until the gf decides that it would be a good idea to go to a bar. Ok, sure, but I have to be back early since I have work again the next day; immediately upon arrival I began the beer sprints and managed to kill about 10 in an hour. At this point, I'm pretty drunk and completely disregard time, I vaguely remember leaving and after that everything is gone. When I spoke to the gf the next day she said she came in and we got our cuddle on and then she left me asleep in my bed....and then I spoke to my mom. Apparently, throughout the course of the night, I unleashed the full force of my pale hairy body and climbed into bed with my dad. He was awoken by the clumsy attempt to get comfortable, and proceeded to ask me what the actual fuck I was doing and ordered me to go to bed, to which I replied, ""I am nigger."" multiple times. 

tl;dr: got schwasted, climbed into bed with dad naked, called that man a nigger for trying to disturb my slumber",TIFU by waking up naked with my dad,3557
LowBlowBobLawblaw,254,1304,1h1tqn,2130,"(Happened last night, but bear with me.)
_____________________________________

So. Be me, an 18 year old guy.

I get home after going on a hike with the girlfriend.

Siblings on summer vacation too, parents home from work, grandma in town to visit, all hanging out in the living room.

Family is playing charades, I am too tired, I observe.

Get bored. Go on reddit on mobile.

Reading through comments. [It's a pretty innocent thread](http://redd.it/1gzyap), no biggie.

One of the comments mentions a YouTube video. A sexy YouTube video. A sexy YouTube video with *boobs.* 

&gt;[*This video.*](http://www.youtube.com/watch?feature=player_detailpage&amp;v=_6VlIHqzEco#t=85s)

Be a horny kid. One who enjoys boobs.

Click link.

Nice boobs.

&gt;&gt;(Now, my dad recently got a new TV. A big TV. A smart TV. [This TV.](http://www.samsung.com/us/video/tvs/PN51F5500AFXZA))

&gt;&gt;And I don't even watch TV or play video games, but this thing is the tits, I swear it has technology stolen straight off  the fucking *U.S.S. Enterprise.*

&gt;&gt;One such technology is the ability to connect the YouTube app in my smartphone with the YouTube app in the TV to stream videos from my device to the TV.

&gt;&gt;When I discovered this feature a month ago, I was so impressed that I set that shit up *pronto,* used it once or twice, then immediately forgot about it.

&gt;&gt;But using the feature is easy! Too easy. Like all I have to do is tap This little guy right here: [http://imgur.com/fUckmE](http://i.imgur.com/fRtBwfB.png), and even if the TV is in the deepest of slumbers, it will wake right the fuck up and immediately play your current video in 51 diagonal inches of 1080p glory, accompanied by Dolby digital 5.1 surround sound.

&gt;&gt;Well guess what I did.

Brush streaming button by accident while trying to remove dust from screen.

My screen goes dark. TV screen lights up.

&gt;ohfuckno.jpg

Now 2,073,600 pixels of [this lovely image](http://i.imgur.com/U5s8bW7.png) appear on the wall of my living room.

The game of charades screeches to a halt as my family's heads turn, I join the game as a gazelle leaping across the room to find the remote to shut this bitch down.

&gt;wherethefuckisit.mov

Fifteen seconds of awesome tits dripping with shame pass until I finally manage to turn the TV off, attempt an explanation/apology, and scuttle the fuck out of there with my tail tucked between my legs.

I haven't left my room yet today.

I am hungry.","TIFU by streaming boobs to my dad's 51"" TV for my entire family to see.",3434
Spamsational,236,1373,1o2dca,2092,"My sister and I were in the kitchen together when I saw her phone ring. I'm a tease of a brother so I answered it with a really loud and long ""heeellllllooooo?"" the girl on the line asked if she was calling my sister, I replied ""yes"" just like this [guy](http://www.youtube.com/watch?v=rL5ZVljj4vg). Meanwhile my sister is desperately trying to get the phone back off me, but I thought I was having fun with her friend.

In the kerfuffle the call ended, my sister tried to call back only to see that the line was busy. She called back five minutes later to get through to a retail clothing store.

Turns out they were calling her to offer her the job she applied for...

They offered it to the next person on the list because they thought she gave them a false number.
______________________



So here I am. My sister finally had a job after months of searching and I threw it away because I had to be an annoying fucking idiot. It's 1AM and I can't go to sleep because of all the guilt I have. I have no idea how to make it up to her because she tried so hard and nothing I have/can do could match a fucking job.

She knows I would never do it on purpose, but I can see how devastated she is and it makes my heart break to know I did this.
I'm feeling like shit, she feels worse which is making me feel like even more shit.

I'm such an idiot.







_______________________________________


EDIT: Alright, well I have woken up to see this really blew up. I didn't expect it to gain so much traction since it was just a way for me to let off steam. I'd like to thank a lot of you for your advice, you have been most helpful. I'm going to help get her a job this time and pay for her expenses like fuel.

And to all the people saying ""don't answer the phone next time, you moron"". 
Well, duh.",TIFU by answering my sister's phone.,3465
pretentious_lowbrow,200,556,17b6pl,2060,"I had been planning a surprise proposal for my girlfriend for a long time. She's always loved this fancy restaurant which was one of the first places I ever took her out on a date. By fancy, I mean your car is parked by a valet, there's an attendant in the bathroom, and they will not let you sit without a jacket and tie. I made reservations weeks ago without telling her. I told her that I was taking her out for a surprise dinner and that she needed to dress up real pretty like. 

A few hours later, we arrived at the restaurant. I slipped the valet a few bills, told him to take good care of the car, and into the restaurant we went. We sat down and had a wonderful meal. The food was fantastic, the service couldn't be beat, and I was there with the most beautiful and charming woman in the room. Right before dessert, I excused myself to use the restroom. Apparently every man in the restaurant had to go at the same time, as every urinal and even all the stalls were taken up. I made small talk with the attendant, bragging that I was about to propose. I took out the ring to show him, and he agreed that it was stunning. A stall opened up, and I walked in to do my business. 

I will never in my life understand how what happened in the next five seconds happened, but it goes like this: I reached to close ring box so I could put ring back into pocket, my big clumsy fingers fumbled the box, the ring became dislodged from the tiny slit in the box holding it in, my eyes followed the ring I had just spent all of my savings on as it fell, the ring hit the toilet seat, fell into the water and slid down into the drain. My life is over. How did this just happen? I screamed. And not a manly Arnold Schwarzenegger scream. I screamed like a little girl. Immediately I dropped to my knees and threw my arm down that toilet. I felt around and around, but I couldn't feel the ring. 

At this point the other men in the bathroom questioned what the hell I was doing in a five-star restaurant flailing my arms around wildly in the toilet. I yelled, ""STOP! Don't. Flush. Anything!"" The attendant asked me what happened. Holding back tears, in the quietest of whispers, I explained my situation. The other men didn't know what to do. Some laughed, some gasped, I'm fairly certain one may have fainted, but I may have been hallucinating from the shock. The bathroom attendant rushed to fetch the manager. They returned and informed me that a plumber had been called and would be rushing over. No one left the bathroom. Several more men trickled in, each one questioning why there was a grown man, sitting on the floor, soaking wet, and crying. Yes, I am man enough to admit that I cried. Any of the rest of you would have as well. Several men attempted to console me, but it wasn't working very well. Fortunately, the plumber arrived in record time, though to me it seemed like days. 

He quickly sent a camera down the toilet. There it is! There's the ring! I am overjoyed. The plumber ran a hooked wire down the toilet and hooked the ring, while watching on the camera. Very very slowly he drew it out until finally, the ring was back in my possession. The crowd of nearly forty men standing around burst into cheers and applause. I thanked the plumber profusely. (Seriously, this guy is coming to the wedding. And Sauron should probably hire him next time he needs to find a ring. The Nazgul ain't got shit on this guy.) At this point, the shock finally wore off, and I realized that I had been in the bathroom for well over an hour at this point, along with half the men in the restaurant, the plumber, the attendant, four managers, and the owner. My girlfriend had to have noticed I was gone a little longer than expected.

Disheveled, still soaking wet, and carrying a ring that now needs to soak in bleach for days, I rose from the floor. Again I thanked the plumber, the staff, the owner, and the other men for their help and support in my time of need. Walking out of the bathroom, I found that everyone in the restaurant who had not joined me in the bathroom were crowding outside the door. They all cheered for me. It was amazing. Scanning the crowd, I saw my girlfriend. She was bawling her eyes out, but wearing a grin from ear to ear. I have never seen anyone or anything appear more beautiful than she did at that moment. I fell to one knee right then in front of everyone, and begged this poor girl to take me as her husband for the rest of our lives. She said yes, and I leapt to my feet, wrapped her in my soaking wet arms, and kissed her.

The crowd around us erupted into cheers and laughter, and maybe even a few tears of joy. Finally we returned to our seats. Everyone wanted to be the first to buy us a drink, but I wanted nothing more than to get my new fiancee home and get out of my soaked suit. I called for the check, but the owner refused to allow me to pay. He even refused my offer to pay for the plumber. I tipped the waitress, thanked the owner abundantly, promised him that we would be back many many times, and then we went on our way. On the way out, I quickly ran into the bathroom to give the attendant what I hope was the largest tip he has ever received. And then I shit my pants.

Edit: Formatting, broke down the ""Holy wall of text, Batman."" Sorry, I was very tired when I wrote this.",TIFU by nearly ruining my proposal,2616
23_,213,475,1521fg,2027,"My grandad died on friday and today I went to see him for the first time. I drank too much last night and I'm feeling rather fragile today. An unbearable hangover mixed with overwhelming sadness was too much for my poor little stomach evidently and now my deceased grandfather is covered in my regurgitated Special K.

Yup.",TIFU by vomiting on a dead body.,2502
Disgruntled_Fridge,396,674,18kpii,2019,"This was actually last weekend.

I've been going out with this girl for a couple of weeks, and last week she invited me up to her cousins holiday house for a weekend. My parents said it was cool, assuming that there would be some form of parental supervision. So I drove up and it turns out her cousin is 19 and inherited the place from her grandparents (long story). So I'm pretty excited. I immediately start thinking about sex. It's only natural I guess... I'm away from my parents AND I'm sleeping in the same room as my girlfriend! So we have a great first day and get back from a party pretty early, at something like 11. I'm pretty tired, so I fall asleep straight away.

I sleep right through the night, but sometime in the morning I feel a really nice sensation on my penis. Without really thinking about it, I start to pee a bit. ( I always have to pee to get rid of my morning wood). I'm instantly woken up by my girlfriend who's screaming at me, something about piss in her mouth.

It turns out she heard somewhere that a great way to wake your boyfriend up is a blowjob. That nice feeling I got was from her mouth. And then I peed in it. She cried a bit, brushed her teeth a thousand times, swore at me a bunch then eventually calmed down and made me promise not to tell anyone. 

TL;DR Gf gave me a blowjob to wake me up, I thanked her by peeing in her mouth.

EDIT: I'm 17 btw.

EDIT 2: so far so good. Front page of reddit and no one has noticed anything. Every time my phone vibrates I get a bit worried. What I'm really dreading is a Facebook wall post.

EDIT 3: **I DON'T KNOW WHY I STARTED PEEING. I DON'T WET THE BED NORMALLY I SWEAR**

EDIT 4: aaaaand the jig is up. Just got a facebook message from my Gf's cousins boyfriend, who was up at the holiday house just before i arrived. He reddits apparently. He seems like a pretty cool guy, I might be able to convince him not to tell anyone.
",TIFU by peeing in my girlfriends mouth,2693
ShiShoSha,369,572,18spgf,1992,"I've had this shameful tale under my belt ever since it happened about ten years ago. It's always made a good party story, so I figured I would finally put it out there for the reddit community. 



So, in 2002, I'm a 17yo guy. I have my own car, I'm getting decent grades, I have a wonderful circle of friends that I spend a lot of time with, I've got a good starter-job at Subway to give me disposable income. In short, everything is coming up ShiShoSha. 



I also have a girlfriend. I already know she's not going the be the woman I spend the rest of my life with, but we have a lot of fun together and share the same kind of humor. So, we're just going through our early relationship phase: a lot of flirting, stupid phone calls, timid sexual activity, etc. Before I know it, we've been dating three months (my longest relationship at that time). The subject of ""love"" has never come up. And then prom rolls around.



So, it's my junior year. She's a freshman. The way my school worked was: Only Juniors and Seniors were invited to the prom by the school. If any underclassmen wanted to go, they had to be the dates of the upperclassmen. So, I naturally invite my girlfriend. She accepts. We're all happy. Yay.



Everything is going great up until about three days before the prom. Her grandmother dies. And they were very close. I feel very bad for her, and she's taking it really hard. It was the first time in my life that I ever really had to support someone emotionally through a loved one's death, and I was glad I could be there for her. 



Then, the night before prom, we're talking, and I tell her, ""You know, with everything that's going on with your grandmother, maybe we shouldn't go to prom."" I told her I'd completely understand if she didn't feel up to a big public appearance, and that we could just chill at home and watch a movie or whatever. She said no, that it was my prom, and that it was important that we go. Plus, she said, she'd already gotten her first big, expensive prom dress, and she'd be damned if she wasn't going to show it off. We laughed and agreed to continue as planned.



Prom night comes. We get Thai for dinner. It was excellent. Her dress is indeed very nice. Then, on to the dance. It was a great location. Good music. Good punch. A lot of teacher chaperones, but they were all clearly ""off the clock"" and were having a good time too. But my girlfriend wasn't really having a good time. From the moment we got in, she'd just gotten all mopey. I was kind of expecting this, but tried to get her to have a good time, only partially succeeding. Then, when the first slow-dance song came on, she lost it. I mean LOST IT. Openly bawling on the dance floor, tearing her shoes off, and storming off into one of the adjoining hallways, slumping into a corner. 



I chase after her and sit down with her. I try to talk to her, about her grandmother, about life and death, about anything to try and cheer her up. Nothing works; she just sits there sobbing, not even really talking to me. I'm a little upset too, but I definitely want to be the good boyfriend. I'm gonna sit there with her through this! A half-hour goes by, then another. She's stopped sobbing, but is still a sniffly, cried-out mess. I ask again if she wants to try to join the dance, or maybe just head home? She says no, she's just going to sit there, but that it's my prom, and that she's being unfair. She tells me to go have fun with my friends while there's still time left. I tell her it's okay, I can stay with her, but she insists. So, I get her a cup of punch, then go rejoin my friends on the dance floor. I have an awesome time for the rest of the dance, about another hour after I went back onto the floor.



Once the prom ends, I go collect her right where she'd been. She's just gone totally quiet. We go to my car and have a completely silent car ride to her house. I'm thinking maybe she's mad at me for taking her up on her offer for me to leave her, but she doesn't seem mad, just sad. So, I go back to assuming it's her grandmother. 



When we finally get to her house, we get out of the car, and I walk her to her door. I'm going in to give a perfectly innocent peck on the cheek and a ""good night,"" when she stops me, takes a deep breath, and looks down at her feet. She tells me that she's sorry for ruining my prom night. I tell her hey, it's okay. I had a lot of fun for some of the night, and we both knew she wasn't feeling her best because of her grandmother. Then she shakes her head and says, no, she hasn't been sad the whole night because of her grandmother . . . she's been sad because she loves me with all of her heart, and knows that I don't feel the same way . . .



I totally freeze. Deer-in-headlights. Probably only about ten seconds, but it felt like five minutes. We'd been going out three months! I'm 17. SHE'S 15!! We don't even know what love is!!! So, while I'm trying to process all this, I just stay frozen. Finally (god, help me), I don't know what compelled me to do this: I sort of smile at her, give her two thumbs-up, say, ""Cool!"" and walk back down to my car and drive away.



We broke up the next day.



When my friends recall this story to bust my chops, I always tell them, in my own defense, at least she got TWO thumbs-up. Sigh . . . I'm a bad person.



TLDR: GF of 3mos tells me she loves me for the first time. I give her 2 thumbs-up and walk away.




EDIT: Fixed my englishing. Apparently, ""kind've"" is not a valid contraction. Legitimate thanks for pointing that out to me; I hope I haven't included that in many professional correspondences.



EDIT: For all those asking about my username, ShiShoSha is my morning routine: Shit, shower, then shave.","TIFU (10 years ago) by giving the worst response imaginable to ""I love you""",2564
tifuohno,218,290,yridm,1994,"This happened 2 days ago, but I digress. And throwaway because  the involved person in this story is a redditor and I would like them to never think or read about this scenario ever again.

2 nights ago I get home from work and ask my roommate if she wants to go for a drive to pick up some groceries. I'm pretty tired so I tell her I'm going to nap for an hour and then we can go, and she agrees.

While I'm nestled into my bed, nature calls and I decide to grab my laptop in order to fulfill my animalistic desires. I find some good porn and begin to fap (or shlick? whatever girl fapping is). I finish happily, and I'm super exhausted. The porn is still going on but I say fuck it and just close my eyes..

I wake up to the sound of someone opening my bedroom door, and I'm so shocked by the fact that my bare ass is facing the door and I have lesbian fetish porn on my laptop a foot away from my face, that the only thing I can do is just pretend to still be sleeping.

I hear my roommate gasp and say ""SHIT"" and closes the door really quietly. I wait a long ass minute before getting up and collecting myself at the situation that has just occurred.

I then went upstairs and acted like I didn't know it happened, and so did she.


**TLDR** I fell asleep after masturbating to porn and my roommate came to wake me up, catching a full view of my bare ass and vagina as well as fetish lesbian porn on the laptop next to my face. We are pretending it didn't happen.",TIFU by falling asleep while watching porn.,2284
SnowWhiteGoth,177,1104,1m0dxr,1969,"So this actually happened two years ago, but whatevs. I still fucked up.

I was at the gas station late one night, about to buy $20 in gas and a Snickers. I got talking to the guy at the register, because work was slow that night, and he was cuuuuuuute.

He failed to get the register open and went in the back to ask his manager. I saw this as a great opportunity to let a fart I'd been holding back. I went to the other side of the station, looked around, and saw that the coast was clear.

(◕‿◕✿)&lt; Toooooot~

""FUCK!!""

I jumped out of my skin!! I turned around, and this time, I looked down. I saw a.... I guess the PC term is ""little person."" He was hood as hell, too. Gold chains, tatts, everything.

""That was WRONG. That was NOT. EVEN. RIGHT.""

I was just... in shock. This guy came out of nowhere, and here I was, looking like I deliberately ripped ass in his face. He went on a rant about how I was racist, and how hard it is to be short in the hood. I tried to apologize, but he was hearing none of it. He don't need no cracker-ass ho lettin' poots up in his grill.

There weren't many people in the store, but they were staring right the fuck at me. Look at this evil bitch, farting on black midgets. The cute cashier came back. Oh God no, I can't let him know that I fart.

""Excuuuse me!"" the lowercase g yelled to the cashier. ""This girl-""

Before he could finish, I took off running. I bolted to my car and drove to the gas station down the road, where I was careful not to poot on anyone.

**TL;DR** Tried to pick up a cute guy but farted in a dwarf's face.",TIFU and looked racist by farting,3073
PhatDaddy420,490,828,19efp8,1938,"So, this was Tuesday, and not really a fuckup, but the scenario is really hilarious in the end.

So here I am, a grown ass man with a hankering for making a snow fort / igloo, cause they are fucking awesome.

This thing here was a monster, enough room for 3 people to stand, seats and stuff, but I ran out of snow from the mountain I was digging into, so I start shoveling on the snow pile next to mine (a little on the neighbors yard), and probably 30 minutes of working into that pile, literally making room in my neighbor's driveway (I figured she'd be happy I'm cleaning her driveway), 2 cops show up with the neighbor pretty much dragging them out back.

Turns out, I was stealing her private property, and wanted to be compensated for stealing, her snow.

I stopped, and gave the 3 a dumbfounded look, trying to figure out if it was her cop friends of something pulling my leg, because I mean shit, I was shoveling her driveway and putting it into my sweet sweet fort, that's 100% on my yard.

Turns out, they were there on official duty.

I spoke to the cops, it went down like this (she went back inside at that point, watching from the window like she ""got me"")

Cop: Sir, we have reports from this lady saying you have been taking her property and hiding it.

Me: Um, does snow count? Cause i'm building a sweet sweet fort right here. (Lead them inside my palace of awesomeness)

Cop: So, your telling me when we showed up, and we seen you shoveling the snow from the edge of her driveway, you were building a fort?

Me: Yes

Cop: Did you take anything from this lady?

Me: No, I ran out of snow and figured since she only dug out her driveway to fit her car exactly, I'd widen the driveway and put the snow to build up the fort.

Cop: (with a huge grin) Wow, that's a serious crime sir, you're telling me you were willingly shoveling out your neighbors driveway, and she didn't ask??

Me: Um, I guess so.

Cop: Ok, so clearly, she want's the snow on her lot, she claimed you were stealing her property, but didn't explain what, just that ""the man is stealing form me right now"", so we headed right over.

Next time you should ask if it's ok to help out your neighbor by shoveling their driveway, we don't want to have to arrest your for grand theft snow.

Me: hahaha, ok, I guess I'll stop using this snow, I'll go grab it from the front.

Cop: She, she wants the snow back.

Me: Fuck off, really?

Cop: Yea, but we already dealt with that, just don't go near her yard without her permission, we rather not have to come down here for this again.

Me: Sounds good officer. And shake his hand.


I then proceed to show the second cop, who was inside talking to the wonderful neighbor I have, the epic snow fort, thinks it's pretty neat, since it's the first fort he's been able to stand in since he was a kid.

We just shook hands and went on our way.

TL;DR: I stole snow from my lovely neighbor who called the cops for grand theft snow.


Edit: For those wanting pictures, I don't know if it'll be possible. Like mentioned in the comments, it's been unseasonably warm the past few days and temperatures went 4-5 degrees above freezing, even over night. Snow forts don't like warm weather. Plus, I didn't think of taking pictures as I tend to make them whenever I feel like wasting an afternoon getting high making snow forts. You never know, there might be another one!","TIFU by making a snow fort, and the police got involved.",2766
ikma,208,475,11dkod,1941,"**Backstory**
I have had a chest cold for a week, and have been coughing up big green gobs of flem.  Last night, I drank far too much (I'm a [Pittsburgh Steelers](http://espn.go.com/blog/afcnorth/post/_/id/56584/rapid-reaction-steelers-titans) fan), and as a result I am hung over and having terrible beer-shits.

**Today**
So I am on the toilet, wiping, when I feel mucous rising in my throat.  Without thinking, I cough into the tissue in my hand.

I smelled my mistake immediately.  It was not a tissue, but a shit-laden wad of toilet paper.  I had just rubbed shit all over my nose and lips. I had some on my teeth.

I coughed. 

I vomited.

I cried a little.

I fucked up.",TIFU and wiped my own shit on my face/lips.,2416
yeah_science_bitches,260,1178,1p9mku,1908,"My husband is an avid outdoors man. He is currently away hunting ducks, and as per our usual passed time tradition, I like to send photos, videos and descriptive text messages to his phone when I know he's in the field and left his phone in the lodge.
Today was no exception. He sent me a text : ""heading out, I'll let you know when we get back in. You should put the red lace on.""

I had a better idea.. I'll put the red lace on, then video a strip tease. So, I did just that.

Why not take it further? 

I get out my while pure romance collection, and video me using each one (4) in short 3 minute videos then take a few still photos. All finished, I put them all in an album format text, then pushed send.

Post orgasm, I figured i'm sated enough until he gets home tonight. I cleaned, dried and put away my toys. Shower time!

My phone now on the charger being, i'm not expecting a text back, I take my time drying my hair, getting dressed and ready for the day before my kids wake up. the main reason I keep my phone on silent.

6:23am my phone rings. It's my dad. ""Good morning, I see""
Confused I say ""Good morning, what are you up to today?""
""Well, with the text I got this morning from you, i'm guessing cleaning out my phone and giving my son in law a pep talk""

My husband's name is next in my contacts to my father, I had sent 9 videos, 13 still photos, and a description of how my husband likes to fuck me, and how I want it when he gets home, to my father.

He thankfully didn't read the whole text, but he has an iPhone, so he saw a picture of me in my red lace, halter, babydoll lingerie holding 3 dildos, and a butt plug.

:-/  

Oye!",TIFU by sexting my father. [NSFW],3086
brokeherface,527,796,1ii9y9,1894,"So, fuck...

Bit of info. I work in an office building and every fucking door in this spot is locked with a keycard access.

So here I am, Monday morning, I was sitting at my desk when I got up to grab a glass of water. But on no! The water machine is empty! So being the nice guy I go in the storage area, and grab 4 bottles (I always grab 4) 1 in each hand and in the arms.


I get to my department door, and these doors are magnetic lock, so I need to swipe my card to get in. I do, not too many issues.

Before going in, I take a peek behind the frosted glass to make sure nobody is there, and proceed to give the door a little kick to get in.

I give the door a little kick to open, but I slipped, and pretty much put my entire weight, plus 4 giant water jugs full behind it, and the door just stopped half way and closed again.

I put down the water bottles, slowly open the door, and see my coworker, laying on the floor, face full of blood, unconscious..

Turns out she was tying her shoe, as she was about to leave.

15 minutes later, ambulance, fire department, police all show up because turns out when you call 911 from a large office building, they send the whole force!

Day goes by as well as it could considering...


Jump to today, I get some more news about her condition..

She has a broken nose, concussion, fractured scull, and some brain damage... and she will be needing plastic surgery to get her face straight again, since you know, giant heavy metal doors and faces don't mix..

I feel like shit, I literally broke her face, like, fuck... 

But from what I've been told, she will be doing a full recovery and should have no scars.

I wanted to go see her in the hospital, but she doesn't want to see me right now, I guess she's a bit upset at the whole situation.. (I wonder why???)

TL;DR: Kicked door, face was in the way. Fucked it right up.


Edit: Many people are wondering if I actually apologized to her. And of course I did! But how much apologizing can you do when they are just waking up from being knocked out with a broken nose and cracked skull?

And also, they were 5 Gallon water jugs, I'm a pretty big guy, so carrying the water turned into my responsibility as I'm the only guy in my department.",TIFU: She now has brain damage...,2690
justastupidname,60,371,15hxoa,1887,Edit: Streaks over everybody :( [This guy killed it](http://www.reddit.com/r/tifu/comments/15j7kx/tifu_and_shit_myself/),"Congratulations TIFU, its been ~5 days since one of you shit yourself!",2258
femaleprosthetic,236,1097,1omlzm,1864,"My husband and I just had a baby a few months ago and we haven't been able to take a sexy shower together for quite some time. We finally got the baby to sleep and snuck away to have some much needed shower sex. We were so excited. Right when we were getting ready to go nuts on each other he stops me and asks if I would be into something new. He wanted to pee on me. Fuck it, why not? As long as I get to pee on him at the same time. So this glorious golden shower of pent up sexual frustration that of a couple of teenagers, commenced. Then...it hit us. Our innocent giggling turned into violent coughing as we began gasping for air. During our sex crazed excitement we failed to remember the few bundles of asparagus we both ate for dinner. WHY?! Why today?! The stench was similar to the breath of a 15 year old Labrador that only ate fritos and compost it's entire life. The water was hot. Really hot and it felt like we were in the middle of a corn nuts and piss filled humidifier. The mood was destroyed instantly and once we could breathe again we couldn't stop laughing. We got cleaned up and as soon as we got out our asshole baby woke up. So much for sex. We really are the worst.

Tl;dr husband and I hot boxed our sexy shower Time with asparagus urine.",TIFU by agreeing to try out a new fetish with my husband.,2961
MouseShank,182,997,1qzfcz,1858,"This morning, I was using a bathroom in the airport while waiting for my flight to board. I did my business, cleaned up, and turned around to take a look at what I had created. After a moment, I pressed the manual flush button, and instead of flushing, the toilet water began to rise rapidly. When the water level was about 1/2 inch below the rim, it stopped. After a moment of relief, I turned around to leave. As I turned around, I triggered the automatic flush. 

I heard another guy freak out as pieces of poop were riding a tidal wave of toilet water in his direction. 

I ran away like a little pussy.",TIFU by using the manual flush button on an automatic toilet.,2855
hogtiemydignity,233,624,17n2k5,1845,"Throwaway for decent enough reasons.

Last weekend I went to visit my girlfriend of about 4 years. We've spent the last year getting pretty into bondage, so when I went I brought a few of our toys from my place in my school backpack. When I left on Sunday I took *all* of our combined toys back with me (at least the portable ones) because she didn't want her roommate to find them at any point. I put them in the non-notebooks compartment of my backpack and went about my week, a little curious as to why my bag was heavier than usual but not thinking much of it.

I should mention now that my backpack is about ten years old and the zippers are getting a little faulty. So about an hour ago I'm walking into math class, and I guess the weight of that textbook was too much on my bag because as I'm walking in front of the class to take my seat, my backpack's zipper finally snaps and out flies everything, and I mean **everything**. Within three seconds I turn around to see a trail of my perverted inventory. Here's what I, and the rest of my class including my professor sees strewn about the floor: 

A ballgag, a spider gag (keeps the mouth open), handcuffs, blindfolds, leather lingerie and chaps, two buttplugs, a collar and a leash, a corset, and a small red dildo.

What made it even worse was that is wasnt all condensed in one area, it was a line about 4 feet long of our toys. I had to pick them up piece by piece and scramble to my desk. When I got to my desk, the girl who sits next to me says ""you forgot something,"" and I have to stand back up to go pick up the spider gag.

I have to see these people every day for the rest of the semester and probably in subsequent classes, considering my major is math and we're in higher-level courses.

**Tl;dr: I just gave my entire math class and probably future classmates a display of my kinky sex toys**

**EDIT**: Thanks for taking my situation and turning it from me feeling like a loser into somewhat of a winner. You guys made my day/night/everything.",TIFU by spilling bondage equipment all over my math class,2469
ChrisFRKNRogers,188,403,19seg1,1835,"**Wow, guys. Fuck Up Of The Week! I was not expecting such a response. Thanks for all the comments and support!**

This actually happened a few weeks ago, but I've just learned today of the unfortunate outcome to my actions.

My friend's mother asked me to drive her to Phoenix to pick some furniture up from her friend Bill's house, as I am the only one in our group with a truck. I agreed, and off we went.

Upon arrival, and after the opening pleasantries, I was left to my own devices while the two catch up. After cracking open a beer, offered by Bill before they disappeared into the other room, I discovered Bill's shopping list stuck to his fridge. There were 4 or 5 items already written (I don't remember what), and I took it upon myself to add one, like I do. I found a Sharpee, and added ""50 lbs Monkey Chow.""

Now, I knew beforehand, and confirmed via sight upon arrival, that Bill is disabled. It never occurred to me that he would have someone do his house cleaning and shopping for him. Anita arrived the following day, let herself in, grabbed the list, and did her job. Never once did she question the curious addition that was so obviously written in someone else's hand. She drove and searched for *hours* before finally finding an outlet that carried bulk quantities of exotic pet food *fifty god damned miles away*, and you bet your ass she bought it and brought it home to her employer, pleased as punch. 

Naturally, Bill was furious. He thought it was one of his friends from out of state that was visiting a few weeks earlier, messing with him, and called my friend's mother to complain. He was so mad, he fired her on the spot, and now I feel just awful. 

I truly can't stop laughing, but I do feel really, really bad.

EDIT: I should have included that after hearing about this, I did call and own up to it. I explained everything, and suggested he hire her back, although I'm not so sure he will. The reimbursement check goes in the mail tomorrow.

SECOND EDIT: As it turns out, he did hire her back, and now keeps his shopping list hidden until shopping day.

*Courtesy of /u/Mcelite:*
**TL;DR OP jokingly added ""50 lbs Monkey Chow."" to the shopping list of a disabled friend of a relatives. Said person did not do his own shopping and Monkey chow was eventually found, bought, and people were fired.**

    ",TIFU by adding an item to a shopping list.,2238
MrTactless,310,899,1ixcm0,1827,"So today I went out for dinner with my family. My mother is remarried, so we're quite a big but close family; I'm the oldest child (19), I have a brother (14), two stepbrothers (17 and 9) and a stepsister (7). I should also point out that my mother is a massive prude and my stepfather isn't much better. Anyway, all seven of us are sitting there in the restaurant waiting for our food, we've been waiting a while, and the kids are starting to get a bit bored.

So my 10 year old stepbrother starts telling some jokes. If you've ever been around a child who tries to tell jokes you'll know that... well, they're pretty shit, and the other kids started calling him out on the fact that they don't make any sense. I was busy texting my friends, but because I was half listening in on this conversation I decided to chirp up.

&gt;""Hey, I know a funny joke. What's pink and fluffy?""

&gt;""*I don't know*""

&gt;""Pink fluff!""

After the initial confusion the two youngest kids started to laugh.


&gt;""OK I've got another. What's green and has wheels?""

&gt;""*Ummmm... a green car?*""

&gt;""Nope, grass. I lied about the wheels""

They start laughing again, and my parents who were now listening in let out a little snigger.

&gt;""*Tell us another, tell us another!*""

And then everything went to shit. With my eyes still glued to my phone, and my brain only half focused on the inane conversation I was making with my younger siblings, I guess I just blurted out a joke buried somewhere in my subconscious.

&gt;""What's brown and sticky?""

&gt;""*Oh I know this one! A stick!*""

&gt;""Anal.""

Silence. Having immediately realised what I had just said, I looked up and saw six blank expressions looking back at me. I felt my heart sink. The 7 and 9 year old, clearly confused were the first to say something

&gt;""I don't get it""

&gt;""*I don't get it either*""

&gt;""Daddy what's anal?""

&gt;""*What's anal?*""

My 17 year old stepbrother bursts out laughing, having clearly understood the joke, but more likely laughing at the whole predicament. His laughter only infuriates the younger kids who still don't get the joke.

My 14 year old brother goes bright red and stares at the floor, clearly aware that 'anal' is an inappropriate and possibly sexual word and absolutely not wanting to get involved.

My parents both desperately try to change the subject.

&gt;""It's nothing, don't worry about it""

&gt;""*It's nothing*""

&gt;""I wonder when our food is going to get here

&gt;""*These are nice napkins, don't you think these are nice napkins?*""

&gt;""You're right honey, they are nice napkins, eh kids?""

Our food arrived swiftly. We ate quietly. The drive home was quiet. My mother has only spoken to me once since the incident. She walked into my bedroom and very calmly told me that she was both shocked and disgusted at me and that she will never be able to look at me the same way again.

Oops.",TIFU by telling a joke about anal sex to young children,2726
fuck4847837923-9,189,728,1okanq,1774,"I'm a software developer. I was developing a software for a client, who is a stocks trader. The software is a trading software for automating the buying / selling of stocks.

I normally use a demo account to test my software, and during this testing, I purchase / sell hundreds of stocks a minute. The software is 99.99% finished, the client has already paid me. He asked for some last minute adjustments, and I was working on them.

In the middle of this, I was having an issue, so I decided to try it with the 2nd trading program which was installed on my testing computer. Not knowing / remembering that this 2nd program was set up with my client's live account rather than a demo, because a couple weeks ago the client had logged onto this computer to do something, and then had left his main account logged in.

So I fired up the program and began my testing, and executed god knows how many trades in a few minutes. Suddenly, I got a call where I got told to immediately stop whatever I was doing. So I looked, and noticed that it was logged into the live account rather than demo..

This all happened a few mins ago, I've tried to call my client but he told me tersely 'I'll call you back later'. I don't know wtf I'm going to do. I'm considering just packing up my things and leaving town without telling anyone where I am going.

I could use any advice / help, please.. thanks.

Edit: Some more explanation of exactly how this happened: http://www.reddit.com/r/tifu/comments/1okanq/tifu_and_cost_my_client_20000_in_5_minutes/ccst1q5?context=3

Edit 2: Update. I have met the client in person. He's turned out to be nice about it and told me not to worry, and that it was his mistake for not having properly looked after his main account. He expects to be able to get the loss back in a month or two with my software (he asked me to finish it). So, for now, it looks like things are going to be okay.","TIFU and cost my client $20,000+ in 5 minutes.",2502
ejaculator123,446,938,1kgsc7,1767,"Being a horny teenager in the summer who recently discovered the joys of premium porn sites can lead to some very awkward scenarios. This is one of them.

I was watching some of the best shit I'd ever seen (I'm talking Brazzers True Life HD at 1080p and the like, there's just no going back), when I decided it was time to fap. I was lying down on my bed, sonar mode engaged (one earbud in, one out) face down, fapping away, just on the verge of climaxing when I heard footsteps nearby. I threw the ipad under the bed and tried to hold it in while I pretended I was just getting up from a nap or whatever. Well, while I was getting up, my dick brushed up against my thigh or my pants or something, then I knew I wasn't going to be able to control it. 

My dad does this thing where he will randomly tell me that he loves me, sometimes with a hug, and I really don't mind it, I'll even say it back and all. But this time, this time as he hugs me I can just feel myself coming in my pants, while I awkwardly maintain my crotch as far away from his body as humanly possible.

**TL;DR** : I came. While hugging my dad. While struggling to say ""me too"" without sounding like an incestuous homosexual.

The good news is, I don't think he knew what had happened, I like to think that the sweatpants hid the boner and that he didn't notice my weird hip position.",TIFU by ejaculating while my dad hugged me.,2705
no_defaults_cunt,311,703,1azvo3,1725,"Yesterday I was at work chowing down on some chili cheese fries. I'm about halfway through when I get this feeling like something is stuck in my throat (like when you swallow a big pill). I try coughing, still there.... I drink water, still there.... It starts to get worse, and it feels like its trying to work itself back up, so I cough some more, nothing.... So I figure it will be alright and it will go away in due time. 

So I go about my business and as I'm talking to people it feels like something is working its way back up my throat, and its about to make me throw up. I also notice I can't say more then about 5 words before I go horse, so I'm getting a little weirded out, but nothing too alarming yet. 

About 3 hours into this and my neck starts hurting. Its a dull pain but when I touch my neck it's noticeably swollen, and crackles when I push on it like a Rice Crispies Treat. Now I'm officially freaking out. I decide I should go to the ER and get checked out. 

On the way to the hospital, my chest starts hurting, I can barely breath and my neck and shoulder are killing me and this fucking thing is still in my throat. I'm really freaking out (probably didn't help) and now I'm convinced I'm having a heart attack. 

I get to the hospital and the doctor starts examining me, as soon as he touches my neck he pulls back and his eyes go wide.... He starts ordering all kinds of shit, first nitroglycerin, then Xrays and immediately hooks me up with some super antibiotics, and is calling in a cardiothoracic surgeon....So now I'm like ""FUCK, FUCK, FUCKDY, FUCK... I'm 27 and having a heart attack from those greasy ass fries, I knew trans-fat would kill me but shit I didn't think it would end like this."" 

Turns out a french fry had punctured my esophagus, which was causing all the air I was breathing to empty into my chest/ neck cavity, which was causing the neck/chest pain and the crackling in my neck (subcutaneous emphysema, for any of you doctory types) . As if that wasn't bad enough the doctors are concerned about food particles spilling into this open cavity and causing an infection (which is apparently really, really, really bad), so I have to sit around for three days with no food, no water, shitty movies, Hoping that I don't die, should be loads of fun.... 

TLDR: Trans-fat really will kill you! 

EDIT: thanks for all the well wishes, ill keep you all posted. So I'm off to bed. The nurse is supposed to be giving me something to help me sleep. I asked her about the ""binding"" issue /u/cilyarome brought up.....and she laughed.....and laughed..........and apologized......and laughed................ and advised against the sleeping meds..... I swear to god if this becomes a shit story I'm going to blame this sub, I'm convinced this sub is cursed with Montezuma's revenge 

EDIT2: from /u/shadekitty https://soundcloud.com/rac91790/french-fry-fracas Its pretty sweet. 

EDIT 3: So the ""attending"" came in this morning and after looking at the X-rays from this morning the doctors have decided we are not doing surgery. The air has started to dissipate, which means the hole is closing or has closed.  However he was worried about the possibility of an infection setting in, something called [Mediastinitis](http://en.wikipedia.org/wiki/Mediastinitis), which sounds pretty shitty. However he doesn't think its going to happen because I was able to get to the hospital and get started with the antibiotics so quickly. However Its going to be **at least** Thursday before we start a soft foods diet. PS No poop stories, however their is a ""binding"" issue... ",TIFU by nearly killing myself with a french fry. ,2428
digital_cake,275,312,15yoay,1728,"Babies little digestive systems apparently cant break down raisins. I learned this last night when I changed her diaper and noticed a couple of grapes in her diaper. Only they weren't grapes...they were raisins that were rehydrated with liquid shit.

After I fully understood what this meant, I quickly disposed of the diaper and hoped that I would never have to think about it again.

Flash forward to this morning as I was getting ready for work, my baby came out of her room with a sagging diaper and motioned that she needed a change. Poop. The same liquefied poop from the night before was everywhere, down her legs, inside her jammies, in her little foot sock...everywhere. 

So I peeled back this filthy layer of clothing and saw the failed diaper. I opened the shit stained diaper and was confronted with a steaming mass of rehydrated poop raisins simmering in a stew of brown disgust. 

I about lost it, but had to finish the job for the sake of my daughter's comfort. I immediately threw wipes everywhere cleaned her up head to toe, and attempted to place the diaper in a bag for disposal. The only problem is the diaper and wipes were too big for the little disposal bags we had. I tried to force the diaper in and a couple of poop raisins squirted out and onto the changing table.

A couple more wipes and it was over, the nightmare was over. Too bad my wife was the one that actually fed her the raisins.

TL DR; don't feed baby raisins. They rehydrate with shit.

edit: grammar

Edit 2: honored to be FUOTW.  I would like to thank poop raisins everywhere, I hope one day your dream of becoming shit grapes is realized.",TIFU by feeding my baby raisins,2040
CG1991,264,1236,1gvvwj,1715,"In work packing a customers shopping bag and put bananas on top (to stop damage). Customer runs off to get juice; which I try to put in the bag as well. 
He grabbed the bananas and said, ""you fucking idiot! Bananas bruise, you piece of shit!""

At this point, I had had enough of peoples crap (a story for another day). I snatched a banana back and proceeded to hit him around the face with it while saying, ""You're right! They do fucking bruise!""

I am currently awaiting investigation by the area manager.",TIFU by beating a customer with a banana at work.,2951
Ask_Me_If_Im_Racist,542,670,1epltg,1700,"Let me preface this with the acknowledgement that no, I am not a genius, but I *am* a reasonably smart guy. Unfortunately, I am nontheless a *guy*, which also means when I'm horny, I'm motherfuckin *horny*. 

I recently got a pretty gorgeous girlfriend who is also into Harry Potter and is generally pretty fantastic. It was a really insane story for another thread, but basically, she is/was the ""it girl"" on campus and has been around. One night, after watching Night at the Mueseum 2 (solid motion picture btw), we were swapping weird sex stories. She was kicking my ass, of course, as she had known more guys than I had girls. She mentioned one guy who was really into ass play. Apparently, he had had the most intense orgasm she's ever seen. Couple minutes later, we bang, something something basilisk in her Chamber of Secrets. Sex is fun.

Well, a couple days later I got curious. I decided that I needed to try ass play. Don't ask me the reasoning; I had it in my head (and later I would have it in my butt) that this was the only way to go for now. I looked around for something to use, but weirdly didn't have much to work with. Finally, I found an empty [blackberry Izze bottle] (http://i.imgur.com/ICPYhjc.jpg) that looked okay. I think even then I knew it wasn't my best idea, but I was also determined that *this empty beverage was gonna go in my butt, god damnit*.

It started off well. I had watched a little porn to understand what to do. You may not realize it, but the male prostate is only a couple inches past the anus; I didn't have to go deep. Nonetheless, I was enjoying it moderately and pushed my limits. I don't think it would have been my greatest orgasm, but then I never found out, so maybe I should reserve judgment. Anyway, I challenged myself to go deeper and deeper. By butthole was not used to this, and in a way it was like a competition with myself to prove that if I wanted to, I could get some surgery and star in Backdoor Sluts 12. It was enjoyable, if stressful. Then it got bad.

I was doing this in my bedroom, ass in the air. Little did I notice how I had inched toward my low, wooden nightstand. I became a tad bored, I suppose, and with 1/2 the bottle from the opening up my ass and unaware of my future despair, I made the biggest mistake of my life: I jerked my ass up, slamming the bottle into the nightstand and **shattering the bottle inside my asshole.**

**WHAT THE FUCK. JESUS. AWWW LORD REEKIS SOMEONE HELP THE FUCK MY BUTTHOLE MY BUTTHOLE JESUS FUCKING CHRIST!** The pain was the greatest I have felt in my life; the panic of the shattering, I believe, had caused my anus to close as tight as possible, trapping the broken glass inside. Furthermore, as I immediately slammed by ass to the ground, the glass inside further shattered. Imagine *pieces of broken fucking glass, too big for your rectum, desperately poking and clawing from the inside to escape, as your poor ass bleeds from the wounds inside*. Worse yet, simply *farting* caused the glass to sink deeper into my rectum. Yes, the slighest bowel gas or movement increased my pain ten-fold. I called the hospital and got an ambulence sent; they rushed me there (on a bumpy highway, mind you) and three hours later I was in surgery. I'm in a hospital bed now, and I can't look any of the nurses in the eye. Most of them giggle when they go over any treatments because they know what happened. My girlfriend literally cannot look at me without cracking up. She has taken to calling me Glass-ass, or the Broken Butthole.

**TL;DR, I tried putting a bottle in my ass and it shattered, plunging me ino an infinity of pain and permanently bruising my manhood. Also, my rectum.**",TIFY by experimenting and exploding a glass bottle inside my ass,2370
strangemotives,337,634,1e6xnu,1673,"Simple story really, 100 year old house, ancient wiring and fuse box caused big problems, so I was running a generator for the basics while I did the upgrade. Friday night I came home and, as not to waste fuel, I had simply left when the generator ran out and came back about 1AM to top it up and get to a long night of redditing.. Unfortunately, it was pitch dark and I couldn't see what I was doing when I poured part of a 5 gal gas can in, and apparently, I did some spilling, because once I sat the can down and pulled the starter it went up in flames, which I was unable to stop. I got my dog out and called 911, got into the back of an ambulance after warning firefighters of the fuel, and woke up sometime Saturday night after an apparent unconscious helicopter ride to a bigger hospital. Waking up with a tube down your throat is not fun, even less fun? finding out that your house is leveled and you and your dog have become homeless. 

edit: some folks seem to think I'm trying to pull something here, so here's the local newspapers take.. if not entirely accurate: http://www.zanesvilletimesrecorder.com/apps/pbcs.dll/article?AID=2013305040018&amp;nclick_check=1

I love that they refer to my dog as ""another person""



re-edit: Guys, with all of the local replies and PMs I've recieved, Z'ville should really have a meetup sometime.. hopefully when I've recovered a bit and can buy you all a drink!



",TIFU and burned down my house..,2307
UpvoteGirl82,244,519,16zqr7,1612,"So my boyfriend and I have been going strong on a diet for a few months now.  He went out with his buddies last night and left me home alone.  It was a perfect chance for a super secret cheat day, but nothing in the house was worthy of the occasion.  I decided to go to McDonald's and order the most ridiculous thing possible: a McRib sandwich.  I've never had one, so this was going to be extra special.  I drove home, settled onto the couch, and slowly unwrapped the magnificent holy grail of obesity.  Two bites in, I get a text message from my boyfriend asking whose car is in his parking spot.  (my neighbor's had a party and someone took his assigned space.)

Shit.  He's home.  

I gather the evidence and stash it ""someplace safe"" and run to the bathroom to brush my teeth.  In the heat of the moment, I was more concerned with him kissing me and tasting McRib than I was with committing the hiding place to memory.  So he walks in the door about a minute later and I looked cool as a cucumber.  We chat, have sex, and cuddle up for sleep.  I'm laying there, trapped under his arm, and fearing my secret will be discovered before I can destroy the evidence.  He left for the gym about an hour ago (6:45 am pacific time) and now I'm tearing the house up looking for the sandwich.  Where the FUCK did I put it??  I've tried the kitchen cabinets, under the couch, the back of the freezer, everywhere.  No McRib.  I have another 20 minutes until he should be home, at which point I will continue my hunt in stealth mode.  Wish me luck.
TL;DR Lost a 500 calorie sandwich in my house while trying to cheat on my diet.

Edit: YOU GUYS. I STILL CAN'T FIND THIS SANDWICH. I'm ""cleaning the house"" while he watches tv. I will keep you posted if/when it is found.

Edit2: Fuck me, he found it. It was in the entertainment center on top of the PlayStation. He came into the kitchen and held the box up with a puzzled look, so I came clean and told him the full story. So embarrassing, but at least I didn't shit my pants. ",TIFU by losing a McRib in my house.,2131
thesandvichisaspy,144,548,16rvtv,1601,"I'm European and as it is mandatory to have visited Amsterdam (Netherlands) at least once while in your twenties, me and two of my best friends decided to go on a trip there over New Year's Eve.

For those who don't know, Amsterdam is besides their liberal policy on soft drugs infamous for its red light district (with hookers dancing in those shopwindow-like cabins and stuff), and it is in fact the place to rock out and where everyone is partying. Since me and my friends are not really into smoking weed, we just gotterribly wasted - business as usual so far.

So, despite not having the intention to enter a hooker's cabin originally, there was that one gorgeous redhead, and as she began to wave at me, shit started to get serious. At that time I was in this particular state where the booze started to interfere with my rational thinking and fueling my sexual appetence. I thought ""fuck this"" - literally, told my friends I'm seeing them afterwards and went straight to that fine piece of redhead ass.

After spending one hundred Euros for her giving me head and some doggy while standing, she demanded another hundred to move action over to the bed, otherwhise we'd be finished here. Despite being drunk I realised where this was going and decided to cut it there instead of being ripped off. So I angrily put my pants back on still fully erected and left the place. I actually wasn't even that mad - I would probably rip off those drunk youngsters too, if I were her.

So i met up my friends again at the bar, told them the amusing story while we proceeded to intoxicate ourselves. This is where the actual funny stuff happened: I went for a piss and stood infront of the urinal, packed out and let go. The feeling of relief was there - but no splashing sound. I lowered my field of view to my privates to check what was going on and almost cracked up when I saw it. I actually never removed the condom and had been wearing it all along since I left that hooker, and now I'm filling it up with piss. When I noticed it had already expanded to about half a litre until it finally stripped itself off my dick due to it's weight and ended up in a splashy explosion. You should have seen that expression of amusement and disbelief from the random guy at the urinal next to me. I left the room not exactly knowing if I should feel ashamed or proud about myself. However I shared a good laugh with my friends about this after i told them - but still feel somehow embarassed.

TL;DR : I got wasted, visited a hooker and pissed in a rubber afterwards.

EDIT: Grammar/ clearify that the guy next to me was a random one",TIFU by getting wasted and visiting a hooker [NSFW],2149
children_are_evil,275,699,1l18a3,1604,"My mother teaches kindergarten, and I stopped by her class on the way to my own school to bring her some shit she needed for the day.

She introduced me to her loud-ass kids. ""This is my daughter, Lydia, blah blah blah. She's a big college kid."" They were all in awe. I felt kinda like a rockstar.

Afterwards, a boy ran up to me, holding a chair like a shield. I thought he wanted to tell me something, but he just kept running. That's when the little bastard drove his chair upward, into my unsuspecting crotch.

All the wind left my body and I fell to the ground, holding myself. I flopped on the floor like a fish. Mom pulled the brat aside while I, embarrassed and hurting, limped into the hallway, where I plopped down on a bench. I sat there, listening to my mom chew the kid out inside. I couldn't hear what she said, but the whole situation was pretty humiliating. I occasionally heard him cry ""But she's a girl!"" I guess he thought it wouldn't hurt because I'm a lady. I was sorry to prove him wrong.

A few minutes later, the boy came into the hall. My mom had forced him to give me a reluctant apology. I was even more pissed off now. ""You’re supposed to say 'It's okay.'"" he said. ""FUCK YOU, ASSHOLE!"" my mouth shrieked on its own. The whole hall turned to look at me like a monster. If only they knew my story, they'd say the very same thing! I just waddled out the door and drove off to class. Now I never want to show my face in that classroom again.

Apparently, later that day, the boy asked my mom what ""fuck"" and ""asshole"" meant. He also asked if I was a boy. He also had to sit out recess for his vicious attack.

TL;DR Children are assholes. Fuck 'em.","TIFU by telling a kindergartener ""FUCK YOU, ASSHOLE""",2303
lightninginabottle,464,550,1a3yj0,1595,"As a foul horny teenager without a cum rag in the immediate vicinity, I resorted the the nearest thing when it came time to blow my load, which just so happened to be a bottle on my desk.  A few days go by and I pop a few more loads in there without thinking anything of it.

About two weeks later, my mother comes down with some illness and is out of work for a few days.  She recovers, but afterwards tells me that she went into my room to look for illicit substances, and notices the bottle on my desk.  Apparently it smelled funny to her, and she thought there might be alcohol in it.  So, she tasted it to confirm.

It would seem that my semen contains psychedelic properties, because shortly after she began to experience extremely vivid hallucinations, became horridly ill, and tripped balls (seriously, no pun intended) for the next 24 hours emerging with little real memory of what happened.  The family Dr. convinced her that there may have been GHB inside, and it was wise to test me for drugs.  I admitted to it being GHB even though it wasn't, because I can never tell her the truth.

I created a throw away for this, I can't risk the possibility of her ever finding out.",TIFU by ejaculating in a bottle.,2145
FuriousGorilla,309,616,182lxd,1586,"A wee bit of backstory: I don't drink hard liquor, I don't like it and it doesn't like me. I can drink wine and beer regularly with little to no issue but stay away from the hard stuff. Amongst my friends and family there is a standing ban against two types of liquor specifically; vodka, because it makes me cry like a baby, and tequila, because I will (attempt) to have sex with pretty much anything. Now I think whiskey will be added to that list.

The Story: My Wife and I are prepping up for a night of pizza, booze, TV at the liquor store and I reach for my old familiar 6 pack. She says that she is bored with beer and had heard one of her friends talking about how delicious Rye Whiskey and lemonade are, so I consent and grab a bottle.

We get home and start mixing drinks, and the mixture is quite delicious. It has the sweet tang of lemonade and the oaky warmth of whiskey but zero alcohol taste, this is a bad thing. The drunker I get the less I can taste the alcohol, so the stronger I make the drinks, so the drunker I get and it snowballs from there.

My next memory is waking up the next morning, still very drunk, and feeling like I've been trampled by a team of horses. My wife has already left for work an hour ago, so I get dressed rather sloppily and head out myself. I carpool and it was not my day to drive so I didn't drive drunk. I make it there and get settled in with a muffin to soak up the alcohol and text my wife to see why I am so sore. Her reply, ""You bit me and I kicked the shit out of you."" I go to the bathroom and lock the door and take off my shirt to find my side and shoulder to be one giant bruise.

These are the events of the evening as pieced together from my wife's story. I drank most of the bottle of whiskey by myself.  She had two drinks with ~2 shots each, and I had the rest. I was not able to make it through the Daily Show and Colbert Report so my wife drug me to bed and tried to have sex with me. By this point I apparently had unprecedented levels of whiskey dick so that wasn't going to happen and I just yelled/sobbed drunkenly into my pillow for a while. She finds the quite amusing and starts jokingly saying things like about me being impotent (which I'm not normally) just so she can laugh at my over the top responses.

Eventually I just get annoying and it late so she rolls over and tries to go to sleep, accidentally pulling the covers off of me. So, I do what any rational person would do and bite her. And not a nibble either, I lock on like a pitbull and don't let go, apparently I also pull her hair. My wife slugs me in the forehead until I let go, then a few more times in the side of the head and the shoulder/rib area for good measure before kicking me (literally) out of bed.

She isn't mad, in fact she finds it quite hilarious. But I have never felt worse (mentally or physically) and it doesn't help when she makes spousal abuse jokes.

TL;DR I'm a light weight, I fight like a girl, and my wife has a wicked left.

Edit : Some words.",TIFU by getting black out drunk and biting my wife.,2202
little_foot_89,332,753,1jkam7,1537,"Just got off my period and hadn't gotten head in about a week. We had been talking about it all day, so before bed I thought it would be a good idea to sit on his face. while he was eating me out I kept saying don't stop as I was leaning back, clenching my legs around his face. Rather stopping, like he should have, he decided to listen to me scream don't stop and let me finish cumming. As I finished, i realized my boyfriend was unconscious and to make matters even worse I knee'd him right in the face as I was getting off. 

EDIT: I did not kill my boyfriend, I just knocked him unconscious for a few minutes. Needless to say, I won't be sitting on his face anymore....",TDFU by choking my boyfriend out while sitting on his face. NSFW,2290
notaneggspert,440,778,1a909p,1527,"So I'm on spring break her parents go to her brothers baseball game that's an hour away but take separate cars.

I sneek into her house anyways and we enjoy some alone time for the first time in 2 months. We're good, we're cuddling and the garage door opens.

Scrabble to get on clothes success. But no time to get down stairs. Fuck.

So now I'm hidding in her closet behind her clothes till her mom: A goes to the store, B walks the dog, or C parents dad and brother come home and fall asleep around 10.

Help? 

(Ignore the grammar/spelling/punctuation I'm on my phone and fingers are still twitchy with adrenaline.)

Update 1: her kindle chargers long enough to reach my phone so that's a plus but I have to take a mad post sex piss.

Update 2: yay her dad and brother are back too... at least her dog's not giving me up


Update. 3 go a head and fuck me. Her dad came into.her room into the corner with the closet and looked around he's suspicious and came literally within inches of finding me. Chaining me up in the basement. and fucking me with a splintery piece of wood. I want to.come clean and be honest but I think it's too late for that.

Update: 4 have a bottle to piss in and move the shoe from under me without banging into the wall. That's better. 2 more hours and I should be safe.

5: filled that bottle to the top and feel a lot better

Update 6 it's all over she found me told me to get out of her house wouldn't say anything else to.me just to leave. Idk what happens next. Sorry guys. 

update 7: first off I realize how ridiculous it sounds for a guy in college to hide from his girlfriends parents. Her parents vary much want to believe their daughter is a darling pure angel. And she is but she's not 7 years old any more... they haven't accepted that so I wont be allowed to see her for a while.

Also at first we were really banking on the fact that her mom would step away and I'd get out before her dad/brother got home like I was never there and avoid the whole thing. But that didn't happen and it was to late so siting there waiting seemed to be the best answer because if I had come clean we'd be in the same situation.

She's not responding to me but her mom texted me essentially that we fucked up, lost her trust, and I can't see her for a while. Again with most parents we wouldn't be in this situation. Her parents are not the average parents.

I'll update again when I hear from her again...

**TLDR- I'm Beta as fuck when it comes to her parents**


Update 8: Alright guys so gf got back in touch with me and turns out her nosy neighbor saw me walk into the house, knew her parents were out, and called her mom. Seriously I know this sounds like I'm dating a child but that's what happened. That's her mom and neighbor for you. 

So her mom knows I'm in the house, drives home and asks my gf if I was there. She of course lied which we now know was the wrong thing to do. Coming clean right then would have still fucked us over but at least we wouldn't have lied about it. Problem is we didn't know she knew and were hoping she'd be gone in 10 minutes then I could leave. This has happened once before and her mom got what she came for then left. I got out of the house asap with out a problem last time and we hung out the next day.

If this story didn't have any bat shit crazy in it I wouldn't have posted it. I'm going over tomorrow to apologize in person, come clean, and try to retain what ever man I have left in me.

**Also this is Today I Fucked Up not Today I Had Foresight. I fucked up.**

Update 9 I'm going to bed I'll probably be back tomorrow.

Alright guys another update/clarification. My Gf is 18 but hasn't been for long, she's graduating from high school in a couple months. So that helps explain the situation.


Last update for a while from a comment reply that's probably buried at the bottom of this:

"" Sorry so basically her mom's mad at me and I'm not allowed over for a while. I'm 300 miles away anyways so it's really not a huge deal and will probably blow over before my last exam.

I went over to her house Saturday to apologize to the mom (both our families were busy Thursday/Friday) but she wouldn't open the door or speak to me so that was that.

I sent a letter in the mail should come any day...

Hopefully time will heal this and they will realize their daughter isn't a child any more and what we did really isn't surprising. It's damn near expected I'd go see there daughter when ever I got the chance.

Ohh also she doesn't think we were doing anything sexual. ""We were just spending as much time as we could before I left since we both had lots of other things to do over break"".

So she's not even mad about the sex just that I was there. If I had come out when she came home I'd have my dignity but we'd be in the exact same situation. I'd just still be a man.""",Tifu and now I'm stuck in my girlfriends closet [help],2305
electromind,142,496,16byk2,1526,"Basically, i walk into my work bathroom to drain the vein. I notice a little fly chilling inside the toilet bowl, Im in a stall not a urinel. I busted out my dick as fast as i could, as i was excited i was challenged in a game of accuracy. First hit i nail that fucker dead center. He flopped into the water and i tried bombarding it with my urine. I thought i hit it enough to submerge it under the water. But i thought wrong. The little fucker flew right up and landed on my lip. I immediately freaked out and tried knocking it off, causing me to piss everywhere in the stall. Including my pantleg. Lesson learned, don't fuck with flys.

Tl;dr

 i got my own piss on my lips.",TIFU: By pissing on a fly.,2022
el-silencio,235,542,1kwvoi,1523,"I was riding the bus home this morning after working a 12-hour night shift without much sleep before work. I did what I usually do on the ride home, which consists of alternating between passing out and waking up every thirty seconds or so. For some reason the combination of falling asleep and the vibrations from sitting over the rear wheel of the bus commissioned a rigid, throbbing, leaning tower of mushroom meat in my pants. I woke up after a middle aged, southeast Asian lady occupied the seat next to me, her legs awkwardly touching mine and her breast rubbing against my arm with every pothole as we shared a seat in the confined rear corner of this stinking vessel for the disabled and vehicularly challenged.   
  
I panicked. My stop was approaching and I was battling a trouser dragon which I could not slay. Her unintended grinding and the bumpy road certainly did not help my cause. I considered riding the bus all the way around town until my man steak returned to medium rare, but this was not an option as I had to be home to let my girlfriend in, who did not yet have a key to the apartment.  
  
So I pressed the button to signal the driver to stop, planning in detail how I would exit the bus without alerting my fellow passengers to the angle of my dangle. I would put my backpack in front of my junk, stand up, and walk out the back door. The perfect crime.  
  
**Where I fucked up:** As I stood up, I dropped my bag. No fear, I thought, her satellites haven't detected my surface-to-air missile yet, I will just bend over and pick up my knapsack and carry on. So I did, I bent over, inadvertently tucking my cock rocket back behind my legs. As soon as I retrieved my back pack and stood up, I noticed she was getting up from her seat. Too late. Wrong place, wrong time, one inch too far. In a cruel twist of fate, the instant she arose from her seat, my beef torpedo launched from between my legs and slapped her square in the jaw. Fucking track pants allowed maximum velocity, too. Nothing but jeans from now on.   
 
  
I was off the bus and running for my life before I had a chance to witness the look of horror that was undoubtedly pasted on her face. I am never riding that bus again. *Never.*  
  
edited for grammar","TIFU by slapping an asian lady on the bus, in the face with my boner.",2065
andikinyon,284,674,1pm9oy,1519,"I am a server and we borrowed glasses from a local winery for a party of 50. We were in between courses and I was a bit bored.
I saw on the box of glasses that they claim to be ""unbreakable"" so if you knock it over, it will bounce and not break. So i lined a few up on the bar and played dominos. 
This only satisfied me for a few minutes. 
So I Took one in my hand and threw it on the floor.
I dont know what the fuck I was thinking.
It shattered, and louder then any glass shattering should sound.
 Everyone in the party looked at me. 
One gentleman saw the whole thing and told everyone what I was doing. 
I was ridiculed. My boss yelled at me, I had to pay for the glass, and explain to the owner of the winery what happened.
 I guess I got what I deserve for behaving like a child. ","TIFU by assuming that an ""unbreakable"" wineglass can be thrown on the ground at full force.",2193
master_mayhem,168,339,144sx7,1497,"We were in her bedroom sexin, 69ing with her facing her outside window, her dad came home drunk from the pub earlier than usual and looked through the window. The vision he must of seen, something a father never should...

All we heard was him swear outside, then my girl panicked and tried to get me out the backdoor, but he went to it also, so we ran to the front door and he ran up there like Terminator, I pretty much walked past him thinking he was gonna knock me out

He raged and said don't come around here again, worst day ever!

MS Painted picture of the event.
http://i.imgur.com/ZSfcu.jpg",TIFU Just accidentally let my Girlfriends DAD see her naked!! (NSFW - MS PAINTED PIC) ,1836
notfork,186,490,19j4fc,1494,"So this started last night really, I had a couple Edible marijuana treats.
Then today at work I had to poo really badly like almost poop my pants bad. So I run to the toilet do my business, I notice it smells a bit like the dank. I thought hrm that's strange. Five minuets later my boss comes screaming that someone was getting high in the bathroom and calls the cops.

They were there for over two hours they brought the dogs around everyone's desk and I just sat there like please do not bark at my ass.",TIFU and got the cops with k-9 units called to my work.,1984
DamnitBilly,255,233,wmnf4,1484,"-A little back-story before I begin-

My friend (Josh) and I have been best friends since Middle School. Ever since then, his family has become my secondary family entitling his sister as my sister also. We're both 20 and she (Janice) is 18. I have had a crush on her for awhile but denied the feeling since we're practically family. When I graduated HS I was kicked out of my house and Josh's family happily took me in as if I were their own son. Been living here and going to the local community college for the past 2 years now.

-Now to the stupidest, most fucked up, unforgivable thing I have ever done-

So mom and dad are out of town and we decide to invite a couple friends over, have a couple drinks, chill, just have a good time (Janice included). Some rum and coke and a couple hours later I find myself shmammered drunk. Josh has went to our room with a girl so I figured I'd sleep on the couch. Everyone is passed out and Janice has went to her room. Like clockwork I go tell her goodnight, as I always do, but this time I find myself laying on her bed. We start talking and somehow get to talking about our feelings towards each other (I've always had a crush on her but ruled it out since we're practically family and apparently she did also). One thing turned to another and we start making out, I'm taking her clothes off and vice-versa, and I'm eating her out until I get my whiskey dick to act properly. It obliged and we do the nasty. Now, this was THE best sex I have ever had but it hurts to say it due to my predicament.

I have been talking to Janice pretty much all day today about how and when we should tell Josh, knowing he's gonna turn furious.

**TL/DR: Got drunk, talked mooshy mooshy shit with friend's sister, had sex with her.**

Also a question for y'all (Yea I'm from Texas!!). How the FUCK do I bring this out to him!?

EDIT: Thanks for all the input everyone, I think I may have made the best decision ever.

Ok, this morning Josh went off to class and I decided to stay home to talk to Janice about everything one last time. We talked and talked until finally we came to the conclusion that we actually want go out with each other. And I've got say, I have never felt this much joy in a relationship so that's a major plus. When Josh came back we broke it down to him together as us having these feelings for a pretty long time and we think it's time to begin a relationship. His reaction, pure happiness. Here's a a basic summary of the convo:

Me: ""Hey dude, me and your sister have feelings for each other and we want to start dating. But for respect for you and your family if you don't agree, by all means I'll back down.""

Josh: ""FUCKING FINALLY MAN! I've been waiting for this shit to happen you dickwad. I've even mentioned it to Mom she's cool with it also."" (Not all exactly, but 
pretty much)

Me: ""Wait, what...?""

Josh: ""Yea man, you can't hide your feelings very well. You get all nervous and shit when you're around people you like.""

Me: -_- ""Thanks bro..""

His reaction was one I could not have guessed was gonna happen but I am happy for it. So, in the end.. Success. Had sex, got the girl, still buds, and not homeless.",TIFU and had sloppy drunk sex with my best friend's little sister,1717
Thatfatcat,207,361,1736z6,1479,"(About six months ago) So one day my brother was playing music from his iPhone in his car while driving with our friends, and thought that it might be funny to put porn audio onto his iPhone in the music section, and maybe if I'm lucky, while him and his friends are in the car driving someday, it will come up on shuffle. That night I went and made an audio file from some random porn, put it into our shared laptop's iTunes library, and synced his phone to it. I named the file ""Zzzzz"" so it would appear at the bottom of his music selection, and he wouldn't see it. Now all I had to do was wait. The next day, he lost his phone at a party, so I completely forgot about the prank, as his phone was now gone. 

And so today, I had a date with a really sweet and pretty Christian girl. It was our third date, and I picked her up after class to take her to lunch. She had a headache, so while trying to be a gentleman, we stopped at a gas station, and I ran inside to buy her some Tylenol, because she didn't have any. I left my car on, and my phone on shuffle while I went in. It turns out that I had inadvertently snyced my iPhone to the same iTunes library that contained the porn audio sometime during the last six months. Now out of 3,000 possible songs that could have played, the porn audio was the one that decided to play when I was in the gas station. And this very Christian, but very sweet girl, sat in the car as it decided to rear it's ugly head. I come out of the gas station Tylenol in hand, to see her standing 10 yards away from my car on the phone, asking one of her friends to pick her up, because she thought I was a freak. I attempt to talk to her, and she goes inside to the women's restroom and says ""stay away from me"". Not wanting anybody to think that I'm assaulting her, I head to my car, and open the door, to be greeted with the sound of a girl moaning and other various sex sounds. And then it hits me what happened. It's now about 7 P.M., and this girl I really liked won't answer my text or call. 

I really fucked up.",TIFU by using porn to attempt to play a prank on my little brother.,1840
kitty_puncher,264,527,18g44v,1477,"I am so sorry. I am a terrible person. My friend and I were hanging out and his cat was chilling on the couch between us. We paused our video gaming to watch the state of the union address and at some point we started to kung fu fight each other like best friends do. Only we didn't get very far.... so we were drinking a bit, and I felt a karate chop on my shoulder, and did a turning straight jab into his leg. Although his leg was soft and furry, and made a weird noise like if you were hitting a small bongo and that bongo also was a cat. I realized then that I punched tony the cat. I am a filthy cat puncher. I should be ex-communicated from reddit. 

I am so sorry tony.",TIFU by punching my friend's cat,2004
facetious_journalist,522,867,1g96de,1471,"**TD;DR-** I ended up wrestling naked with a venture capitalist in a ten-thousand-dollar suit on a dirty bathroom floor beside an unconscious IT professional while my family and friends were either egging us on or trying to break us up.

The day before my twin sister’s wedding. Hadn’t seen the majority of my family for about five years because I’ve been working overseas for an evil media conglomerate. Aunts and Uncles all look older, more weathered. Cousins are taller. Most of them have grown from such delightful children with rosy cheeks unfurling in wonder and fascination in to self-absorbed teens with faux-angst dependency. This generation can tell, I mean, force feed hundreds of people their inner angst by either posting Nirvana lyrics on Facebook or sharing a 50’s country love ballad that only they find kitschy and awesome because they found it on Spotify.  

This sister getting married, Abilene was kind enough to find little formal jobs for her *little* cousins to do at the wedding to make them feel somewhat less alone in their painful solace that is their life. She said it was enough of a present for me just to be there as I had to endure the expense of a business class ticket and embarrassment of defecating in my Levi’s somewhere over the Pacific in the midst of a Xanax rage. 

Now I don’t particularly care for the particulars of those in particular that don’t particularly care about mine. Namely, Simon. Abilene’s very-soon-to-be husband that I hadn’t even met yet. Well. I met him earlier when he asked me to “get off the phone” because “he needed it for business” and that I “should ask the host’s permission” before I used it in the first place. This was in my father’s office that once served as the baby room for each of my elder siblings and I. It was once of those moments when you know exactly who you’re dealing with because you’ve done your fucking homework. So anyway, after this Simon guy told me off for using my own home phone, he would walk around while staring at me briefly each few steps. 

The wedding was tomorrow and a few of the elderly guests were retiring to the guest houses for the evening while the core wedding procession of the young and fit decided to keep the beer and wine river flowing. Simon took it upon himself to wish the leavers a good night before locking eyes with me, as if to tell me to politely fuck off as it’s just family and friends now, bucko. Abilene was sitting next to him at the round table as he looked down at her and then back at me before repeating. I think it was then that he realized that the guy he’d been trying to belittle was in fact, an almost identical genetic clone of the person he’d been fucking for the past few years. Abilene gestured for me to come over and one of my older brothers pulled a chair out for me and shook the ice of a beer can as he slid it across the table to me.

“I’m Grosvenor. You must be Simon.” 

His little heart sank quicker than a stiff dick in a shoe shop. 

Sat across from me were the MC and Best Man. His name was Phil but that’s largely irrelevant because next to him sat quite possibly the hottest chick I’ve ever seen in person. You see, Phil was in to computers, thus being unable to have sex without some redeeming features like money and a strong jaw line. Phil had both but only because I was 60% sure he had either tapeworm or blood cancer. There wasn’t much of him; it looked like a bad fall might finish him off. It never occurred to me that they were together at the time. I just assumed she was a friend of my sisters that took being a self-conscious teenager to a whole new level.

Now I should point out to you now that my family lives on a big ranch/farm in the middle of west bumblefuck, which was also where the wedding was so ALL the guests were staying in the homestead, shearers’ quarters or the guest house. Privacy was a rare commodity. 
I was sleeping in my old childhood room top and tails with one of my brothers in the double bed. The hot chick was in the next room with Phil and some of the other groomsman. That should’ve been enough for the penny to drop but no. 

Dad and I shared a [longneck](http://backoftheferry.files.wordpress.com/2011/02/vb.jpg) over breakfast as he looked to calm himself a little for the big day. I just said yes because I have chronic alcohol dependency from being a journalist. The bright summer sunrise was lifting the dew off the lawn and the gentle breeze whipped through the gums as my twin began to start her long walk down the aisle with her venture capitalist dickhole fiancé for the last time as a legally unbound couple. The details of the wedding aren’t really salient issues at this point. What was at the forefront of my hubris was what I’d do to have my way with the girl in the second row. My brother said he’d crawl a mile from broken glass and asbestos do just be in her shadow. I thought that about as funny as it was sad. She was looking at me the whole time with those round green eyes of a Bond girl. Something you must only look at but never touch. The emerald lawn next door that the neighbour never let you plan on as a boy. Colossal sad eyes of a long hearted mystic that harboured some sort of pain but in the midst of such beauty, seemed to be the apt portal in to such comfort.  The kind of darkness writers and poets dedicate their lifetime to describe. They were looking at me. It was either love, lust or the seven beers I’d had before noon that made her irresistible.
 
The ceremony passed in a blur with all the necessary pleasantries exchanged before the wedding party and guests moved over to the marquee, where it waited with heated pool and bar.

As the night descended into decadent and depraved display of everything wrong in the western world, the drunk, high and generally fucked up party guests began to jump into the pool. At this stage, I’d like to say I held off for a while until it became a thing but in reality, I was one of the founders of the “let’s jump in the pool” movement. The feeling of diving in to a pool in a cheap suit is very liberating. It’s like the feeling of finally making it in life without actually doing so. That brief moment when the screaming roar of worry and insecurities of life are silenced by the water above. I have a feeling that Billy Corgan wrote “Cupid de Locke” about that very feeling. 

Then she jumped in. 

She came up for air almost instantly. I didn’t need to say anything, she’d already had me captive since I first saw her next to Phil, the I.T. I was telling you about.

She swam a little bit closer until she joined me beside the point in the shallow end were the extra hot water shoots out of the jet. As she got within an arm’s reach she just smiled a little and let the momentum carry her up to the wall. I could only just stare as she just said ""Hi"" and we began talking for a while. I told her I was going to have a shower but I’d like to have a drink with her after got dry. 

So off I went back to the homestead, complete with squelching shoes and swollen pockets still dripping with chlorinated water. Mum always has a shit tonne of towels about near the boys’ rooms so we can just get clean whenever. She always made the effort to make sure her boys were clean and well-fed.

I jumped in the shower in my suit with the idea of taking it off in the shower. As I thought that this would be a rare opportunity to do so, I allowed myself that pleasure. As I was about to get out, I felt a hand on a shoulder. I spun around in fright (as if you wouldn’t) and it was her. The girl from the round table, the wedding and the pool. The girl who’d authorized each and every heartbeat since I first saw her. I kissed her and she kissed me back even harder. She threw her other arm around me and pushed me back against the shower wall. It was like that first sixty seconds after to snort some coke a mate shouted you. Not even I can accurately paint that picture for you. The wonder and excitement, jaded with fear and anxiety that only makes you want it more. You know your parents, friends and God don’t approve of what you’re doing but fuck those people. This moment is just for you and her. Just for the both of you. Everyone has that flash of sheer self-indulgence and pleasure that you literally couldn’t give a fuck about anything else except that heart beating under your hands.

The bathroom door swung open, creating violent vortexes as the steam and the cool summer breeze combined in a foreshadowing dance. Simon mustn’t have cared about his suit either because he suddenly joined the girl and I in the shower but he wasn’t there to party. He grabbed me and threw me out on to the tiles in all my naked sinfulness. Phil came in and kicked me in the back but he was in to computers so it didn’t hurt very much. I got up and tried to assess the situation better by trying to engage them in conversation but they were having none of it. Phil hit me in the head with his fist but again, because he was in IT, it didn’t hurt very much. Then Simon did this German Suplex move and threw me into the sink, which, as it turned out, hurt quite a lot. One of my older brothers came in and just king hit Phil and squared up at Simon before Abilene came in and burst in to tears

I looked around the bathroom but the girl was gone. Phil was in terrible shape beside the drain and Simon was huffing and puffing in his Hugo Boss suit. He grabbed me again and we fell on the floor as the others tried to break us up. 

So there I was. Wrestling naked with a venture capitalist in a ten-thousand-dollar suit on a dirty bathroom floor beside an unconscious IT professional while my family and friends were either egging us on or trying to break us up.

My sister still hasn't spoken to me and I’m waiting for my plane at the airport. I thought this would kill some time and it has. Now that I’ve written most of the key things out, it just outlines the sheer absurdity of that weekend. Mum is extremely disappointed with me but was heartbroken to see me leave again for another country. I had to leave in such a hurry the next morning that I didn’t have time to see the girl again. I have no idea what her name is but my Dad and my brothers are on the case because they are bros. I have no doubt that I’ll see her again. One day. Now that I’m persona non grata in my own home, I don’t know when that day will be but the future is pleasantly cruel sometimes like it was that weekend. 

The only thing I regret is that whenever people remember my twin sister’s wedding, they’ll remember her twin brother running some sort of naked fight club in a bathroom beside the laundry. If you’re a twin, then you’ll know what I’m saying when I say that twins have this sort of “shining” between them – a higher bond that can only be forged in a womb. I still feel uncomfortable now about it but when that feeling goes away, I know everything will be OK – and I can go back to finding the girl.                
  
                              ",TIFU by ruining my twin sister's wedding.,2338
r4rion,308,664,1o8mef,1463,"Don't ask how or why, but I ordered my friend a 36-pack of condoms as a joke (they were magnums so he couldn't use them) - they were expected to arrive next week.

-They arrived to his house today

-His mom opened the package because he shares the same name with his father

-Finds 36 individually wrapped magnums

-He comes home from school

-Momflipsshit

-Apparently his family is all coming into town tomorrow for a huge reunion 

-Now his parents think he is trying to fuck the girl relatives so they're calling them warning them of this

-TIFU",TIFU By making my friend look like he was going to have sex with his entire family.,2127
fistmyanusmatey,260,657,1m6s1z,1466,"So I was watching Game of Thrones under my desk when I had to step away for a moment. Nothing wrong with that right? Except that I was at work. At my family's business. And it was the episode where Ros and her fellow whore at the brothel are banging each other with Lord Weasel Baelish watching on like a creep. Oh, and it was my father that caught what I was watching. Did I mention that he is a conservative Asian? He asked why I was watching an X-Rated lesbian porn at work and I had to stammer out a response that this show was actually a respectable, award winning and popular tv program with yes, a wee bit of boobies and butts in it. I think he bought it. It could've been an episode where there were heads being chopped off or another where women are being slapped. But nope, it was the fully nude lesbian scene. 

*edit* and I'm a female ",TIFU by leaving Game of Thrones on while I stepped away [NSFW],2123
ktrcoyote,427,853,1ly6ya,1463,"This is one of the few times I will ever say ""this should be illegal"" in context to Marijuana...

Last night I drove to a dispensary I've never been to. I bought the weed and was about to leave when the guy behind the counter tells me:

""Since this is your first time here, you get a free dap of Hash!"" 

Without thinking too much -if at all- about it I took a MASSIVE bongrip of straight hashish, because how can you say 'no' to free, right?  

**I've never been so completely fucked up in my life.**

By the time I get out the door, I rocketed to a [7].  One block later I'm siting in my car blankly staring at the gas gauge. I was about to drive off through city traffic while verging on [10.] 

I didn't know what to do! I couldn't drive and I was stuck in a unfamiliar part of town. So I got out of my car and decided to walk it off. The paranoia set in and I automatically assumed every person walking towards me was going to rape, rob or shank me. Features on people's faces were becoming exaggerated and almost cartoonlike. Cars driving by would disappear before my brain could register the visual information. It was like my mind was on a 2 second delay.

I ended up hiding in an In-in-Out for about 2 hours trying not to hyperventilate. I then wandered around for another hour because I got completely lost trying to find my car.

To top it all off, when I finally got to my car there was a 70 dollar ticket for an expired meter.

FML

Retrospective Note: I'm an idiot and it was my decision, but dispensaries shouldn't be allowed to give out free samples, especially things like hash bongrips. It's like a liqueur store giving away free shots of Everclear before you drive home.   ",TIFU buying weed from a dispensary.,2316
BrickTheif,224,756,1k29tm,1453," WARNING: NSFW
_____________________________________________________________

Okay so today, i was jerking off, and i had just ""finished"". i exited out, and on the tab below, i had the picture of the seal born at the new england aquarium. (this one: http://i.imgur.com/6Hy2lgg.jpg ) my computer is just in front of my bedroom door, but off to the left a tad, so once you walk in, you immediately see the screen, and i was on an angle. (lefty) so, my mom walks in, sees me, pants off, seal on the screen, junk out, all done. i look up, made eye contact. my mom just staggered out of the room and went out somewhere. we haven't spoken all night. i fucked up. HARD.

EDIT: My Mom just gave me the acceptance speech. ",NSFW. tifu with a picture of a seal,2209
Sirtroz,231,535,1lmqqa,1457,"We were moving my bed and I forgot I had shoved my vibrator in between my mattress and box spring one lazy night.. When we flipped the mattress off there was a bright purple vibrator just screaming at us. My mom was silent and looked at me and could only mutter ""u-m--umm......."". My face turned bright red and i ran out of the room laughing. I've never felt more uncomfortable in my life. Ugh.. 

**EDIT**
F--k and I just realized I posted this on my boyfriends account. Great. 

",TIFU by having my mom find my vibrator.,1992
PCruts,250,588,1gz665,1431,"So my buddy's parents own a huge ranch and we were invited up for the weekend. His brother lives on the ranch in a house built somewhere around 1800. We stayed with him. Fast forward to Saturday night; we partied hard....very very hard. Sunday morning rolls around and I wake up. Hangover. So I did what I always do, I took 2 BC Powders, I got in the shower, turned the shower on low and laid down. I stayed like this for about an hour. Time to get out. I start to stand up. Horrific pain on the underside of my ball sack. I reach down, feel something under there, pull it out. It's a damn scorpion. So now as the underside of my ball sack feels like someone has poked it with a hot coal. I jump out of the shower, dry off, get dressed and kill the Spawn of Satan.

TL;DR: Scorpion stung my ball sack. Fuck you for laughing. ",TIFU By taking a shower in a 200 year old rock ranch house.,2019
FUCK_DESERT_BLUFFS,211,556,1pq7p7,1430,"Every year in October, my school has an annual blood drive. This was my first time giving blood, and I didn't really know what to expect.

The donation went swimmingly, there were no issues besides being slightly lightheaded, which was to be expected. After they took the needle out, they bandaged me up and sent me to the snack table. I felt absolutely fine.

Fast forward to when I got home. No one was there. Parents were at work, sisters were out doing some shit. I figured I might as well get off. 

Everything was going great, stupendously even. I felt euphoric. I finished and got up to pee, when suddenly everything rushed up to my head and I fainted. When I came to, I was on the floor, laying in a puddle of piss. I used 3 different cleaners just to get rid of the smell and threw my piss-soaked clothes in the washing machine. I didn't tell anyone.

Never again.


Edit: this happened two days ago.

Edit 2: I am a female, to clear up any confusion.

Edit 3: If you guys could stop asking me if I go to school with you, that'd be great.",TIFU by masturbating after donating blood,1986
Maklo_Never_Forget,399,614,1pxzy8,1414,"**UPDATE:**http://www.reddit.com/r/tifu/comments/1pxzy8/me_being_an_idiot_and_now_under_police/cd846se



-------------------------

A friend of mine send me this picture after a huge hardcore/hardstyle party we went to. [related picture: http://i.imgur.com/mFAht39.png ]

Those kids are dressed as ''gabbers'', it's how a typical 30 year old hardcore listener would look like.

The picture made me lol so hard I wanted to see if there where more pictures so while at school I decided to google some.

my search terms where:

Hardcore kids

young kids hardcore

hardcore children

- To no avail, so I continued my search:

10 year olds hardcore

11 year olds hardcore

young kid hardcore dancing

hardcore girl.

--------------

A few days after I was asked to have a talk with someone from the IT department who told me he found my disturbing searches, he related them to child porn w/e and that he needs to have a talk with my parents. Since I am 19 they luckily don't have to get involved after all but they handed the report to the police.


Tl;Dr searched for young children doing hardcore, ended up as a suspected pedo. FML.",Me being an idiot and now under police investigation about child porn/about to get kicked out of school,2028
cpawho,160,618,1ow689,1412,"Girlfriend and I were at a corn maze, and she got ahead of me on purpose so I'd go looking for her. I found her after a few minutes in the dark, by herself at a dead end, so I surprised her by turning her around and making out with her on the spot. 

Turns out it wasn't her. I got slapped and my girlfriend walked up behind me asking what the hell was going on. I explained to both of them what was going on and now I'm on damage control.",TIFU by making out with a stranger in front of my girlfriend.,2030
Childwood,234,324,16n6qu,1388,"I have a younger sister (5) who plays with all the other children who live on our street, they range from 3-10 years old. 

So my sister comes inside from playing, she's now crying and after being calmed down, begins to explain that one of the children, Olivia  (5), was being mean to her. Olivia was saying rude things and told my sister nobody wanted to play with her. Me, being a smart ass, quipped ""YEAH?? WELL, nobody even likes Olivia anyways."" My parents were quick to correct me, told my sister some stuff about not everyone is going to like you, how to deal with bullies and  all that good stuff before sending her on her way to play. 

This was yesterday. Today I received a phone call from my pretty upset parents saying my sister had instigated a group cheer along the lines of ""NOBODY LIKES OLIVIA"" and this was fueled by ""My brother says so and he's way older than you."" Olivia evidently relayed this to her parents, who informed my parents who now (rightfully) blame me for the mob attack and psychological trauma of a 5 year old girl. 

Apparently nobody likes Olivia anymore.  



",TIFU by bullying a 5 year old.,1712
For_fucks_sake_man,207,550,19qpxe,1377,"Yeah. So there we were.. Half drunk, doin the ol' in and out. I felt like a pornstar, throwing dick like a mad man. She seems to be enjoying herself. I am having the time of my life. She asks me to bust on her tits, so when the time comes I gladly give her what she wants. Now, I don't know about the rest of you guys, but when I bust a great one, I have a hard time thinking straight for a few minutes. Might as well be asleep for all I can accomplish. So when she asks my retarded ass to hand her a cum rag I reach down and grab whatever the hell I can on the floor and tossed it to her. That's not exactly right. I was actually on the up swing with the first soft thing I felt on the floor when the supposed wadded shirt decided to explode into her pissed off poodle. In my post-orgasm stupidity I sling the seemingly rabid goddamn poodle at her at the speed of light. This gremlin in disguise smashes into her face with the force of a mike tyson punch. The demon dog is none too happy about this as you can imagine. Hellhound decides since I have commenced evasive action while screaming my viking warcry he will take out his frustration on the next closest individual. You guessed it, the poor GF, who is currently disoriented and trying to figure out what the fuck has smashed into her face and why I am hollering like like I just zipped up my penis while simultaneously setting it on fire in a vice. The T-rex masquerading as a dog then bites the shit out of her recently broken nose. (I assume the initial impact broke it but there's no way I'm admitting that to her.) She then screams her Amazon battle scream and slings shit head the dog down the hallway. So there I was, holding my pillow of death up like a shield while she punched the shit out of me til I manages to stop laughing (I know, I'm evil) long enough to explain to her why her nose is bleeding like hell. Knock knock on the door. I discover my kind neighbor has called the cops after she heard our battle cries. So there I am, standing the hallway of my apartment building wearing a bathrobe covered in blood. Laughing maniacally at how stupid this is going to sound. Thankfully they split us up an my GF didn't lie and told them the exact same story I did they and they let us be. I swear those cops probably pissed themselves laughing at that one. For fucks sake man. 

Edit: holy shit front page! Thanks! Guess I will share a few more events in the near future :)

Edit 2: Awesome narration by Shadekitty: https://soundcloud.com/rac91790/bedroom-brawl

TL;DR almost got arrested after giving my Girlfriend a dog to use as a nut rag",TIFU by causing my girlfriend to get attacked by an angry poodle immediately after sex. Definitely NSFW,1927
forgotpasswordagain0,277,343,199cak,1363,"It's about 9.30 PM. Me and my friend have just gotten back from the beach and we're in my room playing video games, chilling out, whatever. The doorbell rings. 

There are two cops at the door. Okay, interesting. They ask me if my name is **Neil Person**. I'm not, I bought a car off him a week and a half ago then. My name is **Joe Everyguy**. I tell them that. 
They say,

""Joe, do you know where your car is?""

I look past them out to the front lawn where I left it, and its gone. Not there. I kind of have this moment that feels like it takes forever of trying to process it over in my head. I left my car there. Cars not there now. But I left it there. Keys are in my pocket.

""It's stolen!?"" I blurt out.

Eventually, they lead me to the street and point down the road.

My car crashed into a womans brick mailbox, totally ruining it - as well as the front bumper of my car. If it had kept going it would have crashed into the living room of a house which had a family sitting in it at the time. 

All of the neighbours were out the front watching, apparently it had been a commotion in the streets for quite some time. The police and the owner of the house turned out to be pretty cool with it.

There are a lot of attractive young women in my street it turns out. I have just ruined all chances with absolutely every one of them. 

Top score. ",TIFU and left my car in drive when I parked it on a slight incline. Tonight I met everybody in my street.,1706
plugshitter,232,447,1ldd0r,1348,"So, I'm a kinky gal. I have a bit of a voyeuristic side. I just started class a few days ago and today I decided why not be naughty and wear a buttplug to class today?  Stupid stupid me decided to wear a pear of loose shorts because it's still fairly hot out. I've never worn a buttplug out without wearing jeans or yoga pants. Guess it was those, not my clenching skills, that typically held the plug in place.

Shortly after my first class walking through the hallway I felt the plug begin to slip. Panicking, I began to quick walk to the restroom clenching my cheeks, but to no avail, the plug slipped out, right passed my undies, out the bottom of my shorts. I have no idea if anyone noticed, but I bolted for the lady's room and hid in the stall for a good 10 minutes. 

tl;dr lost my favorite buttplug",TIFU by pooping out my buttplug in the hallway,1795
FranklinFox,206,358,17sx2k,1344,"Got accused of being drunk, got sent home after 45 minutes, had to get breathalysed, had to ring and talk to the big boss to prove I was sober, got told I could be fired on the spot (even though my BAC was 0, so that would be unfair dismissal). 

Lesson I learned today; if you hate your job don't go in smiling and laughing because they'll think you are off your head. 


Edit: I have a meeting with my boss before I start work today over this, will updates on my break. 

Update: my boss said that the big boss was coming into talk to me tomorrow to explain my side of the story, I reminded him that my BAC was 0 and he said that he has to go by what was reported to him from my co workers, I told him that i wasnt stumbling, slurring, i was walking in a straight line and that he couldn't fire me over an allegation and that it would be unfair dismissal and workplace harrasment, he dialed it back a bit after that and said that I won't be fired but that he is still angry at me for making people think I was intoxicated. ",TIFU by going to work in a good mood. ,1702
GabrielNaess,283,456,1ohsku,1338,"So lately I've been having the diarrhea real bad. (I did not shit myself, just saying.)
And as such I've been forced to excuse myself from class several times a day.
Apparently I was not the only one with diarrhea, a girl in my class was also suffering from it. 

Today I was called up to the principals office where the girl was sitting.
I was caught off guard when I saw slight fear and disgust in her eyes when I entered the room and sat down.. beside her. ( &gt;_&gt; )
The principal told me that I was suspected of stalking this girl since Monday. A bit shocked I asked why.
It turned out that I'd been excusing myself to go to the bathroom right after the girl did. Every single time. *Face palm* I apologized and told the principal that when the word ''bathroom'' was said something must've triggered inside me and made me want to shit.

Although I apologized and explained why this happened the principal called the girls parents and my own. We have a meeting scheduled for tomorrow. :/

TL;DR Had to shit, ended up being accused of stalking a girl to the bathroom.
",TIFU and stalked a girl at school without realizing it.,1794
JedLeland,106,504,1hk11k,1336,"I'm a bit of a slob.  I leave my clothes lying around, I'll often leave soda cans and beer bottles at my desk for days before I expend the energy to toss them in the recycling, and generally the only time I make my bed is when I first put on a fresh set of sheets.  So tonight  I laid down in my unmade bed, same as any other night.  As I lay there in the dark, waiting for sleep to overtake me, my thoughts turned to an old crush whom I hadn't thought of in a while. I imagined taking her back to her place after a date and giving her a passionate good-night kiss at her door.  She invited me in, and, as I proceeded to imagine making out on her couch, I began fapping.

The imagined make-out session grew more intense; clothes started coming off, more intimate areas were kissed, sucked, and fondled, and I decided to adjust my masturbation technique.  See, when I first began exploring my body as a small child, I discovered that it felt really nice to take a sheet or towel and just kind of grind my junk into it with my hips. This has the advantage of being more of a full-body experience and closer to actual sex and I used this technique exclusively for years before discovering the more traditional tricep workout. It also has the disadvantage of being fairly messy since the full volume of your load goes right into your bedsheet; as a result, I generally only do this when it's about time for my sheets to go to the laundry anyway.  I'd been sleeping on these sheets for a while (again, slob), so I decided tonight was the night not to hold back.

I reached down toward the foot of my bed and grabbed the bed sheet that was crumpled up there and started doing my thing.  At one point, I noticed that one part of the sheet was cooler than the rest.  I had a fan running by the bed, so I figured that area had just been in the fan's path, so I paid it no mind.  As I continued to rub and gyrate while my fantasy girl and I went at it with reckless abandon, I noticed that the sheet was not just cool, but moist.  It was at that point that I stopped what I was doing, turned my light on, and discovered that my cat had vomited on my mattress and covered up her crime with the crumpled bed sheet. I had been humping cat puke. I just finished cleaning the bulk of the mess, stripping the bed and putting the sheets in my laundry bag, putting on new sheets, and cleaning off the affected areas of my nether regions. My libido, suffice to say, has been squelched for the night, and I'm about to go back to bed and think long and hard about just what it was that I had against dogs.

tl;dr: fucked vomit",TIFU by masturbating in an unmade bed,1840
overexposedrebel,332,955,1qifxp,1332,"So I was trying to change my profile picture and to the one I wanted, and I had to move the file to a separate folder. I was stupid though, and I didn't look at it before clicking the picture. It was IMMEDIATELY set as my profile picture and there I am turned around with a nice pussy shot for all of my friends and family to see. It took a moment to process what I had done and I scattered to delete the picture. BUT IT WAS STILL ON MY WALL. oh my god oh my god oh my god. Too late, my cousins friend commented on it, ""what the fuck"". One person had already seen it. God damn it. Luckily I was able to delete it in about 10 seconds, so it only appeared on peoples news feeds for that long. The only two people I know of that saw it were my cousin and his friend, but it's not like I have to worry about them blackmailing me. Still, it's an awkward moment when your cousin sees you in a doggy style position. The first guy to comment on the picture messaged me with, ""so I'm assuming we're best friends now.""


TLDR: It's not that long, just fucking read it. ",TIFU by accidentally posting one of my gonewild pictures as my facebook profile picture,2287
lilPatrickstar,93,461,1ldzru,1329,"Today, me and the wife were watching Whose Line Is It Anyway on the iPad while lying in bed. The cat was at the foot of the bed and I wanted to pet him; so I pet him with my foot.

Suddenly, my wife looks over and says ""babe, what are you doing? You're rubbing Stormy's butt."" I looked down and said ""hey, I guess I am"" and continued, not thinking of the consequences. 

All of a sudden, his fur was really wet, I couldn't understand it, what happened? I look down and realize I had moved my toes up and had been stroking his tiny, kitty manhood with my toes.

He promptly got up and walked away, presumably to smoke a cigarette. 

TL;DR Stroked my cat to an orgasm",TIFU by making my cat orgasm.,1790
tybeedoo,607,580,1jcz2g,1327,"Well reddit, today I finally have a worthy post. Not happy about it though. About a week ago I was at my friends house, having a good LAN party, and I was using my new laptop. It's actually my first laptop so I was pretty excited. Something I had always wanted was my own secret library of porn. Even though I was still at my friend's house, I had no shame. I pulled a torrent program up on my laptop and got to work, and downloaded around 5 videos in total. Not much yet, but I'll get there. I put them in my secret locked file and we continued gaming. Fast forward about two weeks. Today, I get a call from my friend. Something about them being contacted by their service provider about being possibly sued for copyright infringement, etc. Fuck. It's all my fault. So, I fessed up. The other part I forgot to tell you is.. I'm only 17. So looking at pornography is illegal by itself, not to mention downloading it like that. So now my friend has to talk to his mom, and step-dad, and now the whole family will know about all the porn I watch and how I almost got them sued/got them sued. Oh, and just about how fucked up I am. Now I'm just waiting for my friend's parents to get in contact with my parents and tell them the story I'm telling you now. Shit.

EDIT: My friend's mom opened the email and tells me I have to pay 200 dollars and she is forwarding it to me. What do I do guys? Do I have to pay the fine?

EDIT 2: [Here is a copy of the email.]( https://docs.google.com/document/d/1cj-JjqBszpNHiJj6ui61w3rWtcWK2vrvqKtks9Jck0E/edit) What do? Remember this^ In other news, my parents found out because I was a dumb ass and left THIS PAGE up on the computer we all share. I honestly have no idea what is wrong with me.

EDIT 3: I also have spoken with my friend's mom and we have talked things over. She isn't as angry as me as I thought, and seems forgiving. She even said her opinion of me hasn't changed of me at all and she has always thought highly of me. Cool. Still unsure about what to do about the email.

NOT SO FINAL EDIT: If anyone is still following this, it is now September 4th and I was supposed to have payed the $200 dollars by August 22nd. I am still yet to receive any repercussions, emails, or phone calls. I think the coast is clear guys!

FINAL EDIT: Never mind ^",TIFU by illegally downloading porn. Fuck.,1907
rendzina,213,403,1eoltv,1294,"I met this really awesome guy at school. We went on a couple dates with the promise of more before returning home for the summer. I was a bit worried about losing him, but things have been great thanks to Skype. As our conversations have grown longer, we've started a little competition with ourselves. ""Let's see if we can beat yesterday's record and talk for 3 hours!""


So I've done things like take him around the house or cook meals on camera. Today we were talking and there was an hour before I had to go to work.


""It's been nice talking, but I probably should go because I want to shave my legs before work.""

""Will you have time to talk between shaving and leaving?""

""Maybe a little bit.""

""Leave the call running, then, we'll beat our record!""


I nod and say I'll take him on a tour of the bathroom. My mind starts formulating this idea to introduce a little sexual tension into our conversation. After I'm done giving him the tour, I set the computer on my bathroom sink, get out of frame, and I toss my pants in front of the computer. Then I giggle, ""Whoops."" His eyebrows immediately raised and he blushes, ""Ohh, what's going on here."" I tell him I'm just being a tease and remain off camera as I fill the tub with water. We're talking while I'm out of view near the tub, and I realize how awkward this is, ""I'm going to mute my mic while I do this so I can listen to music.""


So my shaving commences, and I realize I have to go to the bathroom. I thought it might be obvious I'm taking a poop if I move the laptop out of the room, so I figure I'll just go ahead and do it while I'm out of frame. I triple check to make sure I'm muted, and I am.


After doing my business, mid-wipe, I realize I'm going to need more toilet paper, seeing as I've just run out. There's more under the sink, but I'd have to go across the camera to get it. Now is a good time to mention that my laptop doesn't fit so well on the sink. It is actually just perfectly balanced. Things are still messy enough down under that I can't just put my underwear and pants on. I decide I'll just risk it by ducking my head out of view as I reach across the sink.


I move so slowly, so delicately, all the while checking to make sure I'm not in frame. I can see the guy leaned back darting his eyes from phone to computer, but he doesn't have a clue. Still seated, I am able to just reach the toilet paper with the tips of my fingers. I push so one falls on the floor in a direction I can actually grasp it. Once I have the roll in my fingers, victory's in sight. I think I've done it.


Unfortunately, I got overconfident, and I'm sure you all know where this is leading. I bump my head trying to realign myself back over the toilet, the computer falls, and there I am for him to see: bare-assed and crouching in front of my toilet with a roll of toilet paper in my hands. My leg reacts before my brain can catch up, foot flies towards the laptop and struggles to get the lid closed. It's only after that I realized I flashed him my vagina as well as the shit on my ass by opening my legs up towards the computer.


I just sat there- mouth open in complete dismay- on the toilet. What was I supposed to do next. Try to convince him it wasn't what it looked like? Make some kind of joke asking if he had a scat fetish? I figured the best thing to do was apologize, but of course, he wasn't online by the time I opened my computer back up.


Then denial set in. Maybe he didn't see. He was probably looking at his phone. I thought of the perfect thing to text, ""Don't you hate when that happens?"" His answer would let me know. 10 minutes later, I regret this text and fix it all by sending another, ""Internet went out. Lol. Grr."" Still no response, I know he was staring at his phone while we were on Skype. It seemed unlikely that he didn't see my messages, maybe I should ask him something he would have to respond to, ""I have to go to work, text me?""


I should have turned my phone off or something, because I proceeded to text him every chance I got on break with updates about work- without even getting a response. Now I look like some kind of psycho... all because I fucked up by pooping on Skype.

**Edit:** *tl;dr* I tried pooping off camera in a Skype conversation with a guy I like, accidentally knocked the computer on the ground reaching for toilet paper, and he got a full-on view of my vagina and unwiped ass.

**Edit:** *Update*, I stopped texting him as many people advised. I also asked a friend who lives in his town to mention me the next time she talks to him. He told her that he thought we needed to slow down because I got too eager. She knows about the story, so she kept asking why. I thought it was nice that he didn't tell her about the situation, but he did hint that he thought I might be too sexually agressive. I don't know if he actually thinks that I let him catch me on the toilet to purposefully make some kind of pass at him. Can't help but feeling down, but I think the consensus here is that I should leave it alone. I probably will unless he decides to reach out to me.",TIFU by pooping on Skype.,1697
Nuke-The-Whales,240,468,1prep1,1292,"So this happened twenty minutes ago. I am emotionally and physically wounded.

My Dad headed out for a lunch with some friends, and my Mom tells me she's going for a manicure. I say goodbye and watch her pull out of the driveway, smiling from ear-to-ear.

The instant I shut the front door, I B-line for their washroom (detachable shower head). I have been living away for Grad school, the house I'm living in has an attached shower head, so needless to say I was excited. I throw my clothes on the floor, get the temperature just right and hop in.

In my overwhelming excitement, I forget to lock the bathroom door. Not that it mattered, no one was home . . .

I'm enjoying the jet setting and I'm about to orgasm when I hear, ""Laura, I forgot to ask if you wanna . . .  **OH DEAR!!**"" My Mom had double-backed to ask if I wanted to join her manicure session, but instead she walked in on me holding the shower head to my clit.

She screams and turns around awkwardly while I panic; instead of turning the shower off, I turn it to the hottest setting there is.

**""MY FUCKING VAGINA!!!""** echoes from the shower, down the hall, around the corner and into my mother's already damaged head.

So, here I am, holding a freezing cold wash cloth on my clit while dying from embarrassment waiting for my mother to get home from her manicure. 

TL/DR: Masturbating with shower head, Mom walks in, I turn the knob to hot instead of off and burn my vagina.

**UPDATE**: I didn't get a chance to talk to my Mom until this afternoon. I decided to be mature and ""confront"" her about what she saw. I basically started with ""I'm sorry you had to see that but hey, shit happens"". My Mom laughed and said ""don't worry about it, let's just forget it"". I am back at my Grad-school house, so hopefully with a little distance, my mother will not be consistently reminded of this ordeal via my presence. ",TIFU by masturbating in my parent's bathroom,1760
CryingCarrot,154,497,1klns7,1284,"

It all started innocent enough; I was hanging out with the roommates, smoking, enjoying myself. After getting to what felt like a [7] I got a very unexpected burst of energy. I decided that I was going to be productive. 

As I'm standing in my hallway, I'm trying to remember what needs to be done but instead my eyes kept focused on the phallic shaped dent in the wall. So, like any sane person, I began giggling and like any person as high as I was, I forgot to swallow my spit. I snapped out of my dick dent trance in time to stop myself from drooling. I said ""high five"" out loud in an effort to high five myself which actually confused me. The encouragement felt nice though. This is the moment I realized that I may have exceeded the traditional 1-10 scale of intoxication. I was at a [10+]. I had momentary reservation about going through with the productivity but decided to YOLO the fuck out and do some laundry. 

Now, our laundry room is shared between a few apartments on our block. There is one washer and one dryer inside. So I take off all my sheets and fill my laundry basket with sheets and bras and shit. You know, laundry type shit. 

I was incredibly slow paced but successful nonetheless at the first few loads. 

The last load of laundry is what triggered some very unexpected events. I went to put the last load into the dryer and I notice that I had washed the entire box of 100 dryer sheets in the washing machine right on top of all the aforementioned laundry shit. I did my best to fix the situation. 
I'd like to take a moment to say that the soaked dryer sheets smelled heavenly. It was like lavender and fresh rain made sweet love and their jizz consisted of wet cardboard fragments. I was okay with this. 

As my yoloing continued, I threw the laundry shit into the dryer, paid the machine, pressed start and headed back to smoke a little more. An hour later I go back to discover that the lavender/fresh rain cardboard fragment jizz is incredibly flammable. The dryer is smoking and I decide that I don't want to yolo ever again. I grab my shit from the dryer and get into my apartment. 

We do not live in the nicest part of town. At all. We live in what has been deemed ""the ghetto"" by some. Quite literally in the middle of black gang and Hispanic gang territory (they are a violent group of frenemies). 

I can hear my neighbors near the laundry room yelling, ""what dumb ass nigga put mother fucking cardboard boxes in this bitch"" 

*I was the dumbass nigga.*

Another voice shouts ""GOD DAMN JUAN WE KNOW IT WAS YOU NIGGA WHERE THE FUCK YOU AT"" 

*It wasn't Juan. It was me.*

I hear Juan shout a few racist insults. More and more people begin showing up, it gets louder. People are yelling at each other about who the fuck tried to wash and dry an entire cardboard box. 

I decide to go fold laundry in the farthest part of my apartment with my basket full of sheets, bras and burnt cardboard. 

A few moments later, a fight broke out. The police were called. Nobody was hurt. I put my clean sheets on and watched reruns of Its Always Sunny trying to forget about how everything was my fault and now our block has no working laundry room.  


TL;DR Had a few marijuanas, YOLOed, almost caused a race war 


",TIFU by trying to be productive while very very stoned,1781
VagabondofFunk,330,440,1jmi17,1285,"Okay, so it wasn't today, but today is when I found out I'd done it.

Seven years ago, I filmed my then girlfriend and I having sex. We were both 17, and I did it with the same camcorder I'd been using to record our tabletop role-playing sessions, home movies, all the stuff.

Today while fapping I found screen-caps of that video, which I thought I had destroyed over a year ago when she and I had divorced. I panicked and tracked down the submitter, who relayed me to an incest site on which my youthful indiscretion was tagged as ""brother and sister"". My heart beating the tattoo of the damned in my chest, I followed the rabbit hole deeper thanks to the kind help of the incest board's admin.

I've gotten through three more iterations of primarily incest-based porn to find an extended, unedited version that includes full face shots of friends from high school while I call them by name, a conversation with my little brother, and a high-school film project including scenes of my friends and I dressed up as knights and trolls.

The admin for this final site has requested a formal DSMC request via lawyer before acquiescing to take down the video. At this point it's spread like a cancer and I don't think I can put it back in the box. They did kindly inform me that it was a user-submitted post and that the user claimed they had snagged it off LimeWire, which I had used before realizing how awful it was a few months later. But at some point in that timeline, this guy got video of my teenage self boinking and posted it on an incest site as a brother and sister getting it on.

UPDATE: Thanks to all of you for your advice and support. Also extra thanks to those of you who sent me links to further instances. Apparently, most of the incest community has diddled to me and my ""sister"" at this point. No point in trying to get rid of it, no point in staying fucked up about it. Ex is pissed, but acknowledges that we can't do much about it now.

FINAL UPDATE: My rather naive hope that there was only an isolated instance of the video has been thoroughly crushed. The silver lining there is that it's been around the whole time and the weirdness of it just appearing isn't really a thing now.

I have a personal relationship with one of the assistant DAs from my home state, who has told me A) There is absolutely no way to remove all, or even a significant number of the instances of the video now that it's out there so...prevalently. B) I would have to track down all the poor bastards in the opening sequence that were underage at the time (all of them), which is a thing I simply cannot bring myself to do. And C) Although it is very unlikely I would be charged with any sort of exploitation or child porn, I would have to work extensively with federal prosecutors/investigators, and that makes me deeply uncomfortable as well.

In the end, my decision is to learn from my mistakes, take greater steps to protect my information security, limit and avoid creating any further media content that could be compromising, and then just moving on with my life, because this is not actually a defining moment, just another stumbling block. I'm skeptical, but one of my good friends has suggested that this could be a particularly good story if I polished it up and put some distance between me and it. We'll see.",TIFU by accidentally leaking a personal sex tape via LimeWire 7 years ago. [NSFW],1725
ThatMetalPanda,208,618,1q1alw,1286,"So I come home this morning from a particularly long and boring night at work to my loving fiance and since I'm tired and want to relax, we split a couple bowls. 
After a few minutes things start getting hot and heavy and he ends up giving me one of the greatest orgasms in my life. We then switch to different positions and he winds up getting me off with his fingers. As I finish and get up to do my womanly duty and finish him, I hear ""what is that?"" I turn around to see a couple brown smudges glaring up at me from our black sheets. Mortified, I mutter ""oh fuck no."" He asks again, and Im speechless. I start pulling the sheet off to wash it, and he points out that I have some on my side. Sure enough there was a nasty brown smudge on my hip. I'm almost crying when I go upstairs to the bathroom and clean myself off. All the while, he's laughing and cracking jokes since the discovery like ""well that sex turned out shitty!"". I then say ""I'm sorry I'm so embarrassed!"" and he responds with ""are you **shitting** me? I'm just kinda laughing about it rather than being disgusted baby. Dont take it so hard"" but I can't get over the embarrassment factor.

TL;DR had amazing sex that turned out shitty.",TIFU by orgasming a little too hard.,1904
iBarbo,161,702,1itw1x,1281,"I got a BJ right after we got some ice cream together. She must have ate too much, cause she puked all over my dick and balls. I was laying down on the bed, and i could feel all the melted ice cream flow down my balls and into my butt crack. It was still really cold. It was one of the most uncomfortable and weirdest sensations i've ever experienced. The clean up process was very involved.

This was 5 years ago...so it wasn't *today* today. I married her anyways.",TIFU by getting a blow-job after visiting an ice cream parlor.,1983
yonoober,606,799,1qf1mq,1279,"Okay, okay. This was a few weeks ago. Reddit wasn't exactly on my mind right then.

Okay, it was spirit week at school, and one day was ""Pajama Day"". I don't exactly wear pajamas; instead, I wear these really comfortable pants that have a hole in the front (intentionally made by the people who made the pants) for easy peeing in the middle of the night. In any case, I forget to wear underwear to school that day and wear the pants in question, only noticing that I have no underwear on once I'm on the bus. Stupid me thinks ""how bad can it be?""

Little did I know that it could be *reeeeeeeeeeally* bad.

Crush gets on the bus and sits next to me.  She starts talking to me, and she's wearing a tank top and short shorts.

Perfect time for my member to act up. Surprise, surprise, I have a boner, and it's sticking out of the aforementioned hole.

Oh god. I still haven't lived down the embarrassment.

EDIT 1: She's gotten closer to me, so tomorrow is a good day. Hopefully.

EDIT 2: [OP delivers! Proof, with pics of me wearing pants as well as pants themselves with hole open.](http://imgur.com/a/ZwhB4) They're sideways, I'm sorry.

Also, I just realized there's a button there. Huh.

I will update tomorrow.

EDIT 3: I'VE ASKED HER OUT, BUT AT THE END OF THE BUS RIDE

FUUUUUUUUUCK, NOW I DON'T KNOW IF SHE'LL SAY YES OR NO

THE SUSPENSE IS KILLING ME AAAAAAAAAAAH

I HAVE MATH WITH HER

THAT'S 4TH PERIOD

EDIT I DON'T EVEN GIVE A FUCK ANYMORE: SHE SAID YESSSSSSSSSSSSSSSS

EDIT whatever this is: Man, my most upvoted anything on reddit ever! Thanks guys!",TIFU and showed my dick to my crush.,2078
snugglycthulhu,362,659,18mkfb,1284,"For Valentine's Day my boyfriend and I went on a beautiful date and ended up finishing off the night back at his place. For quite while I have been trying to convince him to let me give him a blowjob. I know it's weird that a guy would refuse but he says he feels it's degrading to women. FINALLY I convince him that for Valentines Day to give it a chance. He had one request to at least finish in my mouth and I agreed. So we commenced the sexuals and I got to it. He was bigger than I expected and right as he finished he was further back in my mouth. He came so hard it came out my nose. I have never felt such a horrible burning pain before. Ugh.

**EDIT**: To clear up the whole ""young teenagers"" bit we are young but not THAT young. I'm the younger of us and I'm 19.

**EDIT** 2: I am aware that it seems weird he would request that, but hey if you are going to let it happen and the girl is willing then why not have the full experience. ",TIFU by letting my boyfriend finish in my mouth...,1943
23_,97,197,z0nde,1285,"It's wednesday. My parents are at work, and my brother's at school. I'm home alone, and this hasn't happened for a while so what does anybody do with a free house? Walk around in the nude.

I'd been nude for a few hours now and it somehow slipped my mind that I did not have clothes on (I just felt very comfy, y'know?). This is when I remember it was recycling bin collection day, and the bins are right outside my front door. I walk out just as my new neighbours arrive home and witness them turn in disgust as I suddenly remember my man parts are in full view.

This in itself may not have been so terrible, albeit still pretty bad. Recently, however, I have had laryngitis. I have no voice. I sound shrill and ridiculous at a whisper, never mind a forcibly audible tone of voice. I try to scream ""oh god!"", ""I'm so sorry!"", and the like while covering myself up, and running back inside, but instead I must have sounded like a complete, incoherent mad man who is prone to flashing unsuspecting neighbours.

TIFU. I don't think I can leave my house ever again.","TIFU: My new neighbour and her two year old daughter saw me fully naked, and while trying to fix the situation, I screamed like a banshee.",1482
coochbuzzthrowaway,618,574,1fahy1,1277,"I'm a 16 year old girl with no car and a crazy libido.
This combination meant that I'd never gotten the chance to get my hands on any sex toy of any kind. 
Well, yesterday I woke up and had had enough; enough of using the showerhead and getting yelled at for taking an hour to bathe, enough of humping pillows and shoving a sharpie up my butt to get the job done. Enough! I am a sexual being and I deserve a decent sexual experience!  
But... but, coochbuzzthrowaway, why don't you just ask your mommy to get you one? 
Well dear friends, I'm a person that easily gets overly embarrassed. I blush when people I don't know well talk to me, when I was little I'd literally hide from the TV when Lizzie McGuire did something embarrassing, [r/cringe](http://www.reddit.com/r/cringe/) practically gives me a heart attack sometimes. No way, I can do that.  
So I form a plan. I'm practically drawing up blueprints for this shit. I'll get my mother to drive to Walmart and go sneakily buy a cooch buzzer and a few normal things and hide it. It's genius, foolproof, exquisite.   
NOPE.  
Day 1:  
Mom comes in with me to buy some groceries.  
nevermind,jpg  
  
Day 2:  
OK, she's coming in to buy cat food, but I got this now.  
I'll just sneak off and grab it, right? Wrong. As soon as I run off to go get ""something to wrap my ankle with"" (I hurt myself a few weeks ago) and obtain my toy and a huge pack of batteries, she starts hunting for me near the registers. I go all secret agent up in this bitch avoiding her. Yeah, that didn't work. I'm holding a shirt I plan on buying to hide my contraband from everyone so she doesn't even notice it.  
""Oh honey, just put your stuff in the cart.""  
Start making excuses, she refutes them. This goes on for an eternity.  
Fine. Just show it to her, you big baby.  
""You're sixteen, it's perfectly normal. Of course I'll buy it for you"".  
Wait, how can this possibly be a TIFU then?  
I promptly started crying from embarrassment in the middle of the store holding a vibrator while my mother consoled me. Keep in mind I live in a very small, 90% Mormon area. I see people I go to school with all the time in there and buying something to pleasure yourself with isn't exactly praised.  
I have no idea if anyone I know saw me, but a lot of strangers got an eyeful of me crying over a sex toy.  
**TL;DR: Tried to buy a cooch buzzer and ended up crying in Walmart.**  
EDIT: Spelled Mormon wrong. Dang it, Bobby.",TIFU by trying to discreetly buy a cooch buzzer.,1851
Nottherightone,97,317,15vdky,1273,"So, for a long while I've been having suicidal thoughts. I mentioned how I wanted to kill myself to a friend, and he told my parents. Next thing I know, I'm in therapy. I've been going over my issues, and I'm not the greatest now, but I'm in a calmer place than I was before. I'm doing so well, in fact, that today was my last counseling appointment, with my parents along to help celebrate me doing better. 

So, I'm there with my mom and dad and my therapist, and at the end of it my therapist asked me, ""So, what's the one thing you've gotten out of our time together?"" I looked at my mom and dad, looking all serious, and then I looked at my therapist who had her 'understanding' face on, and I felt the need to lighten the mood a bit. 

So I said, ""I've learned that the next time I'm thinking about killing myself, I wont tell anyone!"" I laughed. They didn't.

I have another appointment next week.",TIFU by making an ill-timed suicide joke.,1590
jana007,259,328,1etxc3,1270,"Yesterday I had lunch with my mom and I told her about my back pain and how it had been a few days and I think I might be dying... bla bla bla. She pulls out her prescription bottle of ""muscle relaxers"" and says ""Go ahead and take one of these, it'll help make the muscles loosen up."" I ask her what the interactions may be, and her response is, ""It may make you a little tired."" I take the pill and she drops me off back at work, I work for a university doing IT work. I was sitting at my desk carrying on with my bid'ness as usual when my monitors start to pulsate and my body starts to pulsate. After about five minutes I realize it's getting exponentially worse and my reaction time is slowing (including my speaking) and my eyes are beginning to close. I get a little nervous about this and start to plan my options. I cannot drive at this point because I'll probably fall asleep and die on my scooter, I can't sleep at my desk because I work at a cubicle. I slowly get up and realize I'm gonna have to find somewhere to sleep because I am about to pass the fuck out. I looked everywhere on my level of the building, and I vaguely remember walking into my friend's office while he was in the middle of a meeting, letting myself in and just sitting on a chair in the middle of his conversation and in the slowest voice imaginable asking him to ""heellllp meeeeee."" 

I don't remember how that conversation ended because I was so delirious and literally was in the process of passing out. My eyes would stay open for 2 seconds at a time and I could barely walk. I stumble out of his office and get on the elevator and take it to the 6th floor for some reasons that do not exist. I've never even been to the 6th floor. I wonder the halls grabbing onto walls to help keep my balance and finally I find a small break room with a couch in it. Mind you, this couch is the size of a very small child so I don't really fit on it. At this point I couldn't give a fuck less THIS BABY IS COMMMIN. This baby being my unconsciousness. 

I positioned myself on the couch so that my legs were sticking up in the air and my feet were basically kicking the refrigerator of this break room. I'm wearing a dress by the way, so this shit did not look glamorous. I tried to cover my legs and stuff as much as possible, but it's not really an easy thing or a priority to cover your underwear when the only care in your life is sleep, so with half my ass hanging out, I passed the fuck out. I kept trying to wake up because, well beyond the obvious reasons people were also coming in and out of this very popular break room because it was god damn lunch time. I remember at times I would hear someone come in and sit straight up and then pass out again. At one point I opened my eyes while lying down and made awkward eye contact with some guy in a business suit and we did the typical fake smile and nod of acknowledgment as if this wasn't the most awkward thing to happen to either of us all day, then I went back to sleep. I slept there for 3 fucking hours. When I finally had the strength to get off of this tiny hellish couch, there were 3 people eating quietly at the breakroom table trying not to acknowledge me.

Turns out my mom gave me her emergency anxiety medication and not muscle relaxers.


**TLDR; mom drugged me and I fell asleep in a crowded break room.**



",TIFU by taking medical advice from my mom.,1598
Hwy61Revisited,280,535,1p0v6w,1265,"So I have to submit these weekly mini 1-2 page essays online for my English class at University.  Today at the beginning of class my professor told me he'd like to talk to me after class, which was odd since I have a good grade in it and was not missing any assignments or tests.  So after class I wait for everyone to leave and I go up to him and ask what he needed to see me about.  He says he wants to show me something and tells me to come to his computer to see.  He shows me an essay I wrote about a week ago and the last sentence said the word ""FUCK"" like 10 times followed by one final ""TITTY FUCK!"".  I was extremely shocked and embarrassed and I had no words to explain to him how it got there.  He told me it was okay and that I was not going to be penalized, but he just wanted to bring it to my attention.  I later today found out it was my room mate who typed it into my essay while I was away from my computer, I clicked ""submit"" without proof reading it once I got back.  

","TIFU by concluding my college essay with ""FUCK FUCK FUCK TITTY FUCK!!!""",1800
sobakedlol,133,524,1c87ca,1266,"I fucked up so huge.... throwaway so I don't get fired or sued or arrested

My frient's birthday is this weekend so last night I rolled up a bunch of tobacco + powdered hash spliffs to have them ready for the weekend.  Had leftover tobacco, it's really tasty stuff, so I rolled the rest into little mini blunt cigar things just for the hell of it.  Left two types in separate piles on my desk so I could tell them apart

So today I left the office for a wicked late lunch break.  I work for an insurance agency, we're short staffed today, it was busy, I didn't leave for lunch until 3 o'clock.  Wicked stressed out today because of that, finally was able to ran home for a quick bite, decided to smoke one of the tobacco-only blunts to de-stress a bit, because I quit cigarettes but fuck it tobacco helps on days like today.  COMMENCE FUCK UP SEQUENCE

Lit up, took two or three big rips all in a row, started sucking down the fourth, realized ""this tastes a little- OH FUCK OH FUCK OH FUCK OH FUCK OH FUCK FUCK FUCK FUCK FUCK""

It had hash in it

Immediately brushed my teeth &amp; washed my face to get rid of the smell and brought visene back to work with me... but the hash hit me like a ton of fucking bricks.  I'm a regular smoker &amp; high tolerance &amp; whatnot but daaaamn dat hash...  Been back in my office for about 5 minutes and so fucking loaded right now it's not even funny.  It's simultaneously hilarious and absofuckinlutely terrifying..... I'm the only agent working today and it's me and two receptions right now so at least my boss wont see me high but WOW am I an idiot.  We close 4:30 so it's doable but if anyone comes in for serious business or a claim or someshit....... fuuuuuuck that's be bad hahahahaha

I'm giggling so hard writing this post but why am I so fucking dumb, this is the stupidest possible place to be stoned !

Locking the doors to my office and ""pretending to work on something important""

*What have I done?!*




* * * * *

TIL work goes by so much faster when you're ripped.  Got some weird looks &amp; I think one of the receptionists knew what was up but! didn't get fired.  Crisis averted


* * * * *

Edit, several days later:  [Followup posted here](http://www.reddit.com/r/tifu/comments/1cgive/followup_to_being_ripped_at_work_love_you_guys/)

I'm still employed, woohoo!

To those who called bullshit on me being that intoxicated:  I have no way to disprove your claims, but I was annihilated.  Some data:

I've smoked daily for 7+ years, and have developed a routine where I only smoke once per day, at night, to preserve potency of the effects (and not be a useless stoner 24/7).  As a regular smoker for that long, I've gotten to a point that when smoking quality shit (ie hash) it only takes me a hit or two to get good &amp; fucked up, but once I have 2-3 hits I plateau and can take another 20 hits without feeling any more ripped.  The hash in question was *super* fucking potent stuff that I'd had saved for a special occasion.  On top of that, it was dried &amp; powderized with a mortar &amp; pestle prior to rolling, which caused it to burn quick &amp; strong - plus, the hits I took were pretty large as I was expecting a different substance.  That, coupled with the fact that I was in an environment that I've only ever been in sober, got me pretty fuckin' goofy.  That's all I can do for proof, hope it helps!

Cheers to all who read &amp; commented!",TIFU by accidentally smoking hash during my lunch break and now I'm sitting in my office baked &amp; useless,1790
NewYorkCityGal,275,354,1d69ci,1259,"So let's call him Steve. Steve and I are messing around, clothes come off, and he's about to go downtown.  He says ""Hang on a second. I want to try something, I'll be right back. Don't move.""  So I wait. Laying on the edge of the bed, legs hanging down, in my birthday suit.  He comes back and says ""don't look. I want to see something.""  All of a sudden I feel something cold hit my vagina.  I honestly had no idea what it was. He starts to lick it off, then I realize something is wrong.  It's not feeling all that great and it's starting to burn.  

I sit up immediately and ask wtf he just put in me. Well this idiot went to the kitchen to get HOT SAUCE and poured it all over my vag!!!!  I start yelling and as I'm yelling I can feel everything inside of me start to burn. Before he began licking it off, he made sure to spread it all around and inside.  It was horrible. He comes back with an ice cube, realizing that I'm in some serious pain, that he shoves IN my vagina.  

It was not a good night. For either of us. 

**Tl; dr - Don't put hot sauce in your vagina**",TIFU by trusting the guy I was seeing to run to the kitchen before he went down on me...,1613
RuMall,244,420,1pbcny,1244,"Definitely one of the most awkward moments of my life. I was walking back through Edinburgh city centre and I saw a man with a cup of coffee with no lid, and he was sitting on the ground, so I thought he was homeless. I felt around in my pockets for some loose change and found a few coppers. I went over and put them in the coffee cup, only to realise that he had coffee in it and that he wasn't even homeless, he was waiting for someone. There was a good 5 seconds of super awkward confusion and staring. 
TL;DR: I thought a man was homeless and put change in his cup of coffee, he wasnt homeless and had coffee in the cup.",TIFU by thinking a man was homeless.,1664
hawkinator,211,442,1doky4,1245,"Oh. My. God. This is fucking awful.  

So brief background: I've been on adderall for a while, right? Well the loveliest of side effects is that it makes your shit set up camp and just chill in your intestines. 

Technically you could say ""yesterday I fucked up"", but it is today that I am reaping the repercussions of my actions. So basically I hadn't pooped in almost a week. Bad news bears, I thought. So around 2PM I decided to take a single extra-strength laxative to kick down the doors and do some spring cleaning. No biggie. I do this sometimes. It usually results in a leisurely 30 minute session of poop just easily coming out of me like frozen yogurt. 

Naturally, later, I got hungry for dinner. Being the laziest fucking hambeast there is, I reached for something quick, disregarding my decision earlier. What I grabbed was my industrial size box of Fiber One bars, you know the kind you can get at bulk stores and could probably sustain a third world country for a day. 

So I sat myself down at my desk and resumed doing some college shit. I had my delicious Fiber One bars, of which I thought would be a good thing if I brought the entire box with me, and my glass of chocolate milk. Now I'm lactose intolerant, but it's usually ok if I just drink a glass and be careful about what I eat the rest of the day. Being the dumb fuck that I am and not connecting all of these things, I lost track of all time and things and before I knew it I had downed 10 of those fuckers and my full glass of milk. Ain't no thang, right? Wrong. 

By 10 pm the gurgles started. I just thought nothing of it and continued working. Then the farts came like the fucking Valkyrie. At first it was just one whisper-thin fart every 15 minutes or so. Soon, it escalated to some sort of anal rapture. My asshole was playing the 1812 overture in F minor. I swear to god  I think I ripped my sphincter.

I went to bed around 5AM and actually managed to fall asleep. At roughly 6 AM I was jostled awake by a fierce noise that I couldn't pinpoint the origin of. Then it happened. The farts had gotten worse and now sounded like Chewbacca deepthroating a burrito. It was terrible. My entire abdomen was cramping. Then the SMELL. It crawled through the air, something like a unique septic odor, like shit mixed with dead and decaying animals. 

This lasted for a few more hours. Every two minutes I'd cramp up, then release the tension in the form of severe anal rot. 10:30 comes around and around that time I was going to take another rip when I realized there was something sinister behind it. I am not athletic, but I may as well been  bred with Kenyans because I fucking Usain Bolted it to the toilet. 

Taking my place, the next thing I heard was a slight noise piercing the air, somewhat of a high pitched squeak, then immediately followed by the most low and rumbling thunderous sound. Then the shit of a lifetime. The kind of shit that makes people stop believing in god. It was like I gave birth via my rectum.

So now it's almost noon and I'm sitting on the toilet typing this on my phone between anal hiccups from hell, since between that first gastric giant breaking the seal and now, it's been like my asshole is just puking water. I'm hunched over from the pressure of gas on my insides. It feels like that thing from Alien is trying to claw its way out of my stomach and its screams are escaping by means of fart.  I am a dumb bitch. 

TL;DR- If I die tonight there's an 80% chance it's due to something shit related. 



Edit: [/u/Shadekitty](http://www.reddit.com/user/shadekitty) decided to  [narrate](https://soundcloud.com/rac91790/the-poop-delusion) my shitty situation. Hilarious. 

Edit 2: Thank you, random user, for the reddit gold. It does my heart good to know you were so amused by the blunderings surrounding my anal apocalypse. My next shit storm will be in your honor.


Edit 3: the next day... OMFG I am in so much pain. It's like all my insides are in a vice. I feel like I'm trying to pass a fucking monolith. ",TIFU by being a dumb shit and overloading on poop facilitators,1687
i_slapped_a_baby,253,355,1hgws4,1241,"This wonderful tale of a child being bitch slapped begins on a family vacation to the beach. My aunt brought along my 5 year old cousin, who is very destructive and is in my eyes the spawn of Satan. He also has this weird obsession with punching people in the stomach and genitals.

Well fast-forward to day 3 in the vacation, and he decides to play with his toys at the top of the stairs. All was fine until the mother of all stomach cramps hits me (just glad this didn't become an ""I accidentally shit myself"" story). I sprinted up the stairs and was just about to reach the top when he punches me in the stomach like he's fucking Lil' Mac from Punch Out. As I fell from being punched, I lost my footing on the stairs and accidentally slapped him full force across the face. 

This tale only gets worse because due to the slap, he falls down the stairs, causing him scrapes, a black eye, and a burning hatred towards me. Now i'm here, sitting on the couch of the beach house, feeling like shit as a toddler is being treated for his slap/stair bruises. I do have to admit though I feel like I have a solid future as a pimp. 


**TL;DR** : baby punched me in my crap filled bowels, accidentally slapped him down the stairs.

**UPDATE** : His aunt made him apologize to me for punching me, and also made him promise not to do that ever again. That lasted about 30 minutes. Almost immediately after swearing off his crouch boxing, he punched his father right in the dick. This child is a monster, and I feel like from now on he should be slapped down the stairs all the time. Also, I took the advice being given in the comments and tried to explain to his parents that he shouldn't be allowed to just punch people and they agreed to start punishing him more severely, but this little prick now fears me. 
",TIFU by slapping a toddler down the stairs,1596
bigscreenboobies,422,421,17i9a7,1237,"So I just got my brand new Samsung GS3, and he has some Sony Blu-Ray player.  Well, apparently there is a new technology that allows you to stream media from your phone to the player over wireless.  

Here's what happened:

I was rather horny and decided to visit /r/gonewild for my 2nd time.  I was going to post, so I took 5 pictures of myself and a short video of myself undressing and then playing with myself.  I took the pictures and video, and was trying to upload them.  Now, this is the first time I've tried to upload pictures on my phone.  So, I pressed something on my phone that said something along the lines of ""share"", and, nothing happened.  At least on my end.

That's when I gave up on doing it over wifi and decided to plug my phone in.  As I upload them to my computer with the USB cable, I flip through the photos again and then play the video.  The video was the last thing that plays, and is the only thing that shows my face.  I had planned on editing that when I got it uploaded to my computer.  Well, turns out that whatever I do in the pictures or videos is what streams on his player.

So, he knocks on my door, tells me to go look at his TV, and I nearly die in horror.  I explain myself, he laughs hysterically, and I haven't talked to him since.  ",TIFU by streaming a series of naked pictures of myself to my older brother's TV. NSFW,1658
sabbylolo,143,313,1n8hl1,1238,"I was rushing off to the gym and remembered I hadn't taken my vitamins and supps. yet for the day. So I grabbed my magic pills, which include 2 fish oil capsules, and went to down 'em on my way out the door. I quickly realized I had already put my water bottle in the car and was in too much of a hurry to get a new drink to swallow my pills with. I think to myself ""oh, I'll just take them when I get in the car and have my water!"" I had to grab a few other things and of course I can't hold 7ish pills in my hand for 85 seconds while grabbing headphones and car keys. 'Brilliant idea!' Put the pills in your sports bra, yoga pants have no pockets and the bra will keep 'em contained for a minute or two.
Fast forward to 45 min. later. I'm in the gym. I'm sweating, I'm getting my pump on, guys are checking me out because I'm rocking it, I'm checking me out because there may actually be some definition in these chicken arms of mine. I grab a set of dumbbells in preparation for some reverse flyes. I pony up to the incline bench, press my boobs against the bench and let these 9.5"" pythons show the rest of the gym what’s up!
Annnd theeen....there's an explosion on my chest.
Before I can even realize what has just burst all over my boobies, the smell hits me. FISH! Oh and it's strong. I immediately stop lifting and notice the bench is now covered in stinky fishy oil. I start getting looks from the people lifting next to me. My chest is covered in what looks like extreme cleavage sweat. I grab paper towels and cleaner to clean off the bench but the oil is just smearing and covering the bench for the next unfortunate user. The smell of fish is now taking over the free weight area. I’m getting looks from other gym goers within a 10 ft radius and I overhear one guy say to his buddy as they glance over at me, “what’s that smell? Smells like a fish market in July.” All I hear as I’m beelining for the door is the response from his friend, “smells like your sister’s underwear drawer.”
Grrrrreeeeaaaaaat. Please erase my face and my 9.5” pythons from your memory.

TL;DR Put fish oil capsules in my bra. They exploded leaving me smelling like a 2nd rate seafood emporium.

EDIT: Wow, front page of Today I Fucked Up, such an.... honor?",TIFU I am the stinky fish girl,1551
LastNightIFuckedUp,516,495,1l54tv,1232,"After a night of partying we were all really (very) drunk, and were all making our way towards bed.  Being the responsible drunk that I am I cleaned up a few last minute things (because drunk cleaning is way better than sober cleaning) and then headed up to my room when I hear that my roommate is hooking up with one of the girls we were partying with.  As drunk as I was I figured it was no big deal and I would just pass out in my bed (only like 5 feet away) and let them do their thing.  I'm climbing into bed and I realize that my roommates little sister (who was partying with us too) is already there, but again due to the fact that I am drunk as shit I think nothing of it and just climb in too. For a few minutes we kinda laugh about the whole situation and then out of nowhere she starts making out with me. One thing leads to another and all of a sudden we're fucking with her older brother literally 5 feet from her.  I have no idea if he knows (he was pretty preoccupied and we were keeping it quiet) and I have no idea if I should bring it up.  TIFU and I have no idea what I should do.

TL;DR: Fucked roommates little sister while he was in the room, not sure if he noticed

EDIT: AND ITS TOTALLY CHILL!","TIFU by fucking my roommates little sister, while he was still in the room",1727
corntortilla,150,256,1g01mg,1231,"I'll preface this by saying that I have not been very well the last few days. I had what was probably food poisoning last week and have been sickly since. I have eaten very little the last few days and I'm constantly trying to balance out hunger and nausea. 

This morning I woke up very hungry and only a little bit nauseous so I decided to make myself some breakfast. I have english muffins, egg, cheese, and baloney, so I thought I'd make myself a breakfast sandwich. I turned on the heat, set a pan and while it was waiting to heat I grabbed a used stick of butter. As I began to unwrap it I got an odd sense of almost dejavu – this stick of butter looks like something I've seen before. Not sure what, butter doesn't look like many things... that's when it hit me. Semen. I was standing in front of the heating pan, when I realized what I was thinking about was semen. It doesn't really make sense, I don't think semen ordinarily looks like a hard stick of butter. 

I became instantly nauseous anyway and puked onto the hot pan. I ran to the restroom to finish barfing only to barf harder when I began to smell frying vomit. In my rush I didn't turn off the stove! I went back to the kitchen to turn it off and proceeded to barf onto my hands, more into the pan, and finally into the sink. What followed was what I can only describe as barf-cleaning. I intermittently barfed while I tried to clean the pan only to barf on it again as I tried to chip away the barf bits. The pan's finally clean, but I'm not sure I ever want to use it again. 

TL;DR Accidentally made barf omelet. ",TIFU by cooking,1487
Futurames,161,523,1r2jqb,1228,"Just a short bit of context. Where I work, we have uniform shirts and I wear mine over another plain t-shirt. Every day when I leave I go to my locker, take off my toolbelt and work shirt and go home, pretty much in that order. 

Well today for some reason, I decided to take off my work shirt before reaching my locker. Then, out of habit, once I reached my locker, my brain demanded that clothing be removed. So, I proceed to take off my regular shirt and am standing there in my bra for a good three and a half seconds before I felt a breeze and realized what I had done. 

This all happened in front of my entire group of male coworkers as well as a bunch of customers. Keep in mind that this is a hardware store so the customer base is largely men. I don't think they all processed exactly what they had just seen. 

Hope you enjoyed the show boys. 

tl;dr: a bunch of guys at the hardware store got a good look at my nuts and bolts.",TIFU by stripping on front of all of my coworkers.,1751
OrgyOrganizer,271,480,1fsdhf,1228,"The boyfriend and I were meeting a bunch of friends for dinner last night but we had 20 minutes before our ride was coming so of course we decided to bang. Towards the end I tell him to finish in my mouth because I still had a shirt on. Commence some seriously aggressive face fucking. At one point he looks down and exclaims ""oh *god*"" and scrambles to grab some paper towels and starts simultaneously wiping off my face and his penis. There is blood, and it is everywhere. It finally registers in my head that what I thought was just your average pussy juice was actually copious amounts of period. All over his balls, all over my face, all over the bed and most abhorrent, *inside my mouth*. I was immediately filled with the urge to cry and vomit in no particular order but instead he decided he would just finish up in hole B. I managed to keep it together but as soon as he finished I ran to the bathroom and immediately made a deposit. 
To date, that was the worst/most embarrassing thing that has ever happened to me but at least now I have a contribution to TIFU.

Edit: I forgot to add that a couple weeks ago I stumbled upon someone's comment about how he dated a girl that liked to fuck him while bloody and then suck his dick after. I thought it was the most disgusting thing ever and then it happened to me. ",TIFU by having a quickie before dinner.,1708
porn_DJ,162,390,1hlzzo,1223,"Let's start off with a little background info. I'm a totally normal (As far as I know), 20 year old female. Being single, I have my needs and really gotta (schlick? Fap?) one out every day. I don't think I'm anything out-the-ass-hot but I have this thing where I really get off to my own homemade porn. I have an iphone so I just set up the camera, masturbate a little and then watch it as I masturbate again. I usually orgasm both times but really exaggerate it the first time for my future self, does that make sense? And I know, I know, sounds narcissistic, but hey a sister's gotta do what she's gotta do. So ANYWAYS I did the deed and got dressed for work. It's pretty hot here so as I got into my car I rolled my windows down and plugged my phone into my speakers and got ready to leave. Suddenly my extremely attractive neighbor walked up to my car to say hi. We chatted for a bit and then I told him I had to be off for work. As we said goodbye I turned my car on. I had forgotten I had my volume on full blast from driving in the previous day (okay not full blast I'm not that annoying but still LOUD.) I wanted to seem cute by putting on some cool music as I drove away so I hit play on my phone. Now if you don't have an iphone let me tell you if you hit play it will play whatever video or music you were last playing, youtube, pandora, ipod, HOMEMADE PORN....whatever.) Aaaanndd suddenly, there it was. In all it's sweet, sweet, dirty talking glory. MY MOANS blasting out over my speakers nearly full volume. Not just that but the sound of my vibrator vibin' my dirty talking, and the painfully awkward sounds of skin slapping together (my ass on the floor....) I started fumbling in a panic and dropped my phone on the passenger seat floor. So there I'm sitting as my neighbor just stares awkwardly at me through my open window as we listen to me climax. I just slammed the power button on my stereo system said ""OKAY. WELL. BYE."" and drove off as fast as I could. I never want to see him again ever as long as I live. I hate everything.",TIFU by playing my homemade porn to my neighbors.,1613
fourfingerdeafpunch,178,679,1qwh67,1225,"This happened last night, my sister said my dad would tame a mountain lion and then I, thinking I was on reddit, blurted out ya I would mount a tame lion. Needless to say I am now the butt of everyone's joke. I woke up this morning with a bottle of lotion and pictures of cats and dogs next to my bed.",TIFU: I told my family I would have sex with a lion.,1904
idiotic_employee,242,436,1aeny0,1221,"This morning I came into work bright and early, like any normal day. The first thing I do when I get in is make a b line for the freshly cleaned and empty bathroom. After a morning cigarette and a cup of coffee, my anal cavity was looking for some sweet relief. Like most of you here, the majority of my pooping time is spent on my phone browsing Reddit. Of course, during this wonderful shit session I came across some nice GW posts, which promptly caused a stir in my loins. The company was empty, just me there, with 15 minutes to kill. Might as well get some much needed relief. Now, this is where the mistake train started boarding for a straight shot to fuckupville. Unfortunately, I can't really fap in the seated position. I'm a stander, or laying down, and there was no way I was lying on the bathroom floor to beat my dick for rent. So, of course, I chose to stand. Well, i decide the best place is in front of the sink and mirror. I can put my phone down on the sink edge and check myself out in the mirror at the same time. I'm weird, I turn myself on. So, I start the deed. I notice the time and realize I need to hurry it up. I made a rookie mistake and spent most of my time looking for the right image/video. So, it was now crunch time. I grip the sink, lean my weight in, and start furiously tugging like an adolescent teen who just learned about fapping. I'm getting close, only seconds away. I lean on the sink a little harder. Here it comes. CRASH!! The sink just came off the wall. I just came on the wall, and myself. Water is shooting from the wall at my dick. I try to balance the sink with my foot so it won't crack on the floor and cost even more. I'm staring at myself in disbelief. What do I do first? Clean my cum? Block the leak? Anything would of been smarter than what I did. I pulled up my pants, dropped the sink, and walked out. Now I'm in the lobby with cum on my hand, soaking wet. I quickly realized I'm a fucking moron and went back in. Squish. Oh, lovely, there is a quarter inch of water. I clean myself up, turn off the water, and get a mop and bucket. I then have to call my manager, his manager, and the store owner. ""Hey, its you're favorite retarded employee. I think someone broke the sink. I'm going to set up a repair."" Well, an hour later and the bathroom is still out of service. I really fucked up, guys... I do have a picture, but I don't have my computer right now. I will upload it later today after 3pm. 

TL&amp;DR: don't lean on things while fapping.


UPDATE: OP Delivers http://i.imgur.com/W54gccs.jpg",TIFU and fapped at work.,1657
banginchoonz,678,749,1qu6v1,1217,"Context: she and I have a weird friendship where we exchange filthy innuendos and whatnot all the time.

We were at a nightclub last night. She walked up behind me and grabbed my crotch. I don't mean a light squeeze, she full-on went in there.

I, thinking we were just joking, returned the favour, and grabbed her breast.

She freaked the fuck out. She slapped me, and now refuses to speak to me. I immediately apologised, again and again, but she just blanked me. Her friends said 'you pig, you pervert' etc.

Again, I tried to apologise to her, but all she said was 'don't *ever* do that again,' and I've not heard from her since.

**Edit:** Thanks for the support guys (and especially gals.) I know this story reads like something straight out of /r/circlejerk, but it is 100% true.

An update, for those who've asked. We still haven't spoken, and I doubt we will. We live far apart - she lives in the UK, I live in France; I was just back for the weekend to catch up with friends - and so we don't really see each other often. Losing her as a friend means two things: a 80% drop in sexy banter on Facebook, and one less person to see whenever I visit home.

Again, thanks to you all, especially the ladies. Everyone who got Gold deserved it. &lt;3",TIFU By touching my friend's boob after she grabbed my crotch.,1966
Teeklin,216,475,1ev7sn,1207,"So me and the new girlfriend have recently started exploring a bunch of new ""firsts"" for us in the bedroom.  She has always been very anti-blowjob in her life, but she wanted to try it out with me and found that she actually loves it and now can't seem to get enough of it.  So after a few days of that, we then decide to give the 69 position a try because I love going down on her too.  Perfect, right?

What I didn't think about was the fact that she gets very into it when I go down on her and cums hard and often.  Which is usually amazing for both of us, but in this particular situation of her sitting on my face with my dick in her mouth turned out to be not quite so good.  

Every time I would make contact with her clit, she would moan and start sucking a little harder.  I really kinda liked it, so I started putting the focus there and she started sucking harder and harder.  It felt pretty amazing but very intense, especially with her tongue going to work at the same time.  Then I decided to try another first and sucked her clit into my mouth.  I knew she liked biting, so while I was sucking I was licking and gently nibbling as well and it drove her bananas.

She came SO hard and the whole time she was griding into my face and gushing, basically suffocating and drowning me at the same time.  The problem is that she also began sucking on my dick like she was trying to do a vacuum cleaner impression and I was totally unable to move or say anything while I was being smothered.  When she finally came down she stopped and I rolled her off of me, but I was so sore.  We laid in the dark for a while, but when I got up to pee I looked down and noticed that the entire head of my penis was bright red.  About an hour later it turned into a discolored blotchy mess.  That's right, a hickey.

It's now sore beyond belief and every time it rubs up against my jeans it is incredibly painful.  I am now teasing her about it as often as possible, and she can't stop apologizing but also can't stop asking me how long it will be til we can have sex or she can give me another blowjob.  I hope it won't be too long, but ugh is it uncomfortable at this point.

**TL;DR My girlfriend sucked me so hard that she gave me a dickey**","TIFU by trying a ""69"" for the first time",1682
bloodster8,413,358,19pq1t,1208,"I am a New Zealander living in Chile and today I met my friend's sister. She was gorgeous. 6ft tall curvacious with a nice sense of dress. We started talking and eventually she offered for us to go down to the beach and around the town for a bit. I accepted and on this trip it became obvious she was interested in me. She asked me questions like ""Do you have a girlfriend?."" I decided in my mind she was about 15-20 years of age and that I (17) was ok with that. We went back to her house and were getting close on the couch when she asked me my age. I told her and she said ""Oh, I'm 13."" I thought my spanish was failing me so I asked her to repeat, she said it again ""13."" At that moment we went from almost occupying the same seat on the couch to having a seat in between.

I'm pretty sure this is the part where I get asked to take a seat. ""I didn't know she was thirteen!""

""You're free to leave whenever you want.""",TIFU by accidentally going on a date with a 13 y/o,1566
WKahle11,181,198,15d4ng,1213,"But seriously, that's like 30,000 dollars worth of fuel that's going to cost at least 100,000 dollars to have cleaned up. 

Now for the story. I work at an airport as a line service technician, which mostly involves fueling aircraft. The fuel in our trucks comes from tanks we have on the field, which are filled up by tanker trucks a few time a day. So I was checking in this fuel load, and didn't get all the right valves open to direct it to a certain tank, and it re routed to another tank which happened to already be full. Now the fun begins, when the tank gets full, the high level emergency shutoff valves is supposed to kick on and stop the flow of fuel into the tank. The shutoff valve on this tank happened to be broken, thus causing the 4000 gallons of fuel to spray out the top of the tank like a sprinkler. 

The way I see it, it's as much my fault as it is my supervisors. Apparently this has happened twice before, never this much, but it has happened. Yes, I did have the valves wrong, but my supervisor also failed to fix the faulty equipment.",TIFU by spilling 4000 gallons of jet fuel.,1411
loozerr,155,165,zbuuk,1207,"So I decided to replace a door ruined with stickers, drawings and scratches. Everything went well, until I closed the door I had just installed. I'll let the picture tell the thousand words:
[****link****](http://i.imgur.com/DpJR2.jpg)",TIFU Installing a Door,1372
ta7894,404,227,139i4g,1201,"My wife and I had a baby three months ago. We love our baby more than anything, but it's been tough. She had a difficult pregnancy and an even worse delivery. She's had hardcore body issues and was diagnosed with post partum depression about a month after the birth. The result of all of this is that we haven't had sex since she was 5 months pregnant, and since our baby was a premie, it's been altogether 6 months since we've had sex. Half a year. As you can imagine, I've been very frustrated.

Last night we had sex for the first time. I've been gearing up for this for about a month, leaving love notes around and taking her on special dates whenever we can manage. Last night the baby stayed at grandma's house, so I took her to a romantic dinner and then we took a walk along the lake. When we got back we went upstairs and things began to escalate, ending up with us in bed.

I made sure to include a lot of foreplay, especially going down on her. She didn't come from oral like she usually does, but I went down on her for at least half an hour, and from her noises and movements she was enjoying it. When it came down time to finally do the deed, I made sure to add lube and go slow. It was pretty amazing, after 6 months of nothing, and it was all I do to focus everything I had on not blowing my load after the first 5 thrusts. 

Then I noticed she was crying. I stopped and asked her if she was okay or if she was hurt, and she was trying to tell me to keep going and to ignore it. Obviously I stopped. I tried to comfort her and ask her what was wrong, and after quite a bit of crying and talking she finally said that it did hurt, but that was only the start. This opened a whole can of worms of body issues, and she started unloading on how much she hated her body- and she used the term *hate*. Her body definitely isn't what it was before, but I tried my best to talk to her. I told her that she had a baby and that changes your body. 

Then I said, for no other reason than I'm an idiot and have no idea how to handle emotional women, ""You can always lose the weight later."" She looked at me like shewas horrified, and I knew it fucked up. Except it gets worse, because then I said ""I just mean to say that it's normal that your body isn't what it used to be.""

She went from crying to bawling, and I slept on the couch. In the morning she didn't even look at me before she left to pick up the baby. I haven't talked to her all day, and I'm dreading going home after work. I done fucked up, reddit. ",TIFU having sex the first time after my wife gave birth and accidentally insulting her.,1428
gozenurhole,99,398,1qshu3,1187,"So my boyfriend and I are getting ready to lay down and he tells me to make the bed. (Because I move around a lot in my sleep and mess up the bedding.) The lights are already off and I go to make the bed. As I am moving the covers around, I notice what looks like a small box, a small RING box. My heart stops, and he says ""what IS that?"" I'm all ""I don't know..."" and I pick it up, full of emotions, about to cry. ...It's the charging port to his phone charger. Apparently he thought I was going to propose to him too because he really didn't know what it was. I'm an idiot.

TL;DR I mistook a phone charging port for an engagement ring box and got emotional for nothing.",TIFU By thinking my boyfriend was proposing to me.,1585
OddlyStrangeMan,153,392,1q6uc4,1188,"So me and my girlfriend just moved into an apartment together 4 nights ago and everything has been amazing so far. Each night when I get home we have had the same routine, she cooks dinner and we eat, followed by hookah, weed, and alcohol and a good amount of sex. Well last night was no different and this morning I woke up to go take my early morning shower before work only to see that she was awake, which she never is in the morning when I get up. I don't really think anything of it so I tell her good morning and go to take my shower. Fast forward 20 minutes and I'm ready to go to work, and right before I'm about to leave she asks me to cuddle. i think ok why not I have 10 minutes I can spare, I'm one of those who is always early to everything. so I get into the bed and under the covers and low and behold she's stark naked and just gives me one of those you know EXACTLY what I want right now looks and we proceed to engage in the horizontal mamba. Afterwards I tell her to have an amazing day and im on my way to work when I notice I need gas. As im filling up it was time to take a leak. As I enter there is a man, who looks a little rough , taking his place at the urinal. Now there are only 2 urinals in this bathroom and im not going to be the bitch who doesn't pee because there another guy at the urinal. So I go up and whip my buddy out of his hiding place and position myself. Now guys you know that post sex piss that really just sprays everywhere like a damn fire hose? Yes, I started to piss and it looked like someone has slide the Windex bottle halfway between mist and laser and I was doing this all on his pants leg. This is when this fine gentleman decided that his best plan of action was to attempt to piss back at me.... yes you read that correctly, I mistakenly pissed on a random man and his plot of vengeance was to get in a piss war with me. I Then yelled that i was sorry and got the fuck outta there.

TL;DR If you Piss on others, they'll piss on you.    ",TIFU by peeing on the man next to me at the urinal.,1580
Vaxid,211,516,1cf1os,1185,"A minor fuck up, but one nonetheless.

Happened yesterday. It was my birthday and I went to lunch with the girlfriend (we'll call her L) and her parents after church (her father is a pastor and we live in Georgia, keep that in mind). We decided to meet the parents back at their place after they went to the store. We got back before they did, but L forgot her key to the house. We got down to kissing and I leaned my seat back. L wanted to go down on me but needed to check if the parents were close to getting back or not. They said they were just leaving the store, 20 minutes away. She thought we had enough time so she started going to town. After a couple minutes, contrary to what we had thought, we hear the parents coming down the driveway (it's a decently long driveway). They do manage to see me leaned back and her pop up from my lap, but thankfully nothing else. She starts acting like she dropped something while I fix my pants. We get inside, she runs back out to the car to ""find her lost gum"", her mom goes off to the restroom and her dad sits down across from me in the living room. He looks over at me and says, ""Just so you know, it looks rather suspicious when you're all leaned back like that and L pops up out of your lap. Just thought you should keep that in mind."" I said yes sir and that was the end of it.

So thats how I could've potentially been killed on my birthday.

EDIT: Top of /r/TIFU. Thanks, you wonderful bastards. Good thing they don't reddit.",TIFU by getting a bj.,1701
bathedinsanely,91,100,s1gvi,1192,"Last night, I decided to go out for ice cream. I'm lactose intolerant, but my stomach hasn't been acting up lately, so I thought I'd have a treat. I had a cone and I felt fine, other than a little rumbling in my stomach before bed. That night, I had a strange dream, where I was being chased by a monster through a jungle. I kept running, and pulling down leaves, in hopes that I'd trip up the beast. I could feel it getting closer, and I found myself being overcome by waves of nausea as its rancid breath washed over me. I shrieked, as my leg caught on a vine and I went sprawling across the jungle floor, the beast's breath filling my lungs and making me cough and choke... 

And then I woke up, still coughing, and realized that I'd pulled all of my blankets over my head, trapping in a night's worth of half-digested milkfarts. The smell was so powerful that I barfed in my mouth, splattering specks of puke willy-nilly as I wrestled my way out of the stanky blankies. Then I took a shower and did one of those things where you slide down the wall and cry, as the realization that I farted so bad that it gave me a nightmare fully sank in. 

TL;DR - Dutch ovened myself, barfed. I'm also probably never going to go to the jungle or eat ice cream again. ","TIFU. Dutch-ovened myself, puked.",1292
laststandman,265,428,1cjqs1,1173,"I'm a sophomore in college, and during the spring my school usually has a lot of tours for prospective students. Now I'm a huge sports fan (especially hockey) so my eyes are naturally drawn to t-shirts with sports logos on them.

So I'm leaving my building this morning and on my way to fencing I see my friend leading a tour group. So we wave to each other and the group notices me. Then as I'm walking past them I notice this girl in the group wearing a Calgary Flames t-shirt. My mind races for a moment: I LOVE seeing hockey shirts, regardless of the team, and seeing a Flames shirt in Washington, D.C. is like seeing an Asian NFL player.

To make it worse, she customized it so that what was a normal Flames shirt became midriff city (where the navel's out and the hips are pretty), and was cut to show some cleavage (nothing slutty, just a little more revealing). She was decently stacked, and the reason I know this is because when I see a logo I tend to stare at it until I'm out of eyesight, I promise I wasn't eying her up for anything else but the Flames logo.

Well I guess I looked a little too long for the likes of the older gentleman standing behind her (I would guess her father) because he makes a very clear sound of surprise and disgust at my staring. I don't say anything because what the hell could I say? ""No I was just looking the the flames logo sir, I wasn't checking out your teenage daughter, I swear!"" But his noise was loud enough to catch the attention of my friend (guiding the tour) and so she looks at me. I just keep walking.

But I'm a big enough moron to fuck up just a little more. See now that I've identified this shirt as a shirt with a player's name on it, I just had to know which player it was. So, instinctively I turn to see the player name and number, thinking maybe it was just an awkward moment that's passed. Nope, dad's still staring me down, even more ticked that I'm looking at his daughter's back. I look up at my friend amd she shoots me a quick shocked, confused look. I'll have to explain to her later that I am not, in fact, into high school girls.

The player was Miikka Kiprusoff.","TIFU by ""checking out"" a high school girl",1601
deaconfrost5,232,289,19apu0,1173,"Long time lurker fucking thrilled I'm not anymore. 
Edit: Thanks guys.",TIFU AND FIRST FUCKING POST. Just went to get my cat some food and on my return discovered that I ran him over and killed him on the way out. FML,1462
massivechicken,257,364,1huyz6,1172,"I was dopey and it was early in the morning. I was ironing naked. As I am 6'4"" the ironing board is at cock level. As I ironed my shirt the edge of the iron ""seared"" my cock which was dangling over the work area. It now has a blistered line across the shaft and it is somewhat painful.

Edit - someone wanted a pic. http://imgur.com/2xXLqv9
",TIFU by ironing my cock,1536
palelove,182,565,1p39ge,1169,"I nicked my boyfriends penis with my nail.

He said he was perfectly fine and didn't feel a thing. Didn't think twice about it, continued and finished.  
I went to morning pee...peed out A LOT of blood. Uh oh.  What's this from? I already had my period a week earlier.

""Babe, check your dick.""

Yep.  Made a pretty nice sized gouge in his dick. He said he really didn't even feel it happen.

Also, it was *the* most amazing sex we've ever had to date...I guess my vagina likes penis blood.",TIFU by having morning sex,1734
JesusofTorn,165,359,1mnnvi,1170,"This happened yesterday, and it isn't the usual ""Reset the counter"" fart either. I work at a meat factory/processing plant, I was in the wipe up room, where they receive new pallets of meat, unbox them and put the meat in crates for the butchers. The wipe up room supervisor was ripping the shrink wrap off a pallet of Namibian beef when I let rip, it smelled so bad that he recoiled in horror and swore loudly in Polish and got a manager insisting that the meat was bad and had to go back on the lorry to the supplier. The manager caught a whiff of the lingering cloud of foul death and agreed that the meat was indeed putrefying and indeed needed to go back. I didn't own up to this foul concoction because for fear of being fired or sent home ill. 

TL:DR: Farted at work and made the bosses send about £1000 of imported Namibian beef back.",TIFU: by farting at work,1529
Renegade_86,126,426,1otynb,1167,"This morning I was out doing a delivery for work when my partner asked if I could swing by her parents house to collect something for her. She told me her mum would be at work but her stepdad would be in.

I've been with my partner 11 years and we always just walk into her parents house as if they don't want visitors they'll lock the door.

I walk up to the house this morning and try the door, it's unlocked so I walk in as usual, walk straight into the living room where her stepdad is sat masturbating to something on his iphone. Thankfully he's pretty much deaf so didn't hear me and I moonwalked the hell out of there.

That's an image I didn't need in my head on a Sunday.",TIFU by not knocking before walking into my partners parents house,1593
NotLiz,232,376,17ywsg,1162,"So I get zero time at home by myself. Between 4 roommates and a boyfriend who tattoos from home, my ""alone time"" is very minimal. Desperate times call for desperate measures, and I take the rare opportunity to get off when it does arise.

My strategy when masturbating is as follows:

If I hear the tattoo machine running, my boyfriend is clearly not about to wander in the room. Tattoo machine buzzing is my green light. So, I pull up some nasty lesbian ass fetish porn on my phone, bust out the vibrator, and suddenly remember that my roommates dog at the foot of my bed. Due to my opportunity being a short lived one, I decide to pretend she's not there. I prop my phone up on a pillow, and with the safe sound of the tattoo machine in the background, I begin.

Now I forgot to mention, I left the door open to clearly hear if my man takes a break and heads to he room. 

5 minutes in, my roommate welcomes himself into my room. And screams. Like a little fucking girl. This causes my boyfriend and other roommates to run in also, to see what's going on.

I was fixated on my phone at the initial time of the intrusion. They couldn't see the phone, as it was hidden by the pillow from their view. It appeared as though I was gazing into the eyes of his dog while furiously jamming a dildo into me. 

I just started looking for an apartment.

Edit: spelling",TIFU by watching porn with a dog.,1538
whisperkick,324,483,1nsd8k,1150,"I'm a College Student who attends University in the same city I grew up in, so to save money I'm living with my parents until I graduate. Yesterday I came home from class to find no one home, so I decided I could use a little ""me-time"" in the shower. I grabbed my shampoo and the little purple vibrator my boyfriend gave me (how romantic) and got freaky with it. fast forward almost 24 hours. I wake up, ready for a new day, step into the shower and see, dun dun dun, my little purple vibrator sitting on the ledge of my shower... I felt like i was in one of those horror movies where the camera zooms onto the characters face and the background just pans away out of the shot. My mother, and my brother have both used this shower since yesterday... There is almost no way they didn't notice my bright purple ""toy"". Nothing has been said and hopefully this will never be a topic of discussion with my family. But, needless to say, I'm feeling pretty awkward right now...

TL;DR: I left my vibrator in the shower that my brother and mother both use and now I'm positive they know everything...",TIFU By using my vibrator in the shower.,1633
salsa_sauce,136,218,154e57,1138,"I run an internet marketing business. Work has been going a little slow recently, but we are doing OK at the moment.

We have a guy who works for us who's job it usually is to prepare outbound emails for clients to send to their mailing lists. He was off sick, so I covered for him as we had a deadline for a mailshot for our biggest client - a ""Season's Greetings""-type email for their 45,000 customers.

We'd sent out drafts and samples and were really happy, so I hit the big shiny Send button.

Little did I realise, I hadn't replaced the first sentence - ""Dear Kevin,"" - with the merge tags to make it dynamically insert the customer's name.

And now I don't have my biggest client any more :-(","TIFU by calling 45,000 people ""Kevin""",1356
My_comments_count,157,316,1mjr1f,1135,"So my newlywed sister and husband are staying at our parents' house for the week. They just got here a day ago and since her and my brother moved out, my room is the only one that isn't used for storage. So they take my room (which is actually my brothers but I stole it when he left) and I took the basement. I like the basement, it's nice, cool and has a tv. Anyways, it was last night when we all went to bed and I was a little drunk off wine so I felt like looking at some porn. This is the part where I fucked up.

So i'm looking at porn on my tablet. It's an old tablet but I usually just use a remote desktop viewer to hook up with my computer so I can do everything a computer can do and my tablet just has to deal with the video. Well.....my computer was in my room. I knew this, but I also know that the monitors were off. I also was under the impression that the stereo hooked up to my computer was turned off as well. I ALSO knew that my tablet by default will turn off the computer sound and route the sound through my tablet. This all was true, except my brother-in-law had turned on my stereo for whatever reason. 

So I finish with my dirty deed with no problems. Sound never came through the speakers because I tested it beforehand, the monitors were off because I was able to see that there wasn't that blue glow coming out of my door. However, when I finished I didn't turn off the video or exit out of the web. I just accidentally and every so casually pressed the home button. So, there I am, 2 floors away, cum in a paper towel and wiping the excess off my nether region when I casually pressed the button and immediately I knew my mistake. Now I knew what could have happened but I was still thinking that I had turned the speakers off and no one turned them back on so i'd still be fine. 

so I waited

Two seconds later my speakers two floors up ignited with the sounds of a very nice lady getting absolutely wrecked by some big cock. Holy Shit. Not only did the sound come on but my loud ass studio speaker were turned all the way up and were right next to my bed where my sister an her husband were fast asleep. My neighbors probably thought we were having the loudest orgy ever. MY DAD FREAKED. He ran to my room, my brother-in-law was trying to turn the sound off but somehow turned the monitors on in the midst of things. So my dad has now walked in on my sister freaking out, my brother in law trying to unplug every outlet possible and see just some girl getting pounded making the loudest screams i've ever heard. 

Needless to say they knew it was me. They knew I did it and they knew it wasn't a joke. I just admitted to jerking it and I was sorry it went through the speakers. They were more mad at the fact that it scared the fucking shit out of everyone because some nice lady just started screaming at 1 in the morning at the loudest setting my speakers had. All in all it was probably the most embarrassing thing that has happened to me and IDK about you guys but there is something really embarrassing about anyone seeing what you get off to let alone my parents, sister and brother-in-law. 

TL;DR: I woke my whole house up to incredibly loud porn at 1 in the morning which I couldn't stop for a solid 120 seconds. I'll never know any longer time than those 120 seconds.

Edit: changed my rude description of a porn star
Edit 2: missed a bitch",TIFU by looking at porn with my tablet,1451
equestribitch,176,487,1j111g,1136,"From time to time my boyfriend likes to take my iPhone and have Siri change my name to something ridiculous. I came home from a job interview and said hello to my boyfriend's mom who was in the living room, but apparently I pushed the button for Siri and she wanted to join in on the conversation. My phone on full volume screamed,""HELLO THERE, PURPLE PUSSY POPPER"" in front of my boyfriend's mom. Thankfully she just laughed it off, but I'm still completely mortified. ",TIFU by letting my boyfriend play with my iPhone,1623
Turbosky,134,272,166ue2,1135,"So...I used to laugh at ""the idiots"" in tifu. Today I have joined the club with a delux membership. I am at home at this moment. I will go ""back"" to work and face a barrage of ball busting after I tell my tale....

So I had a few beers while watching Alabama and Notra Dame last night. I woke up feeling a bit groggy but I got up on time. On my drive into work I started to get the urge to take a massive shit. 

So I get to work, punch in, turn on the radio and start getting things in order at my machine(I'm a Machinist). The urge to take a crap came back, so I grabbed my water bottle and headed for the shit house. I locked myself into a stall and did the deed...nasty, it was. It was pretty much the usual routine of taking a shit, folks. Washed the hands, grabbed my water bottle and off to cafeteria I went for some water. Still...a bit groggy.

While filling up the bottle at the bubbler, I noticed the distinct oder of shit in the air. The garbage pails are near by, maybe something is rotten in one of them, I thought. At this same time, two of the office girls came out to get water also and got behind me. I absolutely heard one of them say, ""Oh my God"" in that valley girl kind of talk they do now. Of course, it meant nothing to me. 

I finished filling my bottle turned around and smiled and said Hi to the ladies. All I got back was a blank stare from both of them. Bitches, I thought.

I get back to my machine where once again I notice the distinct oder of shit wafting through the air. What the fuck? I thought. It was about that time when a good friend came over to see me for the usual morning talk...and this is how it went down....

Him- ""hey dude hows it goin'?!""

Me- ""Good, man. you catch the game last night?""

Him- ""Yeah...what a blow out...hey, what the fuck is that smell? Smells like shit.""

Me - ""Dunno...it's in the caf too.""

At that time I turn around to boot up my computer....

Him- ""dude!! What the fuck is on the back of your shirt?!""

Me- ""what are you talking about, man?""

Him- pointing at the back of my shirt. Confused look on his face.

Me- I pull the back of my shirt around to see a VERY pronounced shit stain at the bottom of my tee shirt about the width of my hand, you could even make out the four spots where my figers were. The shit smell, the looks from the girls...it all made sense now...I wiped my ass with my tee shirt. I was speechless.

It took but a second for my friend to figure it out.."" You wiped your ass with your shirt??!!....BWAAAAHAAAAAHAAA!!!""

Me- ""tell the boss I'll be back in a while."" I don't know if he heard me or not. He was in a state of complete hysterics. I took my shirt off outside the car , put my coat back on and here I am to tell the tale. Oh God...now I have to go back.
",TIFU by unknowingly wiping my ass with the back of my tee shirt.,1407
myairblaster,171,484,1la7po,1133,"My girlfriend and I have had quite a few threesomes in the past so we are pretty comfortable with having another woman in our bed.  Last night my girlfriend had her friend over studying for an exam they are both taking.  I made them dinner and served a nice bottle of wine.  Afterwards I asked if I could make them a drink, several margaritas later and they are finished studying we are on our couch listening to music and drinking.

Now in my stupid man-brain while we were drinking and being social I had thought she was dropping hints, and my girlfriend was dropping hints at her too.  She ends up staying the night because she missed her last train home and sleeps on our couch.  

The girlfriend and I are both drunk and having sex in our bedroom when we realize that the bedroom door was open and that she could probably hear us.  I convinced my girlfriend that we should ask her to join us.  My girlfriend is really hesitant but also turned on at the idea so I walk out naked and say to her ""sorry about the noise, we didnt notice the door was open""  she shyly mumbles something and I continue ""We don't want to be rude, maybe you'd like to join us?""  She started to well up and cry, my girlfriend comes out, half naked and I hightail it out.

While my girlfriend was calming her down she finds out that her friend thinks she might be pregnant from her ex-boyfriend who she's been recently sleeping while he cheats on his own girlfriend....

**Lesson of the story**

It's easy to mistake sexual hints and flirts when you're drinking....


edit:  I accidentally a title.  ",TIFU by asking my girlfriends friend is she wants to have sex with us,1617
Paiste402,135,308,1e3pqh,1119,"I like the little cartons of flavoured milk and before you open then you give them a quick shake to stir it up. I don't usually have soft drink but in the case of a University musical theory exam I thought I could use something fizzy. 

I sit down, exam begins. I pick up my bottle of coke and give it two quick shakes and immediately open it, not realising what hell I have unleashed. It spews all over me, my phone and the chick sitting in front of me drenching her. She screeches like a wild yeti and here I am holding a now completely empty bottle with ruined exams in a 3 metre radius. I look like a complete jack ass and the professor didn't have any spare exams left so I will have to do it tomorrow. The chick I soaked burst into tears too, I apologised but it was too late for that. 

Phone is toast too. 

TL;DR: Shook a bottle of coke like I would a flavoured milk in an exam. Ruined exams, phone and social life. ",TIFU by drinking flavoured milks all the time,1427
supstern,179,507,1m47ar,1116,"ok so this wasn't today or any day close to today (it was a few years ago when me and my sister were younger).  I was trying to go to the bathroom and my sister kept tying to open the door back up.  Not thinking about where her fingers were, I slammed the door shut and heard a yelp of pain.  I opened the door to find her and her bloody nub of a finger.  luckily my mom had been there and called 911 just in time to have them re-attach it and today it's as good as new. but i still feel bad for cutting off her finger ",TIFU by cutting my sister's finger off,1623
H1Ed1,117,367,1pggev,1111,"I work in China as a college ESL (English as Second Language) teacher. Today was a relaxed class, playing games with my freshman to practice pronunciation. During break time in class, I took it upon myself to download a popular media player used by a Chinese TV/movie site. With that player I can stream TV shows and movies with Chinese &amp;amp;amp; English subtitles. So I went ahead and downloaded it onto the classroom desktop. I have the player on my personal laptop, but had forgotten that downloading it opens the flood gates for porn and rpg related pop ups. Once class reconvened, we continued our game: 2 students stand in front of the projector screen, I say a word, they must reach and touch the correct word/picture. The words on the screen were ""Ship"" and ""Sheep"". I say the word ""Ship"", and I'll be damned, as soon as The words left my mouth and the students lunged for the screen..a pop up of an Chinese girl in lace lingerie appeared, face down ass up. The students ended up hands on the ass! Without missing a beat I x'd out of the pop up, look at the class, and simply say ""Shit"". We all had a good laugh.

I immediately uninstalled the media player.

TL;DR: Ship, Sheep, Porn, Shit!

Edit: Took a pic of my other class playing the same game today.http://i.imgur.com/n99uas5.jpg",TIFU by showing my students porn,1478
ChefTedLogan,119,327,1ermha,1120,"I worked 36 hours in three days...but that's no excuse.  After work on Sunday, I went to a bar with one of my managers to blow off some steam from the hectic weekend.  I had a few too many and had my girlfriend come pick me up.  Today, I had my girlfriend drive me back to where I parked, we were going to grab lunch and then drive back home.  When I got to the parking lot...my car wasn't there...

I began to freak out.

""FUCKING ASSHOLES TOWED MY CAR! FUCK!"", etc.

I went into the businesses surrounding the lot, and the owners all said they hadn't seen it and definitely hadn't called anything in to the towing companies.  One of the business owners told me that that parking lot wasn't even contracted with a towing company, so if my car wasn't there it was most likely stolen.

Great.

""WHO THE FUCK WOULD STEAL MY CAR?""

To the police station...The police tell me they need my plate number to file the report and, since I am registered out of state, they didn't have the authority to look up my number.  I panic and call my mother saying ""Mother, don't freak out.  I'm trying to stay calm, so please stay calm with me.  My car got stolen and the police need my plate number.  Do we have it on file anywhere?""

Thus begins my mothers frantic search, calls to insurance, calls to the state police to see if they can look me up.  Dear god.

I leave the station with a half-filed report filled out and tell the coppers I'll be back with the plate number and sign the finalized report.  They have the basics though, red civic, my state plate (just not the number, mind you) and that it is a general piece of shit that no one in their right mind would even bother stealing.  

10 minutes pass, I'm almost home and I receive a call.

""Mr. So-and-so?""  

Yes... 

""We found your car.""

So soon?  With no number?  It's a miracle! Here I am imagining it's driven off a cliff and in flames or at the bottom of a lake with a dead body in it, just like tv or the movies.  I'm nervous/excited to see how damaged it is and what kind of hell it had been through in the past 48 hours.

""It's one parking lot over from where you thought you parked it.""

Damn...that turned the ol' cheeks red.  I ashamedly tell my girlfriend to take me to the lot where the police CLAAAAIM my car is. (I'm still in total denial that I could be so stupid.)  Sure enough it was there.  Great.  I mean, don't get me wrong, I'm happy I found it, but my family is freaking out still that my car is gone, I almost had a stroke, my girlfriend thinks I'm a complete idiot and the police are probably choking on doughnuts they're laughing so hard.

I drive my car home, call my mom, remedy everything and my phone rings.  

""Is this Mr. So-and-so?""  

Yes...

""You left your ID at the station and you're gonna have to come get it....how about when you go pick up your car you swing on by and grab it."" *chuckles in the background*

Soooooo, I went back to the station, got made complete fun of by about 5 cops and walked out ashamed.

tl;dr **I went to a bar after work, forgot where I parked my car, reported it to the police, gave everyone I know a heart attack because I said my car was stolen and now I look and feel like a total tardo**","TIFU by reporting my car stolen to the police when, in fact, I had just forgotten where I parked it.",1447
sanser89,277,166,us9e4,1116,"I don't have a fucking clue how this happened. We've been together for a year and fucked many times.

He's doing me doggy, I feel myself about to climax and clench my body to try to hold it back then suddenly he stops.

""Amy, you pooped"" he says.

I don't believe him so I don't turn around but then I smelled it and I knew in that moment that I had indeed pooped mid-sex.

I jumped away from him quicker than sonic the fuckin hedgehog and lo' and behold there's a layer of shit in his pubes and he's just looking at me as if to say ""what the actual fuck?!""

I'm so ashamed I run to the toilet to furiously wipe my ass and then jump in the shower in a futile attempt to wash away the shame.

I must have clenched my body hard enough that I squeezed a loose turd out. Thankfully my boyfriend saw the funny side of it and cuddled me in the shower after, all while making poop jokes, but I'll never live this down or forget that this happened.

I'm so fucking ashamed.",TIFU by shitting on my boyfriend's during vaginal intercourse.,1282
Shrappy,100,172,tyo3m,1115,"Just happened.  I'm wearing gym shorts.  You know, elastic waistband?  So I'm doing my business when my thumb slips off the waistband, causing it to shoot up into my exposed gentlemen vegetables.  This resulted in a rather spectacular stream of homemade lemonade covering the side of the bowl, the floor next to it, the shower curtain and parts of the bathtub.

TL;DR:  Thumb slipped, junk whipped, everything dripped.


Edit: That awkward moment when your most successful post on Reddit ever...is a self post.   Feelsbadman.",TIFU while peeing.,1287
Rasteb,177,413,1e92cl,1109,"My parents are giving me a ride home from college today and I packed a small drawstring bag the week before of shit I would need in the car, snacks/bottle of water, shit to play with, book about led zeeplin (""when giants walked the earth""so far pretty good and recommend it.). I packed it last week cause I knew that after finals I would be so dead that I wouldn't bring anything and be bored for 8 hours. Flashforward to about an hour ago, 45 minutes into the ride, I was digging through the bag looking for something to entertain me and I saw a cookie in a baggie I got about as excited as a five year d would and ate it. It had an off taste but yet somehow familiar. Now about 20 minutes ago I am reading my book and think, ""When the hell did I make cookies? I don't even have a kitch**OH MY GOD THAT WAS A POT COOKIE!! **"" forgot that I made them about a week and a half ago and saved 2 for this trip but had intended on only eating half and waiting a while (as they had about a gram and a half which is a metric fuckload)  so here I am baked as fuck listening to music stoned out of my mind with my parents, waiting to be caught.",TIFU and ate a cookie I found in my bag.,1522
zk001guy,398,390,1gqt2a,1101,"Last night on my way to take my girlfriend home she was getting frisky. Now my car is perfect, it has a camper shell and a matress in the back. So I pulled behind an empty frys market place. We start going to town, you know... plowing guts, and right before we climax, *tap tap tap* ""Put your clothes on and step out of the car!"". Me and my S.O. both got indecent exposure charges and my possibly become sex offenders.... Yay-_-

Edit:Behind the Fry's there's a neighborhood and the officer said that kids might walk by and see us, and we could become sex offenders. The cop seemed salty as hell and I think that's why he gave us tickets, me and my S.O. both had clean records up until this point.",TIFU by having sex in my car,1491
wblueskylives,205,348,1c2ydg,1102,"This actually happened a couple weeks ago, but I didn't even realize this subreddit existed. Here's the story:

I (used to) work at popular pizza chain as a delivery driver. We get requests on receipts all the time, draw this, write a joke, write your favorite song, etc.

Well, I had already clocked for the day and was bagging an order before I left. I noticed the ticket said ""??"" in the note line, and I thought ""Reminds me of the Riddler.. I SHOULD WRITE A RIDDLE!"" So I wrote the first one that came to mind, the classic ""A rich man needs it, a poor man has it in excess, but if you eat me you'll surely die."" The answer of course being ""Nothing""

Here's the part that in hindsight I could've done better with (besides that riddle in the first place), I put each part of the riddle on a seperate box, so the last one had the ""If you'll eat me you'll surely die"" bit.

Well, the customer got her order, and her children promptly freaked out, which freaked her out. She took pictures of the boxes, sent those to corporate, and the following day at work my manager sat me down to say, ""This was a dumb choice, and it has a terrible outcome."" After calling his boss, I got fired outright.

tl;dr - got fired because people don't understand a good riddle

EDIT: Would like to point out that the tl;dr is kind of misleading. I realize it was my fault for having written the riddle on there in the first place, and in the end, it's on me for getting fired. I kinda thought that was implied by the fact that I was posting to TIFU though. 

tl;dr2 - It was my fault, I know. Just never would have thought a riddle would get me fired.

Edit2: Just got myself a new job and I start tomorrow! Will not be writing anything on anyone's stuff ever again x.x",Tifu and got myself fired.... with a riddle.,1450
vikingnurse,88,331,1n30s1,1092,"So, I have had this amazing African Grey for the last 8 years. He has a vocabulary of over 150 words, and is capable of forming random sentences and shit.

Anyway, here are a few fuckups following his ability to speak, and both my hobby of teaching him as well as my friend´s hobby of teaching him the most foul things.

1. We´re at a café. Sesar (that´s his name) hates women and has always done. Cute little waitress walks to our table, brings me a coffee and Sesar a bowl of fruits (didn´t ask her for it even).
Girl: Awwww what a cute little guy^^ Does he speak?
Sesar: - Shut up!
Girl: wow, that´s some beak he got there?
Sesar: fuck off! Get out you twat! Slut... (NB: not me who tought him the misogynistic thingies)
Girl: ehh...right?
Sesar: Yeah, shove it! Now fuck off...dog..*barks at her*

A few minutes later with the poor waitress bursting out in tears out of laughter, we were approached by the manager who said she had had some complaints from elderly people and people with young kids. We had to sit outside. Sesar´s reaction? Hysterical laughter all the way out. Me? Shamed and shamed and shamed for appearing to be a terrible owner, as he speaks in my exact voice...

2. Sometimes when I teach him new stuff, he confuses the words. A few years ago, I wanted to teach him how to say ""help, i´ve been turned into a parrot!""... Oh well, that didn´t go better than the fact that he only learned how to shout ""heeeeeelp!""
A few days later: Sesar is practicing his new vocabulary in an extraordinarily manner. I mean really loud. I hear a knock on my door and something like ""this is the police! Are you allright in there?"" is called from the other side of the door. 

I open the door with a large ""WTF"" on my face and they told me a concerned neighbour heard someone shouting for help from my apartment. Then a loud ""HEEEEEEELP!!"" is heard from the living room. Cops rush there, see featherball on his stick laughing hysterically. Cops went silent for a second, then joined sesar in hysterical laughter. Parrot and cops became best friends and we ended up having a coffee and chatting about how this was one of their funniest incidents to date.

3. Driving with Sesar in the passenger seat on our way to get some burgers and go to my parent´s for a visit. Had had a party the weekend before where apparently he was tought some very bad habits by my friends.

I order my food in the drive-thru, forget about the ball of feathers in the front seat and listen to music while I wait. All of a sudden I see that 4-5 staff members are gathered at the window, looking at Sesar. Sesar, silent until then, decides to put on public display his newly learnt vocabulary.... Examples:

- *moans in a male voice, then moans as a female, then in the end moans a manly ""ahhhhhhhhhh"" *

- (in a female voice)*stop it! You´re being aggressive! (you´re being aggressive = sesar´s version of saying you´re nice... Icelandic: þú ert ágætur(nice), sesar´s version: þú ert ágengur(aggressive) 
...*silence*...(male voice): come on! Lemmeshag!...*moans manly*

- Get... the... F****...OUT!....C***...dog...

- PENISPENISPENISPENISPENIS!!!....*hysterical laughter ensues*

Needless to say, I got shamed by my own parrot.
This is not counting the times he has said other girl´s names if i´m having a girl over, cursing my grandparents, scolding my little nephew and teaching him bad words, biting my brother´s dog´s tail and nose etc etc etc


tl;dr: Parrots are dicks.


Photo: http://i.imgur.com/RsalDF2.jpg - us on ITLAPD 2013


EDIT:
Videos of the fucker (also in comments):


http://www.youtube.com/watch?v=azBUBV00EF4 in a good mood 


http://www.youtube.com/watch?v=cRUc14diJUY 
-sorry for no subtitles. Only in Icelandic


EDIT 2:

If you find this funny and want one, please don´t just because they speak. He´s extremely hilarious and has been the brightest point in my life for the last 8 years, but CAGs (as well as other parrots) are extremely demanding pets who deserve a LOT of time caring for them, attention, training and such. I´ve never had a problem with him thankfully, but after i started working shifts full-time (I´m an emergency RN) he developed some problems. Also, I had to move across the globe to do my Master´s and it´s affecting him seriously. So please read a LOT about those guys before you think about getting one. This is a huge commitment and a long term one, as these guys live normally for 40-60 years. More than happy to answer any questions in PM.


EDIT 3 (for the lulz)

More examples of his behavioral shenanigans (conditioned, i presume):

- always when someone opens up or drinks something for a can, Sesar burps violently.

- if someone farts around him, Sesar has been conditioned to say either ""good boy"" or laugh hysterically

- he also does the cutest things (non-vulgar ones): Examples would be saying ""wannacuddle?"" and rub his beak on your fingers, ""gimmeakiss"" and rub his beak up to someone´s mouth (normally mine... during puberty he was a dick and did this and bit my lower lip in half)....

- he gets extremely horny after I take a shower. If I don´t take him into the shower with me, I´m rewarded with him trying to shag my hand when I get out of the shower",TIFU a lot of times by teaching my parrot how to speak,1423
taylordesoto,196,318,1ffsps,1088,"So I woke up this morning with a headache, only to see my credit card out on my desk by my computer with a website still open.  Apparently I was lonely last night and had clicked on an advert for ChristianMingle.com, and I 'sparked' a girl that was cute. Well, in order to message her, I needed a 13.99 monthly subscription.  So I thought, 13.99, not bad, let's go for it.  Well, I submit my payment, and apparently I signed up for the 6 month subscription, and $87.00 was charged to my account.  It's pretty comical but I still feel really foolish.

**TL;DR Got drunk, now a premium member of ChristianMingle.com**","TIFU by getting drunk and paying for a non-refundable, six-month subscription to ChristianMingle.com for $87.00",1406
Senamage,198,389,1kib2f,1087,"My sister recently had a baby and isn't able to leave her house very often due to taking care of the baby. So yesterday I decided to be nice and bring over taco bell and alleviate her by holding her baby. That way she could eat in peace. While holding the baby he let go a fart of all farts, or so I thought(sounded like an orchestra of tuba players). It smelled bad so I passed him back off to my sister. While she was changing him I decided to eat my delicious five layer beef burrito. I looked down and and saw what I presumed to be some of the meat that leaked out of the shell. I went ahead and licked it off my shirt. BIG MISTAKE, it was some of his shit that leaked out of the diaper. When the taste hit my taste buds I immediately start puking everywhere, on her newly shampooed carpet, on her microfiber couch, and all on myself. I cannot fully describe the taste of it, other than 20 year old hamburger meat, and garbage with the texture of grits. 

TL:DR Baby shit leaked out of the diaper and I mistaked it for meat that fell out of my burrito, then puked.

*sorry for bad grammar.",TIFU by tasting baby shit.,1476
dontkillmyvibe6,132,609,1is4kx,1078,"My Daughter is almost 2 and a bundle of joy. We went to her cousins birthday party today where she proceeded to get her face painted. All was good until it was time to lay her down to bed. She lasted down peacefully and I put her favorite cartoons on. An hour or so later I hear her yelling for me. I run upstairs to see the problem, and to my surprise she ripped her diaper off. Thinking that the poo was face paint she attempted to paint her face with poo. TIFU.",TIFU taking my daughter to a birthday party.,1687
115872,114,400,1ortgv,1076,"Ok, this was a couple years ago, but I love this sub.

This was probably one of the most embarrassing moments of my life (throwaway because I'm a baby) I was working at a college bar with a girl who was a maxim ""college hottie."" It was after closing time and we were the only ones on the second floor. We were talking about how good of a night it was and she picked me up in a bear hug. I farted audibly. 

The only thing I could say was ""I farted."" As I started dying inside, I tried to laugh it off. She laughed nervously then made excuses to return downstairs. 

PSA: Don't fart when a maxim girl touches you.",TIFU by farting on a maxim model,1476
throwaway453246,265,464,1ms27n,1076,"Oh man, where do I start. I have been studying all week for this exam as I wanted to start out the semester on the right foot. 6:45 this morning, the day of the exam, I decided to take a Vyvanse to help focus and get a bit more studying in before the test. All was going well when suddenly, at about 8:00, It hits me. It hits me hard. I knew something was wrong. In my morning stupor, the pill I had actually grabbed and inadvertently swallowed was a capsule of molly that I was saving for the weekend. As you may expect, that exam was not my finest work. Luckily there is an exam drop in that class, so there will be no penalty. Also, I'm having a killer morning.

TL;DR I have a great story to tell my children",TIFU by taking MDMA before my orgo chem exam.,1540
SaveGarrett,103,246,1cnr5d,1073,"So I'm a high school English teacher and I'm in the middle of teaching the trial scene from TKAMB when the zipper on my pants just splits open. Luckily, I'm holding my book so I make my way to my desk and grab a folder and tell my students that I forgot to deliver a very important message and ill be back shortly. I run to the room next door, tell the teacher what happened, she laughs at me but agrees to cover my class. I go to the nurse's office to get some safety pins to fix my pants. Fast forward a bit, I'm in the bathroom trying to safety pin my pants closed so you can't see the gaping hole of my fly being undone. I'm sweating a shit ton and starting to get nervous that ill never fix these pants in time for my next class. After about 20 minutes of failed attempts I give it one last go. I grab the two ends, pull them together real tight, and then shove the safety pin through. I finally got it this time, although I got more than my pants. I pushed the pin too hard and it went through my pants, through my underwear, and into the right side of the head of my penis. 

I went home early. ",TIFU by accidentally piercing my dick,1319
wrongpicthrowaway,142,349,1ivmr1,1071,"So here's my story, happened just 15 minutes ago.
I just got back from the gym and had a shower. I decided to snap a pic of myself to send to the gf and also just as a general progress pic. So anyway, here's where the fuck up happens. As I opened the picture, I pressed this one button which I assumed was the ""share"" button. Once clicked, nothing happened. I admit at this point I had no clue what just happened so I shrugged it off. I was able to press the correct button and send it to the gf.

HOWEVER! as I'm getting changed and heading down to grab some food, I start hearing my mum yelling at me VERY loudly. I have nfi what this could be about, cos she usually nags me like this, but not this loudly. At this point I just want to add that I have traditional Indian conservative parents. As I'm walking down, she starts asking me what I was doing in the bathroom, and WHY THERE'S A NAKED SELFIE OF ME CURRENTLY ON THEIR 48"" TV.

At this point I start trying to explain (half fucking shocked) that I was trying to take progress pics and it was an accident. Eventually after me repeating that same line over and over, she lets it go. She then goes on to tell me how both her and my dad were watching tv when my picture suddenly appeared. I burst into laughter and could not stop laughing as I walked back up the stairs to my room. Hopefully everything won't be so awkward, though I'm wishing now that I had one of those neuralizers from Men In Black to end my humiliation and embarrassment.

Embarrassing but also pure hilarity.

TL;DR - Took a naked selfie for the gf and for ""progress pics"", end up accidentally sharing it onto the big screen TV downstairs which my parents were viewing. TIFU.",TIFU trying to send nude pics to the GF,1420
MBubbles,237,296,1f4it2,1070,"Throw away account just to be on the safe side.

I am visiting my parents over the long weekend and with such a large family and sharing a room with my sister, it's hard to get any privacy. My only opportunity to get some peace and quiet (and orgasms) is during my nightly bath. So finally, the bathroom has been cleared and I jump at my chance to relax in my parents ginormous jetted tub. 

I start the bath water, get the bubbles flowin, and slide on in. I get into position and masturbate the best way I know how, with ye old faucet. The orgasms get better every time. 

for those who are unfamiliar (warning, porn): http://24.media.tumblr.com/tumblr_lwof78I6GL1r898hvo1_500.jpg


Now, the tub is filling with water faster than I can get off. (I can go for days), so I let the water drain at the same time so I get a steady stream going without the water level getting in the way. It's incredibly easy to lose track of time while doing this, especially since the water never really rises so you could be in there forever without having to turn it off. Apparently, almost an hour had passed and my mom was getting suspicious as to why the water had been running for so long when it usually only takes a few minutes to fill up. I was off in my own little blissful world and didn't even bother to think about it. 

This is where the TIFU part comes in. Apparently my mom had knocked to check on me and ask why the water had been running for so long. I had the tub jets on and my head was partially submerged in the water so I didn't hear a thing. My mom goes 'OH MY GOD SHE'S DROWNED' panic mode and BARGES in on me, spread eagle in this giant tub, getting a FULL FRONTAL of my lady bits, hands on nipples, legs in the air, the whole sha-bang. She looks at me, we both have the deer-in-headlights look and i'm scrambling to look ""natural"" (impossible at this point), and all my mother does is turn around and briskly walk out the door. 

At this point i'm wondering if it's possible to actually die of embarrassment. Contemplating never getting out of the bath. Drowning  didn't seem like such a bad idea. But, alas, here I am, sitting in my bedroom in a puddle of awkward embarrassment telling all of you. I have yet to face my mother again but I am predicting an awkward breakfast tomorrow. 

TL;DR: mom caught me masturbating in her bath tub. awkward. 

EDIT: I get it, not the most earth-friendly form of getting off but hey, I don't really care.

UPDATE: To those asking, breakfast was delicious. Mom seemed normal, no awkward avoidance of eye contact, no suppressed giggles, all was well. I decided to take /u/ZombK 's advice on how to handle the situation/see how much more awkward I can make it. (in the comments) Here's how it went:

We went on a little family walk before I had to leave to go back home. My younger sister just gradated high school and will be attending my university in the fall so she was asking some questions about college/dorm life. I had planned on bringing up the shower head thing right before I left so I could just escape if things got awkward, but my sister led me right into the question. She was asking what it was like to have to share a shower with a bunch of different people and asked for some tips. I told her to make sure she ALWAYS wears flip flops, and to bring some sort of caddy to carry all her stuff in. *opportunity.* This leads me right saying ""The water pressure is really weak at times, so try to take showers when there aren't many others in there... speaking of showers, Mom, where did you get that removable shower head in the downstairs bathroom. I've been shopping around for one to put in the apartment but haven't found one cheap enough. I'm in love with the massage setting."" My oldest sister smirked (told her the story) and my mom without hesitation said ""Not sure, your dad got it."" I watched to see if she'd at least blush, nothing. Quite the disappointment. (My dad got it from Bed bath &amp; beyond if anyone was wondering.) So in efforts to get some sort of reaction out of her I asked if she thought i'd be able to convince my landlord to install a tank-less water heater because I just LOVE how the water never goes cold at their house. Then she said ""I'm sure they'd consider it. It would be a great investment. Isn't it neat how you can take an hour long bath and *still* have hot water?!"" I blushed. She laughed. Still blushing. 

I'm sufficiently less embarrassed now. It was more the shock of getting caught that embarrassed me. I've found my moms vibrators before, so I think we're even. 

TL;DR: tried to make the situation embarrassing for my mom, and less awkward for me. I think it worked. ",TIFU by fapping (schlicking?) in my parents bath tub. (NSFW),1366
cshaxercs,214,337,1dxyx1,1068,"TIFU by “sleeping 10 minutes in”.
So you know how whenever wakes up early in the morning *6am for me*, they would usually hit snooze and say, yea just 10 more minutes? Well that was me this morning. **BUT**, instead of 10 minutes, this “snooze” turned out to be 1 hour and 45 minutes. And what woke me up, was my Boss’s phone call at 7:43am. So at 7:45 I rushed out without showering, brushing my teeth, or eating. I ran to my car as I put on my clothes, and I fucking tripped on my shoelace or pants (I don’t even know which one exactly) and I ripped my $80 dress shirt from Banana Republic as well as a fresh wound on my cheek bone. AT LEAST I GOT TO WORK RIGHT….? **WRONG**, So as I was speeding to work I realized that I forgot my ID badge (to get into the buildings). I quickly made an illegal U-turn (because I was just frustrated and only thinking about getting to work), and guess what? There was a cop right there camped on the side. WOW, RIGHT? I didn’t know making an illegal U-turn was $281.00 mistake. After all that was done I finally made it work at 9am. At the end of the day: I smelled like shit cause I didn’t shower/brush teeth, ripped my nice clothes, got a scar on my face, got a $280.00 ticket, missed 2 hours of pay, got yelled at by the boss, and just had a miserable day from then on. Moral of the story: **Never sleep in again. AND I MEAN IT.**  
*  **[Update]**: *Back Story: So basically I got this ""dream job"" like 1.5 months ago. I already missed a day of work. My boss already had a ""talk"" with me 1 month in, and I told him it would never happen again. (I'm the person who hates being late and hate to disappoint). So I did whatever I could to rush to work (the only thing on my mind was to get to work as fast as possible).* ",TIFU by “sleeping 10 minutes in”,1405
scatking69,146,287,1b16oz,1071,"Every day since the incident I have had urges to shit but when I sat down only one loud airy fart would come out.  No poop.  This got scarier as time passed.  But yesterday, I had that feeling where I needed to shit BAD and I rushed to the bathroom.  I could finally feel something long and hard exiting my ass, I was so happy.  I made sure to get a good look at this thing, it was BIG.  It was probably about as thick/long as 3 well nourished turds.  It was like a brown can off redbull but twice as long.  There were also 2 standard logs on top of that.  We have this toilet at our apartment that you could flush a live house cat down if you wanted to, but it struggled with this batch of shit.  Although this was a nice poop, it does not come close to my 2 favorite shits of all time: ""The flak cannon"" and ""the spaghetti and meatballs"".

I was glad to have finally shit, but I knew of course it was not over.  This morning I woke up and prepared for work then  I felt hella rumble in my stomach.  Rushed to the bathroom ASAP, shot out a small round rocket ship then began peeing out of my ass with no end in sight.  I could not stop fucking shitting.  I had to call in at work I was shitting so motherfucking much.

Anyways, I think it's all over now.  It was an interesting experience that I'm glad I had but I certainly will not be repeating any of this ever again if I can help it.

TL;DR  Finally pooped, and pooped enough to miss work.",TIFU ***UPDATE*** by eating 3 boxes of fiber one bars,1358
cirque-ull-jerk,143,460,1bgaaw,1062,"So, I got into a first offense diversion program so I could avoid probation. One of the requirements was the completion of three drug tests, the last of which was to be taken in a room with mirrors for walls and in the presence of police officer. Well, here's the problem. I'm have a bit of a shy bladder. And that whole situation was basically a nightmare of mine. Well, about 10 minutes passes and still nothing. He tells me if I can't go, then I'm gonna have to pay the thirty-five dollars and try again on another date. Given that bit of information, my broke ass decided to sacrifice my shame and pee like a woman. I sat down, still nothing. My heart was racing. He says, ""10 seconds kid..."". So what did I do? I threw caution to the wind and squeezed so hard I let loose the most disgusting post-coffee diarreha of my entire life, right in front of him. But I still got out that 30ml. So fuck yeah.",Tifu by pooping in front of a police officer,1522
[deleted],78,311,1lj15b,1051,"The NFL doesnt start until Thursday. 

Ive been hyping this party up for over a month thinking today was opening day. Nope. I spent $300 on party supplies, food, NFL gear and there is nothing to watch. ",TIFU by inviting 20 excited Europeans over to watch their first American Football game today.,1362
redribbon75,249,316,1ag7bj,1049,"My mother, after showing her r/aww, decided she was going to make a reddit account. So she makes her account and within 20 minutes of being active she finds r/spacedicks. 
How? I have no clue nor do I want to know.
After consoling her and telling her that not all of reddit was that bad she begins to ask questions like, ""What's your account name?"" and of course, ""What are you subscribed to?""
Fuck that. It's like everything that could go wrong went wrong.
",TIFU by trying to show my mom Reddit.,1365
Childwood,159,290,1773k9,1055,"I live in a building with shared bathrooms. This morning as I got up to poop in the toilet (it's my preferred method), I noticed some liquid on the seat before I sat down. 

**Now**, I can't tell you what possesses a man to think such a thing, but in my brain, at that moment, I *needed* to know if it was piss or just some water splashed up from the last flush. Now I **especially** can't tell you what possesses a man to do the following under any circumstances, but for some god forsaken reason, I gently reached out, dabbed the liquid and gingerly touched it to my lips. 

I immediately thought about what the fuck I was doing whilst beginning to cough and spit violently all the while doing some sort of spastic urine taste induced dance around the small cubicle. I washed my mouth out with listerine, brushed my teeth and proceeded to do a walk of shame two floors up where I could poop in a different bathroom that knew not of my shame.

Today, I wish I shit my pants instead.",TIFU by doing a taste test,1345
Ustozzle,283,419,1ktu5g,1047,"DISCLAIMER: This story happened last year. I didn't know about reddit back then. I was having lunch with a buddy of mine today and this story came up and he suggested I post it here. Sorry if that's like, against the rules on this sub or something. I just think it's funny and I hope you will too.

BACKSTORY: I'm an Air Force veteran who's out of the service now and is currently attending college. 

Without further ado, here is the text of the story which I originally posted on /b/ about a year ago:



   Duuude. I got taken for such a chump at Sapphire. Pull up a chair and I'll tell you the whole story.

   I was in Vegas for a wedding; one of my Air Force buddies was getting married. I served 3 of my 4 tours with her, so when she invited me about 6 months back, of course I said I'd show up even though it meant missing class. The wedding was real nice and I got to see a lot of other military friends that I haven't talked to since I got out. 

   I had only two goals while I was in Vegas: go to the wedding, and go to one of those fancy strip clubs they have. See, this was my 4th trip to Vegas (the other three were in the AF) and the other three times, I'd never been able to get anyone to go with me. So this time I was determined to go. I hung around at the wedding reception for about 2 hours - had 3 long island iced teas and 2 beers. Got pretty buzzed. My friends all wanted me to stay longer but I was hellbent on going to Sapphire, so I left. 

   I walked the mile or so from the Mirage over to Club Sapphire. I walked in, payed the $30 cover, and took $200 out of the ATM (with a $30 ATM fee). There was a stripper waiting at the door as soon as I walked in. She latched on to me like a fucking magnet: didn't let me out of her sight except for a quick trip to the bathroom. She dragged me to the bar... it didn't help that I was already pretty buzzed from the wedding reception. So, we did tequila shots and had some witty dialogue. Spent about $25 at the bar.
 
   I wanted to go sit by the stage and just enjoy the atmosphere. This was a really top-notch place. But within 5 minutes she'd convinced me to go to the VIP room: 30 minutes for $200 +$72 for the 4-drink minimum. Since $200 was exactly the amount I'd already decided I was prepared to spend, and whereas I was getting drunker by the minute, I agreed. But I'd already broken a 20 into ones, so I had to go back to the ATM to get more cash so I could pay the $200. She goes with me to the ATM. ""Just take out like another 100,"" she purrs in my ear while grabbing a nice handful of my dick. So I take out another 100 in cash, + another $30 ATM fee. I now have $280 in twenties, and $20 in ones. 

   I spent a total of about 10 minutes actually in the VIP room, and those 10 minutes were good. Witty dialogue continued. 4 more tequila shots were imbibed. I gave her the entire $280 and said let that be incentive to treat me good. She let me touch her everywhere.
 
   The whole time, she's using her feminine wiles to convince me to upgrade to the champagne room. And by feminine wiles I mean I'm fingering her asshole and pussy at the same time while sucking on her nipples. She seems totally down with that level of touching, and in fact, she cites her willingness to let me finger her asshole as reason to upgrade, and promises to be ""a lot crazier than this"" in the champagne room.

   I fall for it like a chump. Also, I'm now running on 6 shots of tequila + the buzz I already had from the reception, so I'm asymptotically approaching shitfaced. So I agree to go to the champagne room after 10 minutes.

   To go to the champagne room, it costs $600 + about $200 to buy a bottle. I really, really can't afford that. That's a month's fucking rent. But I decide to do it anyway. So I go to the ATM (she comes with me, pressing her tits up against me the whole time). Remembering that I'd transferred $1500 into checking before leaving on this whole Vegas trip, I try a straightforward withdrawal: Insufficient Funds. 
At this point, I should be alarmed. Like, seriously worried. But I'm shitfaced, and I've got pussy moisture on my fingers, so I try my savings account: Transaction Denied.

   Fuck it, I try my emergency line of credit: Transaction Denied. 

   WTF man? How is it that I have no fucking money all of a sudden? Also why is this ATM swaying from side to side like that, shouldn't it be bolted to the floor or something? Anyway, let's try a balance inquiry to see what's really going on here.
 
   My balance is $112.

   The stripper sees this and abruptly loses interest. She mumbles, ""Well that sucks... just take out like, another sixty and I'll treat you good for the rest of your time in the VIP room."" So I take out $60 + another $30 ATM fee. We go back to the VIP room. I give her the $60 and she starts to take her top off, but right at that moment, the srs bzns waitress and a bouncer both come over and inform us that my 30 minutes is up. Yeah, I spent 20 minutes trying to get the ATM to give me money, and that time totally counted against my half hour in the VIP room. Hearing this, I should be angry, but everything is kind of hazy and the room refuses to just hold still a minute so I can walk in a straight line. 

   The srs bznz waitress hands me a receipt for the 4 tequila shots: $72. I sign it while the bouncer looks on. Then the stripper smoothly escorts me out and gives me a kiss and says ""don't be mad baby.""
I'm too drunk to process what just happened so I just say thank you and leave. 
 
   The mile walk back to the Mirage was shitty. I knew if I called a cab, I wouldn't be able to afford a taxi to the airport the next day. I tried to text one of my friends from the wedding reception, but that was the exact moment that my phone ran out of battery and died. For the next hour or so, I walked by broke ass back to the Mirage. It was about 2 AM when I got back to my room. I crashed onto the bed, and suddenly the alarm started going off. I got up and was shocked to find that it was now 5:30. Still feeling tipsy and a little sick, I packed up my shit and checked out of the Mirage. I used the last of my money in checking to pay for a taxi to the airport, and then flew back to Austin. I got lunch in Houston with the $20 in ones that I never spent.
 
   And that's the story of how I spent all my money at Sapphire.

EDIT: Wow this got a lot more attention than I thought it would. Thanks everyone. For some common questions:

- Y'all caught a couple of grammar mistakes - sorry about that. I fixed them (I think). 

- A lot of people noticed that I only actually spent about $600 in the club, and asked where the rest of the $1500 went? It turned out that I'd already spent most of it on previous expenses for the trip (plane tickets, hotels, etc). However in my drunken state I didn't remember or realize that, so I was shocked and confused and a little bit afraid. I tried to convey that confusion that I felt by writing that part of the story ambiguously.

- I wrote this story the very next day after it happened while I was still hungover - which is why so many of the details are clear. If I tried to write this today (almost a year later), I definitely wouldn't remember all the dollar amounts and whatnot.

- For all the folks pointing out how many dumb mistakes I made: yes, I know. Isn't that the whole point of this subreddit? Enjoy the schadenfreude.

Thanks again, everyone, for all the comments and commiseration. I look back on it now and laugh. I learned many valuable lessons, and I came away with the kind of epic Vegas story that you see in movies. Well, sort of, anyway.",TIFU at the Sapphire Club in Las Vegas [NSFW],1466
[deleted],209,204,129sn5,1041,"Last night, I had a great date and great ""festivities"" after. While he was showering this morning, I thought I would pass a small bit of gas under the warm covers. Instead, I released the diarrhea. On the white sheets. It smelled so badly! He came in and saw my face, but didn't explicitly realize why I was blushing. I thought about grabbing my clothes, but instead  I told him that I had something embarrassing to tell him that would make him not want to go on another date. I lied, and told him that I got my period and I would buy him new sheets. I balled his sheets, so that he would be forced to wash them before evening. There is no way he won't know when he washes them - the smell is awful!! 

To make matters worse, I left my FAVORITE vintage belt, so I have to see him EVEN IF HE FIGURES OUT I SHIT IN HIS BED. 

**Update: Shit, I wish I made a throwaway! I have purchased Egyptian cotton sheets (the nicest I could find) and I am delivering them tonight, as soon as he gets home from work. I have told him I am ""stealing"" the old sheets so I can wash them properly!!! He seems keen to see me and has commented on how much fun he had last night. I think I got away with it!

**Final Update: Thanks for making me feel better about my day! I TOTALLY GOT AWAY WITH IT! Dirty sheets are at my house soaking in stain remover, fresh sheets are on his bed, and WE SET ANOTHER DATE for next weekend! 


 ",TIFU by shitting in a date's bed,1245
vitaminc28,149,296,1a626b,1044,"Last night I was at a friend's house with a couple of buddies. We were drinking and hanging out having a guy's night. After a few beers we got to talking about pepper spray (somehow) and my buddy said he had a can in his car. So for $20 I decided to let them spray me with it. I can now confirm that yes, it indeed does hurt.
Fast forward to today; my girlfriend surprises me by coming over in the morning and suggesting a rendezvous in the shower. Without hesitation I accept the offer. In the shower making fun time when my face starts to burn a little bit. Midly irritated, I wonder what it is but continue anyway. Midway through she stops and starts freaking out about her hooha burning. Turns out that pepper spray stays in some of your pores after you get sprayed and reacts with water after it gets wet again. The shower had washed it out of my pores and down my body to my genitals. ",TIFU by having sex after getting pepper sprayed. ,1340
JayDee240,123,293,1biqj0,1042,"   My talented girlfriend made a delicious meal of fresh carved turkey, mashed potatoes, gravy, corn, and all that other good stuff. Everything looked excellent, but I had just come back from a meal with my family and was unable to eat anything. She put the leftovers in the fridge so I could have them for dinner the next few nights.

   The next night I come home from work and make myself a plate and soak everything in gravy, because I fucking love gravy, especially her homemade gravy. Heat it in the microwave and start to chow down. I ate everything so fast that I barely had time to enjoy it, but I noticed something tasted strange.

   The following night I make myself another plate, microwave it, and now I notice that the gravy is what is giving this the funny taste. I watched her make it and remember a-lot of flour going into it. So I just assume it has too much flour. It was also pretty lumpy and stiff but I didn't microwave it for very long so it might just not have been hot enough. I ate it all and became pretty nauseous afterwards but didn't think much of it.

   A day later, I microwave another plate for an extra 45 seconds. This time the gravy got hard as a rock and burnt, ruining my whole meal. So I make another plate, gravy on the side this time, regular microwave time. With the gravy on the side, it completely solidified. It looked like cake. I don't like mashed potatoes without gravy, and I normally love anything my girlfriend makes. I don't understand how her gravy turned out this way. She's like a thinner, sexier Paula Deen when it comes to cooking. So I'm a little upset right now. Actually, very upset.

   I walk into the living room and confront my girlfriend about this. Not really yelling but in a louder frustrated tone I said. ""WTF DID YOU PUT IN THIS GRAVY? IT SUCKS!"" She was confused and wasn't aware of an issue with the gravy. I told her there was way too much flour in it and it keeps burning. She asked me to show her the gravy container. I reached in the fridge and pulled it out to show her.

   She looked at it and immediately started laughing hysterically. Like unable to breath laughing. After a minute, she finally pulled herself together, goes in the fridge and pulls out another container and says ""Here's the gravy"", then went back to laughing. Then my brain starts working and I remember back to the morning before she cooked this meal. We had pancakes for breakfast. I put the extra pancake batter in the fridge. I've been pouring pancake batter on my turkey and mashed potatoes for the past 3 days...

**TLDR; Substituted gravy with pancake batter.**

Edit: Made some adjustments so I don't fail reddit english class.  Thanks to /u/blurplegreen for spell/context checking and /u/Viscerae for the gift of paragraphs and bold text.",TIFU by eating leftovers,1335
tro39478,245,362,1kce53,1038,"I sold my old phone to my friend (Samsung Galaxy) and did a factory reset, I assumed that deleted everything, my friend put his SIM card in and it was all good. Today he texted me that hes watching the vids of my girlfriend blowing me. ",TIFU by selling my old phone to a friend without deleting all the nudes of girlfriend,1400
IDunGoofedBad6,174,284,179t37,1032,"I thought my room mate was going to be gone for the rest of the afternoon, so I decided to get a little freaky with myself. Then I though, ""Fuck it, I'll take off my pants and underwear, and get really into it"". So I did just that. Just as I'm getting to the best part, I hear the door start to unlock. I'm pretty sure my heart actually exploded from the initial terror and my brain shut down, so I had just enough time to pull my laptop over my dick, and just sit there like a moron. He walked in, had the door open for a few seconds, and I just hung my head in shame, staring at the weird porn I had open, and for some reason, refused to close. He awkwardly said ""Oh"" and left. Obviously, I rushed to set myself right again, and headed out into the hallway, and gave him the thumbs up that it was all safe to go back inside. I have class in like 10 minutes &amp; he's in the shower and going home this weekend, so hopefully I'll have enough time to plot out his murder so I don't have to deal with the horrifying awkwardness that is to come.

TL;DR Masturbating, room mate comes in, put warm laptop on my dick to rectify the situation. Unending shame.",TIFU by masturbating when I didn't have the time to masturbate,1316
phlegming,150,319,1nwqnp,1015,"I have a habit of eating like complete garbage when I'm drinking. It started on Friday morning at a playoff baseball game with beer and nachos, with more beer and fast food burgers afterwards. Saturday was comprised of Biscuits and gravy from Hardee's, philly cheesesteak from Subway (that I think might have turned), and a rotisserie chicken all washed down with more beer. 

Yesterday sent me over the edge. My girlfriend and I woke up around 11 am and decided pizza sounded good. We got dressed and went to a local sports bar to watch our teams. They had beer buckets on special, so of course we partook. A large pepperoni and garlic pizza, potato skins, and mushrooms nantua drowning in... more beer!

I got home last night and keeled over in abdominal pain. Took a shit, then had some sex and went to sleep. I woke up this morning butt naked with the sheets off most of the mattress. Ripped a fart, my girlfriend says I'm nasty, whatever. 

Then I ripped another one. And I know, from sharting myself previously, exactly what has just transpired. Wide-eyed, I scoot off my bed and lift the comforter to reveal a tan sunburst explosion against the pure white of a bare mattress. I clench my cheeks and run to the bathroom to release the rest of the demon. I hear my gf scream and laugh in the other room amidst the thunderous bowel release. 

Luckily, she thought it was hilarious. I'm not proud of it, and I probably will never live it down. We're going to look at mattress protectors tonight. ",TIFU by sharting myself in bed next to my girlfriend,1334
ultrafilthy,193,371,1piwe8,1022,"So I'm at the office going on a usual mid week coffee bender which usually consists of three cups before lunch. I take my lunch break and have a smoke after. For those that don't smoke, drink coffee, or both, the coffee is the primer and the cig pulls the plug. So I go upstairs to the 26th floor where I work and head for the bathroom. Of course the cleaning lady has to be in there so I clench the cheeks for a good half hour. After she leaves I head in there and plop down ready to. As soon as the porcelain and skin make contact the door opens. I get the nervous poop syndrome so I immediately try to hold it all in till the co worker leaves. Trying my hardest, a bunch of loud farts start shooting at at rapid fire echoing off the bowl making it ten times louder. I'm talking 25 toots in 8 seconds. I lost my state of mind and jammed my hand in the bowl trying to cover my poop hole like its some sort of plausible option and I can stop the gas leak.  wrong. The deuce shot out. Blasted my hand and I almost puked. 

Waited for the co worker to leave. Used about a roll of toilet paper, walked to my desk. pokerface.jpg. act like it never happened. 

tl;dr thought my butt hole could be pluged like putting your thumb over a tiny hole in a garden hose. ",TIFU by pooping in my hand at the office,1393
_wait_what_now,123,114,12r6t5,1002,"in the bathroom at work, i realized i needed a tampon. i found my last quarter, thought ""Wow, this'll be the first time i've ever used one of [these machines](http://www.picable.com/Architecture/Interior/Wacky-Industrial-Bathroom.29698) !"" and turned the knob. the tampon got stuck  half-way, so i put my hand up the slot to grab it. 

3 seconds after opening my clawed hand inside the machine, i knew i was fucked. i couldn't get my hand back out. i was stuck in the tampon machine, in the bathroom, at WORK. 

dying of embarrassment, i tried to open the box (it was locked), &amp; briefly thought ""What was that James Franco movie where he was stuck somewhere? Did I ever see that? How did that end?"" 

it took me a good 5 minutes before i could twist my body around to grab soap from the hand pump, which i applied to the machine's slot in an idiotic attempt to slip my hand out. no dice.

eventually, someone came in and found me, red-faced &amp; near tears, soap dripping down both hands, and she got a custodian. 

i will NEVER live this down. i am buying 300 boxes of Tampax pearls tonight.",TIFU by getting my hand stuck in a tampon dispenser machine ,1116
K3R3G3,79,157,1q60m6,1003,"(This is a bit long, but I think it's worth it)

I attend classical orchestral concerts in a hall of about 2000 - 2500 people.  There are frequently sounds that really take away from the experience, whether they be coughs, sneezes, whispers, dropped programs, etc.  It is extremely frustrating and a properly timed disturbance can ruin the culmination of a piece since even quiet sounds carry so well throughout the hall. 


So, after intermission when I had my 3rd drink of the evening, I was sitting in a tier about 25 feet above the stage during a symphony so that I could only see half the stage and about half the lower level seating.  During the music, I thought I was going insane because I swore I could hear someone down below talking at a normal volume.  I was terribly agitated and kept looking around, but couldn't see the person.  What happened next is extremely rare. 


The conductor actually stopped the music right in the middle of the performance and turned around to face the audience. I could hardly believe it.


I leaned forward to get a better view and there he was!  A man, though now in a somewhat hushed manner, blatantly talking on his cell phone!  I instantly went into a rage, leaned over the rail, and yelled in the large, acoustically-tuned, otherwise silent hall of ~2,300 people, ""GET OFF THE PHONE!!!"" 


I heard over a thousand people shift in their seats to look at me from all directions.  I sat there shaking my head and looking at the people to my left and right in disbelief due to this exceptionally rude man, who had brought the concert to a grinding halt.  I sure put that fucker in his place though.  


Just then, the conductor picked up a microphone and stated that a woman in the audience had gone unconscious and may have had a heart attack or stroke and that a man was on the phone with 911 getting an ambulance to come.  Though intoxicated, I was overcome with extreme embarrassment and slumped down in my seat so far, I almost slid out of it.  I stayed down there for the remainder of the concert.

",TIFU by finally taking a stand when I shouldn't have,1160
[deleted],93,183,yfzgc,995,"Waiter/bartender here. I passed serious gas that I couldn't hold anylonger at a table that took FOREVER to tell me what they wanted to eat. It made a slight noise and the father noticed, but said nothing. As the horribleness crept to the mothers nose she said something about it.... Not thinking at all i said ""I think it was your baby"" and the father objected that he heard me fart. I was speechless as I was stuck in this very awkward moment. The mother broke the silence with ""I know what my baby's farts smell like and that is not it. This smells like dead animals"" they complained when they left and i got reamed out by my manager.



God I can't wait to finish school and get out of this hell hole.",TIFU by farting at the table I was taking an order from and blaming their baby.,1178
dogboy21,170,335,1ipbda,989,"I work for a car dealership and was delivering car parts to a body shop. It was around lunch time so I really think to much of it when there was nobody around. So I see some guys inside a room and head towards it thinking its an office. Instead of knocking I just walk in casually when BAM there doing coke in the middle of the room. One guy starts yelling at me in spanish and all the other guys look nervous as hell. I was like ""no no its cool im just here to drop this off"". What I guess is the owner gathers some cash, while he's doing that some guy offers me a line and I was like ""na, not right now cuz im working"". Crazy stuff.  ",TIFU...by not knocking,1324
PappaCat,135,235,18u6lx,997,"   I work at the local hospital. I am a ER clerk where I check patients in. They are installing a new voice intercom system to announce when visiting hours are over through the entire hospital. The engineering department did not tell us how this system will work, or what they were setting up to make it function correctly.
 
   Two people work the ER desks, and I'm actually working with one of the coworkers I enjoy joking around with. I start messing with youtube during downtime like I usually do, but I noticed something different. I started messing with the sound from the computer. I adjust the volume and I noticed the dinging noise from the volume was coming from behind me. I thought to myself ""awhhhhh yeahhhhh! It's coming from my coworkers computer. I'm going to rick roll that ass! I bet she will have zero clue where the music will be coming from."" I laughed to myself for a bit thinking this was a decently funny idea. I turned the volume up on both youtube and the computer to the **MAX**. I start chuckling to myself while it plays loudly. The song plays for a solid 15-17 seconds. My coworker starts yelling at me, and nurses start coming from the back yelling at me to turn it off! *Here we go*.

   Little did I know that the new system being installed went through our computers and connected every sound from our computers to the overhead system throughout the **WHOLE** hospital. The sound I was hearing was not coming from by coworkers computer, but from the overhead speaker above her. I was not aware of the new system working like this and no one told me, but for some reason everyone else knew. I fucked up. I Rick Rolled the entire hospital. I now await an *unimaginable* ass chewing.

**EDIT:** I guess I forgot to mention our hospital has been failing the last few years. Losing money constantly, the OB department shut down a few months ago, because the OB doctors left for better hospitals. We have no other OB doctors near, so the department was basically force shut down. All of the ""big wigs"" here are in serious mode about the hospital and praying it doesn't go under. I'll be sure to tell how this ends up.  


**EDIT: UPDATE/OUTCOME** I got called into the office today. After a long talk, and me explaining the reasoning behind what happened. (even using some of your guys advice) They disconnected the setup with the computers through the PA system. I managed to not get in any trouble, and not even a slap on the wrist. They realized that this wasn't completely my fault and are going to have a ""talk"" with engineering. *Surprised* for sure.",TIFU by RickRolling the entire hospital I work for.,1232
StanleyDecker,128,229,1jfnub,997,"Near the end of a meeting this morning with the owner of my company, my direct boss, several other important people, and my entire department, one of my subordinates (I am the department manager) mentioned they would be out on Friday for a doctor's appointment.
Someone made a joke about the appointment being for a prostate exam, everyone laughed and the joke-teller said ""oh come on, we've all had it done.""
Being the youngest person in the room, and the only one under 45 years old, I mentioned that I had never had one.
""You've never had one, StanleyDecker?""
""Well, not by a medical professional...""

One guy chuckled nervously. Everyone else stared at me in silence for what felt like hours.
Finally the owner said ""OK, are there any other work-related items that need to be addressed?""

I think I am going to update my resume.",TIFU by making a joke about assplay in a meeting with my boss and the owner of the company I work for.,1226
bluesky747,159,263,19gwdq,992,"I was in a school girl outfit, garters, a collar, and leash. 

I can never look her in the face again. Ever.

**Edit: Thanks so much guys! Most of you were telling me not to worry about it, and it definitely made me feel better. I also appreciate everyone's input on my stockings. I actually wound up not wearing either, and got some black mid thigh-highs that looked hot with the garters! Party was awesome, too! Just wanted to thank you guys for easing my mind about my faux pas! Thanks, Reddit!**

**Also, since a few were asking about our Simpsons picture, [here's a better picture of it](http://i.imgur.com/XWt005F.jpg).**",TIFU by emailing fetish pictures of myself to my boyfriend's mom instead of him.,1255
CatchUNextTuesday,265,260,1bulte,989,"If, for whatever reason, you have ever wondered what it feels like for a cat to lick your eyeball; just stop. Stop right there. It feels like sanding your eyeball with course sandpaper. Just... just don't ever let it happen. Oh my god. My cats are bastards. My fucking eyeball.

I was trying to sleep. I suffer from insomnia and have recently come off my meds. It wasn't going too well. My cat, in her infinite wisdom, decided to comfort me in her usual way by walking up my body to roll on my face. Before she initiated her rolling sequence she started sniffing my face. This is where I fucked up. I opened my eyes to see what she was doing. And in that split second, her tongue was being dragged across my eyeball with the pain of a thousand really painful things.

I actually feel bad for startling her so badly with the flood of expletives that subsequently issued forth from my face and flinging back the doona to spring out of bed and run to the fridge to get my saline in all my naked glory. I've never flushed my eye so hard. It burned. It burned so much.

I ended up being able to sleep at around 6am. For 5 hours. I think my brain is falling out of my head like wet cake. My eye still hurts.",TIFU By Accidentally Letting my Cat Lick my Eyeball,1249
Dookus,56,265,1i2lx1,982,"No, it wasn't today.  It was almost 45 years ago, but if you ask my parents, it happened yesterday.

There were 7 of us in one house (9 if you count the Great Dane and Mynah bird).  The toilet went hinky.  Dad spent the day trying to replace it, sweating and cursing.  I was probably 8 or 9 years old... 

He had just placed the new toilet over the... I dunno, toilet hole?  And the old one was sitting off to the side.  I really had to go and he reluctantly let me in.  

All I knew is that the new toilet wasn't fully ready.  So I shit in the old toilet.  It never even occurred to me think about how toilets worked.  I thought they were shit-recycling machines.  I had no idea they were connected to anything.

I wiped and walked out.  Dad went in to finish his task, and screamed,  uncharacteristically, ""Jesus Christ!  He shit in the wrong toilet!""

I was mortified.  I didn't know what a right toilet was. They told that story to anyone and everyone who would listen. 

To this day my family still loves pointing out what a big dumbass I was.

So even now, all these years later, my family still laughs at me for shitting in a disconnected toilet bowl.",TIFU by shitting in a disconnected toilet bowl.,1247
damonx99,342,270,1dfklr,986,"I work in medium sized office as a web designer/ what ever else is needed.

I had to go to the server room to grab a few cables...then I hear it.  This heavy thudding noise coming above the cabinet.  It's steady and a bit muffed.  

My first thought was that something was being moved or falling down.  But it was steady.  Well I went to the office around it to check it out...nothing.  Still thumping...

Check out the next...nothing. I just tell people I am checking for PC issues when I come around.

Finally get to the last office near the server room and the door is jammed.  This particular door ALWAYS jams...all the dam jamming time.

So I do what I normally do and bash it a bit to open it.  Won't budge...

I do it harder....harder...and then bam!

I slam the door open on a new hire dogging it with an office gal.  They both get embarrassed and try to hide behind a desk...

Here is where I had my ""TIFU"" moment.

I try to play cool and leave, (dont want to be a douche you know), but as I go to walk out my foot catches on this girls g-string.

I walk all the way back to my own office and take a seat, not know a thing about the shoe accessory I picked up.

A woman I work with walk in to drop off a package for me and looks down.  She smiles and walks off saying, ""so that's where *****'s been""

I looked down and see this very large bright red g-string with nutty love all over it on my shoe.  

Moments later a very pissed off gal walks in asking for her underwear and knocks over my drink.

I am having serious thoughts about posting the security tape of her office sex...adding in that she is married NOT to the office sex guy...

Her husband is actually a Really cool dude and I would hate to do that to him...but man..that bitch...she has the office talking all kinds of shit about me stealing her g-string.

SO RECAP..

Tracked down office sex, dragged cum g-string all over office, and now people think I am so sort of freak.  ***** this day.....***** it hard.

**OP COMMENT UPDATE: I was on reddit since the whole thing went down acting like I was working so people would leave me the hell alone at the office.  Thanks to all of you for being active so I could temp drown out the shitty situation that spewed forth from holes of that hell bitch.  I will let you all know if anything happens since your interested.**  

**Just to clear things up on emotion...I dont encourage violence against women, BUT YES, I did had half a mind to take her on a public bus and make a new ""bitch got knocked the fucked out video""...**

**Yes I have backed up any evidence that she thinks she could screw me with, and sharing said data is illegal and will get me fired as there are very prominent company logos visible.**

**My wife is sleeping right now...I looked over to her and made a mental note to thank her for being awesome.**

**Not looking forward for next day of work one bit...**

**But hey!, at least I didn't drive my lawnmower into a lake today or flash my dick at anyone.  Read those TIFU post and counted my luck that THAT didn't happen.**


**-----------------------------**
**-----------------------------**
**-----------------------------**
**-----------------------------**
**-----------------------------**
**-----------------------------**

**UPDATE # 2**  **(since people seem to care, or get bored)**

HR bitch is now out of HR and back on ""other"" duties after cussing her boss out.  Yes, there is justice in this world.

I know you use reddit Tina, so butter biscuit fuck you, because I dont give a dick slapping crap what you think or what your idiot tweets say.  You wanna talk, come see me.  Oh and bring some coffee....   Next time dont use your job to be a cunt...

You could just be yourself anytime....


G-string lady wont say a word to me or even respond to my email intercom summons...she put in a request to take an early out as she feels sick.  

Yeah bitch...so do I.   So do I.

Trying to be nice but man....sometimes it just isn't worth it.  But still....



**-----------------------------**
**-----------------------------**
**-----------------------------**
**-----------------------------**
**-----------------------------**
**-----------------------------**
**-----------------------------**
**-----------------------------**
**-----------------------------**
**-----------------------------**
**-----------------------------**
**-----------------------------**

**UPDATE # 3**  **(Husband knows)**


So it's done.  Went out for drinks last night with friends and the husband was there.

By this point 3 others with us already knew what was up ,(1 by way of reddit), and what we had to do.

We asked him to come site in a booth with us and I layed out what happened. Talk about a crap thing to have to do.  We talked for about a solid hour.

Turns out that this guy had his own suspicions for quite a while.  She has been giving off tell tale signs for a while.  Even going as far to do her laundry at a separate place.  

It was strange...he didn't break down or anything.  Face was solid as a rock...very hard to see as I imagine he had all kind of anger or pain inside.  He said he would talk to her but has no plans to end the marriage as he knows it can work.  He really loves the gal, so he is going the distance.  We asked if he needed help to call any of us, as we dont want him exploding and doing something crazy.


We showed him the support on reddit and he says thanks for wanting him to know the truth... for what it's worth.

As for my work place, I sent out an email explaining what happened **(with her husbands blessing)** so I dont get any more crap about being a nasty g string thief. 

HR is following up with their own review of the matter as well.
Cheating lady has returned to work today but refuses to speak with me directly to apologize for her behavior.  



Cheater lady, if you read this, think about your life...

You need to apologize to your kids and husband.  Tina, you help her cheating ways so your no better.  


You really do have nice kids and a good guy.  If you want other men for sex, then straight up tell him.  I could see in his eyes that he was living some kind of torment.  The fact that he was almost relieved to know for sure what you were up to is sad.  

Also, you own me one brand spanking new bottle of Mountain Dew Code Red. 

That shit, madam....was not in any way or form....cool.  



Tina, I know I named you, but in all honesty, fuck you with light sabers...I have never done anything for you to go SO out of your way to try and mess with me.  If you get fired, I have no qualms about is.  You should NEVER have acted out so ugly to me.  


You dare to try to make me out as something I am not just to help out your cheating cousin? You DARE to tell me your calling my wife?  If you want to get mad about something, then be angry that you cant handle being a responsible adult.  

Also, next time you want to call someone racist...think about it.

I married a white girl...my best friends and Indian and Black.  Color is no issue for me, so stop spreading ugly rumors.  Even if you dont talk to me at the office, know this, I WILL make sure others know what you are doing.  Sharing this thread around...you think your the ONLY other person who uses reddit at work?

Dont consider your job safe...you did just get a demotion for being such mean spirited    person right? 


I totally expect FULL apologies from you and your cousin...but not to me.  I could care less about it at this point.  


So that's it people...   I hope the best for that dude and his kids.  I REALLY do hope that his marriage works out for the best.  

As for all the other people on TIFU, heart out to you, there are some REALLY fucked up days going around.  



",TIFU By walking in on Office Sex,1256
CharlesMonsoon420,170,588,1k5i0g,980,"If you've read my other post, you already know marijuana and my penis don't mix well. If you didn't know that, you're about to learn.

After a nice wake and bake bong hit, I decide to go down and get some breakfast. I was video chatting with my girlfriend, and she brought up that some guys were telling her that they all enjoy touching their little boy ding dongs to random inanimate objects. She said this as if it came as a surprise to her, which baffled me. The conversation doesn't stop there though. I go to take the cream cheese out of my refrigerator, and grab a bagel to cut in half and toast. With the thought of touching my penis to strange objects still fresh on the mind, I notice the hole in the bagel in a way I never had before. I couldn't believe I had gone my entire life without once putting the head of my flaccid penis into a bagel. After contemplating what I had been doing with my life up to this point, I give it a go. Pajama pants at my knees, I press my dick against the bagel only to find it won't fit. With a mix of disappointment and happiness (I had two different reactions to the fact that it wouldn't fit) I cut the bagel in half. I leave it there on the counter with the cream cheese next to it.

If you've read my other post, you know that penis-y stuff and marijuana and leaving things places do not mix well for me. If you haven't read my other post, you're about to find out.

My mom walks in, yelling something about needing breakfast and asking if she could have a bit of whatever I was making. Being distracted by the TV with a mix of being high, I absent mindedly said yes. 30 seconds later it dawns on me. She is in possession of the penis bagel. I get up as fast as I can, storming after her and barreling through my front door. She was miraculously already through half of the bagel. The fact that it was covered in white cream didn't exactly help the image. I stood there mouth agape as my mom confusedly looked back at me, wondering why I was so entranced by her bagel. We stood there awkwardly looking at each other as she pulled out. I grunted out a bye, and walked shamefully back inside, my sexuality in deep contemplation.

I walk back into the kitchen, ready to stress eat the pain away. I see my older brother holding the other half of the bagel, covering it in gooey, white liquid butter. ""You snooze you lose, sorry bud."" He says to me. I desperately tried to get the bagel from him, but considering he is 60 pounds heavier than I am and 6% body fat, I didn't stand a good chance. He consumes the entire bagel in front of my practically sobbing eyes, my penis shriveling into the size and shape of a tan raisin from the sexually scarring bagelfest I was currently attending.

tl;dr By the transitive property, my family licked my junk.",TIFU by letting my Mom eat my penis bagel,1568
bekt,123,411,1m1raj,970,"This happened back in high school, but I still fucked up.

We took a field trip to some play. Got to the theater, I sit with this girl I've been talking to for a while. I'm cracking jokes, shits going great. She decides to say something funny. It probably wasn't really that funny but I was in love so I busted out laughing. 

The thing was, I had a cold that day and I had been keeping a giant fucking lugie in my mouth because I had nowhere to get rid of it. It was too warm and gross to swallow and I couldn't just spit it on the floor. 

So anyway, she makes me laugh and this wad of my spit and mucous comes flying out of my mouth at mach 10 and lands on her shoulder. 

I'm all O_O

She's fucking repulsed. ""EWWWW WHY DID YOU DO THAT?!""

I needed to fix the situation fast because she was making a scene. Quickly, without thinking, I frantically grabbed for my nasal mouth juice. I'm grabbing and snatching, trying to get it off this girl's shirt. 

*rrrrriiiipppp*

Her fucking shirt ripped right off. I don't really know how. It was this silky kind of shirt that was all artsy and shit and it just came right off. We were both speechless now but she gave me this look... I'll never forget that look. She broke up with me with that look. 

She took her shirt back and ran to the bathroom and I just sat there with my spit still in my hand. 

**TL;DR**- I spit mucous on a girl and then ripped her shirt off on a field trip. ",TIFU and ripped a girl's shirt off,1381
LJ2003,160,212,18ifch,972,"...*sigh*. The title pretty much says it all, but Ill explain a bit.

Start the story realizing that I got up at 530am to get ready for work, and am still a little groggy from my Ambien I took the night before.  To top that off I had dental work done yesterday, so the first thing I did this morning was take some Vicodin (on an empty stomach) which was prescribed to me for pain.  I turned on the coffee pot, and the warmer plate up to high because, well, my fiancé likes his coffee to go into the thermos hot, dammit.

I think we can all see where this is going.

He wakes up, I pour the coffee into his thermos and there's just over a mugs worth in there.  I give him the mug and he sits down to drink it.  I go work on some dishes.  My OCD starts driving me up the wall knowing I've cleaned all the dishes in the kitchen, but that I can't rinse the coffee pot yet cause there's a sip or two of coffee left in there.  Assuming he has by now drank enough to be ""topped off,"" I bring the coffee pot to him and proceed to pour the coffee into his cup.  

Only it wasn't his cup, it was directly onto his testicles, only shielded by boxers.  Which don't make a good barrier from hot liquids.  :/.   Fiancé jumped up, checked them out and those suckers were scalded and red. :(. I officially suck.

Happy Valentine's Day, I suppose.

TL;DR :  TIFU by pouring obscenely hot coffee on my fiances nuts.  ",TIFU by burning my fiances testicles...,1184
lilninos2,210,313,1ee4aj,970,"Edit: [The baby bunny that I thought I saved]
 (http://imgur.com/lwn1RlJ)\

**Edit2: Adding the story**
""So I was cutting grass at work around the play structures when I see a baby rabbit running around on the ground. I quickly hop off my mower and chase after the little guy. I finally catch him and see a bus full of special needs kids pull up. The parents asked me to show the kids the little rabbit. After parading around with him I decide to put him near the tree I found him after I cut around it. I hop back on my mower and say to myself thankfully I didn't hit the guy.

*Crunch.* ""What the hell?"". Turn around to see the special needs kids next to the tree I just set him under mouths open in dismay. On the ground, said rabbit spinning in circles doing the twitch of death.

Drove off.""
","TIFU by running over a baby bunny on a mower, in front of a bunch of special needs kids.",1283
i010011010,105,342,1mfpds,973,"I have packages arriving this week, and could swear yesterday was Sunday when I checked the calendar.  

So despite going to bed at 0230+ and needing to wake up at 0700, I pulled myself out of bed this morning, dressed, packed, and waited for a bus that never arrived.  Irritated, I attempted to call the company and berate them for a no-show but I got an answering machine.

So I started walking to work.  I reached a middle school about a mile+1/2 away from home before I finally realized something was awry.  Where were the kids and vehicles?  Why were the streets so vacant?  Why haven't I seen one other pedestrian all morning?  Was today a holiday and I wasn't aware?

At least on the plus side I have all day to do whatever I want, and possibly even sleep tonight for a change.",TIFU. I was convinced today is Monday.,1315
deffsight,87,239,1cvr0z,970,"So I'm sitting at my desk at work minding my own business chewing on a plastic straw, which I do quite often while working just out of habit. I happened to bite off a piece of the straw, and while the small piece was still in my mouth I accidentally breathed in too hard effectively lodging the small piece of plastic into the back of my throat. I instantly start coughing with no luck of removing it, then almost immediately after my gag reflex begins to kick in. I start to panic at the thought of vomiting at my desk, so I get up to make a run for the bathroom. I make it no more than 5 steps and then begin to projectile vomit the burrito I had for lunch all over a nearby wall. Needless to say I'm a bit embarrassed; I'm now sitting at my desk deciding whether to fake sick or own up to my stupidity. ",TIFU: By chewing on a plastic straw.,1209
LeeCarvallo,76,351,1mdc8h,965,"Happened a few quarters ago, sorry I only discovered this place recently. I was in a Helping Relationship Psychology class where we were given a task to practice one on one relationships with people who had small and manageable problems. We were assigned to record our sessions so our professor could check on our responses and tell us how to better work on our methods. The file was a little large so I put the recording on a USB stick I got freshman year. I wiped it clear on my PC and checked to make sure that nothing was on it. I turned it in and thought little of it. 

I got called into her office the next week. I walked in pretty casually awaiting my feedback. She tells me to take a seat and goes: ""Well, first of all, your file didn't work (she tried to open it with itunes I think and the audio file wasn't compatible), but more importantly, I have to ask you something. Were you aware that your USB is named 'horse porn'? I'm not sure I want to open that file anyways, care to explain yourself?"" 

**SHIT**

Flashback to freshman year. I used the same USB stick to pass music and shows between my roommate and I. As it turns out, he changed the name of my USB stick on his Mac, which for whatever reason wasn't visible on PC. Although I took all the files off, the name remained until my professor stumble upon it expecting my assignment. 

Anyways I had the opportunity of explaining this to my professor as she laughed her ass of at how flustered I was and how many times I apologized. She also made me tell the story the next class, and that's what I am currently known for within my major as far as I know. 

Tl;dr, forgot to wipe USB stick name, handed my prof. what she thought was my horse porn collection",TIFU by giving my professor a USB drive containing 'horse porn',1316
Testudine94,219,254,1n0y6q,960,"I got an awesome new 150 gallon tank and decided I wanted to show it off to one of my Facebook acquaintances, James. We occasionally chat about snakes and turtles, so I figured he'd be interested in my new aquarium. 

After I got out of the shower I took a picture of the aquarium and sent it to James. 

I went back and looked at the picture to see if I could tell there were turtles swimming around, and that's when I noticed that my naked reflection in the aquarium glass was clearly visible. I just sent this guy I barley know a picture of my naked reflection... I was pretty embarrassed. Still am. But he never said anything about it, so I guess that's good.

Edit: I'm a girl  ",TIFU by accidentally sending a guy a picture of my new aquarium.,1214
ihearthaters,106,261,1dqp26,959,"I went to the chiropractor and after they are done popping your joints they hook up to these two electrode things on your lower back that shock you. The idea is to kind of half ass short circuit your nerve endings and also loosen and strengthen up the muscles. So you lay down they hook these things up. They ask you to tell them when its comfortable or not, the problem is though no matter how high you start it out at it, it doesn't feel like much 30 seconds later. So I was laying there and i got numb to it so I tried turning the thing up. There's two electrodes two knobs so I turn them both up. It seems like only one knob is controlling it, so im guessing I can only feel one of the electrodes so I turn them both up. 30 seconds later numb again so I do same thing. I do this 4 times until the point where the lights in the office are flickering my whole lower body is spasming and it feels like im gaining some sort of super power. 

30 seconds later I put them both on max. There is a curtain around me so they can't see what im doing. It's extremely intense but it also feels really good. All the meanwhile i hear slight yelps from person who is laying next to me, its an older woman and im thinking ""wow, your having problems with your little quarter turn? You should try this thing on the setting I have it on"" so the thing beeps after 10 minutes or so because apparently in 2013 we have yet to progress the alarm system on this machine and it sounds like an egg timer goes off. So the thing bings; my time is up. 

They pull back the curtain I see the older woman next to me her face is in complete agony she's complaining to the nurse about how the machine kept shocking her and getting more and more intense every 30 seconds. I immediately realize the second knob, the one I couldn't feel was going to her. I've been making this bitch next to me feel like she's in Guantanamo Bay. The nurse knows whats up because she's probably never in her life put the machine on FULL BLAST MOTHERFUCKER mode. She asks me if I was experiencing the same thing...I lie and tell her no..and now I have 6 or so more awkward sessions involving the nurse who thinks im a sadist torturing an old woman next to me.

**TLDR: I gave an old woman the shocker at the chiropractor's office.**",TIFU: At the chiropractor's office,1220
Engineer_Man,94,193,1l89fm,945,"So this happened today, I am not sure if I can live down the glare, but I will share with you my pain, and story. Also, for the record I was not arrested or charged.

My work often has me working around emergency services, and therefore emergency service vehicles and emergency service personnel. It just so happens for the past two weeks I have been in the midst of a Police vehicle service centre working with vehicles and electronics contained within.

Last week I was struck down with a cold and vomiting bug, probably a cousin of Norovirus, and spent many an hour not eating and feeling like I had to throw up every 30 minutes. This week however I have bounced back, and along with the energy and enthusiasm came my appetite. I have been relishing the ability to eat spicy food after a week of bland water a dry crackers, so I may have over eaten on some wonderful nachos and jalapenos last night for dinner, with smokey chipotle tabasco sauce.......mmmmm *drool*

So here I was working inside one of these vehicles, past the normal knock off time of most of the crew as I have extended access, headphones on listening to some wonderful glitch hop. I am working with my top half in the vehicle when I feel a rumble in my bowels. The sort of rumble where you know whatever is brewing is going to be worthy of recording and uploading to Soundcloud (if you are into that type of thing). So over the period of a few minutes I feel this enormous fart move its way through my intestines until it is primed ready to fire.

I am now bent over, working away set for main event when I feel a tickle in my ribs. Thinking nothing on it I continue working and bop along when I feel it is time to pull the pin and release this monster I had caged inside of me. The moment I straighten up slightly, cock my leg and release this enormous, gut wreneching, sphincter flapping monstrosity I look over my left shoulder to see a petite female officer in uniform bent over trying to get my attention by poking me in the ribs, her face, with a confused look on it, mere inches away from my rear end.

Time stopped, I am sure time stopped. It felt like a good 10 minutes passed where we both just stood there, staring at each other, eyes locked both knowing what happened. My lips are flapping trying to apologise. I am suppressing the urge to giggle when the smell hits. A weeks worth of intestinal fermentation being backed by last nights mexican delight smacks us both in the face at the same time.

It think I saw her vomit in her mouth a little before she ran off out of the building.

*tl;dr - Stanky mexican fart right into the face of a police officer, making her mouth vomit and run*",TIFU by farting in a female police officer's face.,1138
Quibbloboy,90,223,1d29cq,946,"So there's this chick in my Science class. Really nice, really funny, and she happens to be lesbian. This particular girl dropped her pencil and it rolled over to where I was sitting, so I bent down and picked it up and gave it to her good-naturedly.

She said in a joking voice, ""Thanks, homie!""

I tried to respond in kind but not recycle her word. For some reason, instead of using a different 'gangsta' word, my brain just spit out 'homie' again with a random vowel sound attached to the end. So naturally I blurted out, ""No prob, homo..ohhhh...girrrrlllll...^pal...^friend...^mrfff....""

I just kind of shrank to quieter and quieter volumes as I transitioned from one failed word to the next, and then just sat there quietly for a few minutes in open-mouthed awe at my incredulous idiocy.",TIFU by trying to be cool with a lesbian girl,1169
John_Barleycorn,298,270,17fe5g,939,"
 She knows I had a bad relationship more than 10 years ago that really soured me to relationships for several years.  I tried to explain to her that my love for my first girlfriend was crazy and emotional, but now that I had grown up and matured a lot, my love for her was calmer and less exciting, but much stronger and more permanent than what I had with my first love.  I spent AT LEAST 20 minutes explaining the bad things that happened in that relationship, and how much better my relationship with my current girlfriend was.

 Literally the only thing she took away from that conversation was ""so you loved your old girlfriend more than me?""  She has been repeating this over and over again all weekend, and now says that if I want to see someone else, it is fine with her, because I don't love her anyway.  I will never again attempt to explain my feelings to someone.  I'll just keep repeating what they want to hear.  

 ",TIFU by talking to my girlfriend about my feelings.,1209
Crankshaft69,290,119,105xys,931,"So my roommate's computer has been out of commission for a couple days and he asked if he could use my laptop to check his email about 10 minutes before class this morning. Of course I said yes and he checked his email as i was getting ready to leave. He told me he just put it to sleep when he was done. 

I get to class a couple minutes early and decide to check reddit before it starts. The class already had about 30 people there, and I sat a couple rows back from the front. I open it up and hit the power button and all of the sudden orgasm noises fill the room. Then I realize my roommate wasn't checking his email at all. He was looking up porn and turning the volume all the way up. I start frantically trying to put in my password to make it stop. Finally, after three tries, I get in and close the 3 different windows he had open, only to find that he also changed my background to two guys having anal sex. I slammed the lid closed as fast as i could and started looking around hoping no one noticed. Of course, every person in the room was looking at me. Some were laughing, and some were giving me the worst looks I've ever seen. For some reason I decided to stay in class and explain myself, and obviously, no one believed me. Needless to say my roommate got me good. This was probably the most embarrassing day of my life. 

Also if anyone has any good ideas on how to get him back let me know.

**TL;DR: I let my roommate use my laptop before I went to class and he looked up a bunch of porn, turned the volume all the way up, and changed my wallpaper to gay sex.**

**EDIT:** It took a while, but I got him back. I thought poking holes in his condoms was a good idea, but very very cruel. So I just pretended to instead. As it turns out, I knew his date from school so I asked her for some help. I told her what happened and she decided to play along. To be thorough, while he was at school today I went through and poked holes in all of his condoms, so he would believe me. Then I asked him what he thought about the holes I poked in all of his condoms to get him back. Of course he didn't notice any holes on Friday because there weren't any. However, when he checked today he found all of his condoms with holes in them. He freaked out for about a half hour. After apologizing profusely, I advised him that it might be a good idea to let his date know just in case. She then informed him that she was supposed to start her period yesterday, but sometimes it starts a day or two late, and she'd let him know. So I let him freak out for about another ten minutes and decided to tell him before it got out of hand. He's a good sport about it and we laughed just about as hard as we did when I got back from class last week. I'll have to be extra vigilant for a while because I expect another prank sometime soon haha. Hopefully the bar isn't set too high.",TIFU by letting my roommate use my laptop before class.,1050
sadtastic,141,264,1fl1kg,940,"I went to a Tex-Mex place down the street last night and ordered the nachos and a couple of drinks. The nachos had a liberal amount of sliced jalapenos among them. I was a little disappointed as they really weren't hot and had a more ""pickled"" flavor than anything. I asked for some hot sauce to make up for the weak flavor.

I ate most of it and took the rest home. Then I ate the leftovers for breakfast. At work I began to feel extremely tired, and then nauseous, and finally went to the bathroom to see if expunging whatever was brewing within my guts might make me feel better.

I proceeded to let loose a molten pile of fetid, discolored fudge and realized very soon thereafter that my butthole felt like it was on fire. Wiping only made it burn worse! It was as though some sadist were teasing my ringpiece with a blowtorch. I've felt afterburn from spicy foods before, but nothing like this.

Turns out those goddamned jalapenos were like a sleeper cell of spicy terrorists. They sneaked right past my tongue only to burn the everloving fuck out of my mud whistle.

TL/DR: Ate more jalapenos than my b-hole could handle.",TIFU by eating too many jalapenos.,1204
IApproveThisUsername,160,259,1fgrqq,930,"In my infinite wisdom, during my first drug test, I pissed in the toilet, and then decided to sort of ""scoop"" the piss-water mixture out. Not like I didnt know to pee in the cup, my brain just told me to do something else. Needless to say, I feel absolutely fucking retarded.",TIFU a simple drug test.,1189
technoe,439,521,18dlr4,933,"We've been together for a little more than 7 months and yesterday she was alone, all day at my house while I was at work. She was using my laptop for Facebook, email, etc. No big deal, until she starts deleting the history ""icons"" from Chrome's home page. She continues to do so until she sees this flaming dick with rainbows shooting out. Her curiosity got the best of her and so she opened /r/spacedicks for the first time ever. She slammed the lid shut so hard it cracked the LCD. The best part was once I got home. She proceeded to ask me if I was secretly gay or bi-sexual and that she found my history of ""rainbow dicks"" and ""bizarre fetishes"". After laughing hysterically, I had to explain /r/spacedicks. I took her straight to /r/awww for some eye-bleach and now all is good in the world again.  

TL;DR - Girlfriend found /r/spacedicks, asked me if I was gay, showed her /r/awww, now it's ok. :D

EDIT: This post made the front page and I don't know if I should be proud or terrified. 

EDIT 2: /r/spacedicks explanation... I basically said that is a dark place for obscure and obscene stuff but if you can get past the shock value ( and the flaming rainbow dicks) that there is some substance to it and you can learn something from time to time. ",TIFU by leaving my girlfriend alone with my laptop,1454
CharlesMonsoon420,122,378,1js2ep,929,"Fuck guys, this just happened.

It's just another day in the Monsoon household, I'm polishing the ol' pussy penetrator, porn's playing, everything is good. When I finally finish, it goes fucking everywhere, including all over my mouse and my keyboard. Fuck!

I'm so high that I forget about it while trying to find something to clean it up with, and go and get high (smoking after an orgasm is the best)

About 30 minutes later, I come back down into my room and all of the covers are taken off my bed. I see my computer 10 feet from where I left it, still crusted with man goo which by this time has dried into what looks like a cum filled puss-sac. The porn is STILL ON FULLSCREEN and of all things it's a closeup of an asshole.

However, something wasn't right. Everything was changed around and yet nobody was home... At least that's what I thought. It turns out my extremely religious, extremely old, EXTREMELY conservative cleaning lady happened to drop by today too!

tl;dr By the distributive property, I finished on a nun.

edit: Wow, over 200 upvotes, and someone put it on /r/bestoftldr! I'm flattered guys, thank you.

edit 2: Woke up to 644 net upvotes and a ton of awesome comments. Thanks again guys!!

edit 3: Shout out to the various math nerds who told me I ejaculated on a nun by the *transitive* property. Well that takes a load off my back! (Not off of my computer though, unfortunately)",TIFU by getting high and watching porn,1307
ella1993,260,387,17vta5,922,"[Original post here](http://www.reddit.com/r/tifu/comments/17pdc2/tifu_by_making_a_stupid_bet_with_a_guy_i_barely/). **TLDR**: I bet an acquaintance of mine that Ian McKellen had been on the TV show ""The West Wing"". I lost and now I have to clean his house in the nude.

***

People in the original thread seemed to fall into three camps:

1. People concerned for my safety and wanted me to back out of the bet.

2. People who felt I was leading Roger on and that I was being a huge bitch by doing so.

3. People who think I'm not very smart.

I appreciated most of the feedback and took it all into consideration. The first thing I decided to do was to *not only* let at least two trusted (and nearby) friends know where I was but also to ask them to text me every ten minutes or so while I was there. Both of these friends were male and both agreed that if I didn't reply within five minutes they would come over and rescue me. I won't go into the long arguments I had with each about how stupid I was for wanting to go through with it here; suffice to say that in the end they agreed to help me out.

As for Roger, I called him the night before and we spoke for quite awhile about the situation. I told him that I didn't want him to think I was agreeing to fulfill the bet because I had a secret crush on him or anything. I also warned him that if, at any point during the cleaning, he touched me or did anything else that I felt was inappropriate I would immediately leave. He assured me that he would be in his office almost the entire time anyway so that I'd basically be alone. As for the whole ""me leading him on"" thing? He just laughed and said he wouldn't date/get involved with anyone as young as me anyway but that he was flattered that I was so concerned with his emotions.

So that was my preparation. Here's what actually happened.

***

The drive there was the worst part to be honest. I have severe anxiety problems and at one point I felt a panic attack brewing so I had to pull over and do some breathing exercises. The main things going through my head were: *Are you really being as stupid as the people on reddit say? Are you going to end up raped and murdered? Is life really that cruel and I'm just too young to understand how dangerous everyone out there is? Will I die today?*. Thankfully I calmed myself down enough to begin thinking rationally again.

I arrived at his house at 9:00am Saturday morning. I had to start that early because I had no idea how long it would take me to clean his house. I'd checked it out on Google maps and knew it wasn't huge but for all I knew it'd be a pig-sty inside. Since I had to be at work at 4pm I wanted to give myself plenty of time to get the job done.

The first thing he did was offer me coffee. He was very friendly in a breaking-the-tension type of way. We joked about the bet and he offered me again the chance to back down. But even though I know most people don't understand it I'm proud of the fact that I've never welched on a bet. I wasn't going to start now. I told him that. So then he gave me the tour.

It was a small house: living room, kitchen, two bedrooms, one bathroom, and a basement. What really struck me, and made me feel more comfortable, was how incredibly tidy and well kept the place was. My fears of it being a disaster that would take me all day to clean were alleviated.

In each room he had left out the supplies I would need as well as a list of what needed to be done. None of the lists were very long. And while he showed me both his basement and his office (the second bedroom) he told me that neither needed any cleaning.

So then I got to work. And despite my fears to the contrary he didn't isnsist on watching me disrobe. After returning me to the kitchen he simply said ""Well, thanks! I'll be in my office."" That's where he left me.

That's when I undressed.

Since it was obvious that he wasn't making a huge deal out of this I was really tempted to keep on my underwear. But I ultimately decided that there would always be an asterisk next to this bet if I went half-way. Besides, with all the drapes in the house closed and Roger busy working in his office I practically felt alone. So I got completely naked and tied back my hair before getting to work.

I started with the dishes. That took a while because he didn't have a dishwasher (well, he had a space for one that was empty; he'd told me that he was waiting for a new one that he had ordered online after his previous one died). He had provided me with kitchen gloves so I used those as I worked on his backed-up pile of dirty plates, cups, bowls, pots, and pans.

It was halfway through doing the dishes that I called both of my friends to tell them to stop texting me so often. Having to take off the gloves and dry my hands to reply to them was really slowing me down. I assured them that I felt safe and that everything was cool. One of them told me he was going back to sleep, then, but the other insisted that I check in with him every thirty minutes. I agreed.

The first time Roger saw me naked was when the sink began to back up. I'd been shoving down enough leftover chunks of food down the drain that the water wasn't draining anymore. I couldn't tell if he had a grabage disposal or figure out how to turn it on if he did so I reluctantly went down the hall to his office door and knocked. He told me to enter and when I opened the door he did a complete double-take.

I was covering my breasts with one arm but other than that I was fully exposed. He said ""Wow you really did it!"" and I just ignored him. I told him about the situation with the sink and without looking at me he told me how to turn on the disposal. I went back to the kitchen, blushing like crazy but sort of giddy and disarmed by how embarrassed he had been, too. 

After finally finishing the dishes and cleaning the counter and sinks I got to sweeping and mopping. It should have been a quick job since the kitchen was so small but the empty space beneath the counter where the old dishwasher had been was really nasty. I had to use a scrub-brush and get on my hands and knees to really work at the stains. That's what gave Roger a great view of my ass, no doubt, as I didn't hear him enter the kitchen while I was busy scrubbing away like crazy at some kind of moldy black stuff that just didn't want to go away.

""Uh, you don't have to clean that,"" I heard him say. His voice made me freeze. I couldn't see him since I was half under the little alcove scrubbing like crazy but I knew what he could see. After a long pause I said, ""Really?""

I heard him open the refrigerator. ""No, those stains aren't going away and don't need to. The new washer will cover them once I install it.""

""Okay"" I said, still frozen in place.

""Uh, sorry. I just wanted to grab a water.""

After a long moment I heard his footsteps walking away, back down the hall toward his office. When I crawled back and stood up I was honestly aroused.

He had seen me like that. I've always felt it sort of erotic to show my body to people but I'm not exactly an exhibitionist. I don't go out of my way to do it though there have been some exceptions. The reason I've enjoyed it has always been b/c it makes me hot. But please understand that just because I was aroused does NOT mean that I was considering going down to his office and starting a porno scene with him. I just felt.. a bit excited. And a lot less anxious.

With the kitchen done I tackled the living room which took very little time. Just some dusting and vacuuming. It really didn't need anything else and that was all that was on the list anyway. So then I continued to vacuum down the hallway toward the master bedroom before deciding to get the bathroom out of the way.

That also didn't take very long. Some windex and comet, some scrubbing, and everything seemed clean. The bathtub took the longest but only because I decided to clean all the tiles around it even though that hadn't been on the list. People always clean the tub itself but never the walls and I hate how grimy that ends up looking!

After that I had one room left: the master bedroom. Truly there was nothing to be done there but what was on the list: make his king-sized bed and vacuum. It was a nice room, very clean already, and the only thing I had to do was throw a few sheets and pillowcases in his hamper. I didn't have to do any laundry; he doesn't even have a washer or dryer anyway (he sends his laundry out).

Here was the problem I had that led to him seeing me the most that day: I couldn't manage the new sheets. I just couldn't. The fitted sheets were obviously the right size for the mattress but try as I might, every time I got three corners secured one or two of them would snap out as I tried tugging the fourth into place. After ten minutes of trying I gave up and decided that I needed help.

Roger was a gentleman the entire time. I know he looked at me often while he helped me make his bed but he wasn't a creep or a jerk about it. He didn't leer or make any perverted comments. Hell, he mostly spoke about the Superbowl! Poor Roger: he told me he was a niners fan and he expected them to dominate the game.

Once the bed was made he went straight back to his office. I went to the kitchen and got dressed. Then I got back to his office and when he saw me dressed he clapped for me. He said he had been certain I wouldn't go through with the bet and was amazed that I had. I told him to please not tell anyone at the shop about it and he agreed.

And that's how it ended. He walked me to the door, thanked me profusely, and said he looked forward to seeing me at the coffee shop again. Once I was in my car I texted both my friends to let them know I was on my way home, safe and sound.

It's weird. I feel embarrassed by what I did but also proud. I overcame my anxiety and every time I do that I see it as a victory. Plus I can still honeslty say that I have never welched on a bet and that's important to me. It will help me bet less often, too, because like I said this wasn't the first time I've made a bet and lost. 

When I think back to all the comments people made in my original post, the people who called me an attention-whore or being fucked-up or being a ""tease"", I wonder if they're right. I suppose no matter what you do in life there will be critics and you just have to learn how to discern between those critics who are trying to help and those who are trying to hurt. All in all though I think the majority of the comments helped me make sure this situation had a happy ending (for me!). So I do appreicate the advice/suggestions/concerns. The haters can go on and keep hating.

I have no regrets. But I still wouldn't post this whole escapade with my *real* account. If that makes me a bad person well, then I am a bad person.

***

**TLDR**: I did it and it did not turn into an emotionally scarring disaster.",TIFUpdate: TIFU by making a stupid bet with a guy I barely know and now I have to clean his apartment in the nude.,1309
kingofvodka,116,200,1jy8y8,918,"So yesterday I was chatting to my friend on facebook. We hadn't met up in a while, so we made plans to go get lunch together at 12 the following day (today).

So 12 arrives, I'm at the meetup place, she's not there. So I decide to send her a text. But I made a typo.

I meant to send ""are we eating?"". Instead I send ""are we dating?""

Her: ""lol no""

Me: ""...why not?""

Her: ""Because you're my friend""

Me: ""What?""

Bear in mind I still didn't know what I sent. That came later. In my mind I'd turned up to our meet, asked what's up, and she outright laughed and told me she was blowing me off. It was really out of character for her, so I phoned her.

Before I could say anything, she launches into her friendzone speech about how I'm a great guy and everything, but she just doesn't see me that way. I was so confused; it took us like ten minutes to figure out that I'd made a typo.

This happened about an hour ago, and I don't know whether to laugh or cry at how awkward that was.",TIFU by trying to meet a friend for lunch,1118
tyin_kn0ts,178,327,1j7o87,921,"Okay, so a little background info: my sister is 14 and is a huge drama queen. She over exaggerates everything and always have. So, today was no different in my book. 

She came into my room about 1:00 this morning to talk. We (mostly I) spoke about our feelings towards my parents (divorced, he lives in NYC and she lives in TX, we live with her, he has decided to sue for custody) and emotional issues (she's constantly angry and I'm depressed). We talked for about two hours and then I started rambling and she wasn't responding, so I assumed she was listening and carried on talking. 

A few minutes later, I realized that she had a funny look on her face. I asked if she was okay and she couldn't respond. About half a minute later when she did, she told me she felt trapped in her body and like she couldn't move. Being the drama mama that she is, I decided she was joking, as she often does things like this. 

Twenty minutes later she still couldn't move. She rolled off of my bed on to the floor and laid there for a good fifteen minutes. I was making jokes at her, calling her an inchworm and such. 

""What's the hardest part about eating a vegetable?"" 
""Chewing?"" 
""The wheelchair."" 

Around ten minutes later, she starts twitching. Then she starts uncontrollably shaking (not seizing, I'm epileptic and would have noticed that instantly). At first I didn't know what to do, so I dragged her by her arms out of my room and ran and got my mom. 

We deliberated for about fifteen minutes before calling 911. Her shaking gradually got worse and she said she was so cold. The ambulance came and took us to the hospital. 

They took her through triage and whatnot, and when the doctor came in, she asked to perform a rectal exam. (This gave me a seizure, a Gelastic one, for anyone who cares.) So my mother and I stepped outside to let the doctor work. 

Apparently my sister had a very bad anxiety/panic attack stemming from a lack of sleep and stress. We just got back from the hospital. 


tl;dr: a doctor stuck her finger in my sister's poop chute because my rambling gave her an anxiety attack


EDIT: My father has decided not to follow through with the custody battle. Thanks for listening, reddit :) ",TIFU by not believing my sister,1248
Balmarog,111,183,14lzej,908,"So I recently got a new kitten, she is absolutely adorable, fuzzy, cuddly, likes to lick my nose, she's a fantastic cat. I love her to death already.

Well, our nightly ritual before going to sleep typically consists of her attacking my hand as I move it around under the covers. In the rare event her tiny claws penetrate the thick comforter it really doesn't hurt my hand. 

Last night happened to be a particularly warm night for the winter, so I only slept under a sheet as opposed to a comforter. Fast forward to this morning I'm awoken from my peaceful slumber to a sharp pain in my nether regions. I woke up to my kitten attacking my morning wood, and now have three small puncture wounds in my wing-wang. 

Edit: wordsmithing

Edit 2: Here is the little shit. No regrets. http://i.imgur.com/oqRNk.jpg",TIFU by teaching my kitten to attack things under the covers,1091
brownmike3,65,206,16veyx,910,"This actually happened a month or two ago but I was just informed today about the colossal goat fuck I caused this poor dude.  

I live across the street from a bar where I have become quite the regular along with some old timers from the subsidized housing building next door. Often referred to as the Delaney Crew (name of the building they live in)  These elderly gentlemen provide quite the comic relief and provide a pretty steady stream of perils of wisdom.  Every once in a while they will even attempt to wing-man for you, it never works but I suspect it's just a genius excuse to put their arm around an unsuspecting bar fly and rub their junk on them.  Often, they get shitfaced and end up needing a helping hand across the street, a task that I have somehow inherited, though I don't mind it. 

One day in particular, the Delaney boys are taking quite a bit of booze to the face as is customary when social security checks arrive. Most of the crew disperses aside from one new face, who was having a hard time forming words, thoughts and equilibrium.  I was amongst other friends when I noticed this guy fall straight backwards, off his bar stool and thumped his dome pretty hard on the hardwood floor.  As the unofficial keeper of the Codgers, I sprung from my chair and went to assist.  He seemed disoriented but overall okay.  I helped him to his feet and told my crew I would walk him across the street and would soon return.  The old man, who I will call Gordy, was appreciative but not much help in explaining to me what his apartment number was.  Typically I would just pour them into a lobby chair but Gordy was pretty tanked so I decided to take him all the way to his apartment.  I was able to discern that his unit number was 609 and found the door to be unlocked, helped him into his lazy boy, handed him a glass of water and showed myself out.  Back at the bar I got a free beer and life went on...  

Fast forward to today..  I see Gordy for the first time and walk up to say hi and see if he recalled me helping him.  Boy did her ever.  Gordy, confused at first, quickly turned angry and all pointy fingery in my chest.  Turns out Gordy does indeed live in unit 609, of another building two blocks away.  Fuck me right?!  Gordy angrily explains that some elderly lady awoke to him pissing in her kitchen.  She proceeded to assault him with a umbrella until law enforcement arrived and hauled him off to jail for a variety of charges.  Fuuuuck.. I think Gordy understands it was a well intentioned gesture gone bad but he remained pretty pissed. 

TLDR;  took a drunk grandpa to the wrong apartment, left him there to be assaulted and jailed  ","TIFU, and put a grandpa in jail",1116
IthoughtIcame,244,603,1c5wiq,914,"So yeah it actually didn't happen today but about 5 years ago. I was still a virgin and kind of frustrated about it. You know how it goes ""shit i'm still a virgin...""

So I was at this party and I heard that there was a girl which I heard she was pretty easy(Let's call her easy girl from now on). So for the rest of the evening I spent drinking, I went outside to smoke. There was easy girl. I was really fucked up, but I thought hey, let's try this! I took her apart to someones driveway. We began to kiss, started to go down on her. Everything went alright I even brought a condom! (well look at that!) I started fumbling around with my dick since I was drunk and never done it before.

We fucked for a while but then I decided since I couldn't feel anything, let's take the condom off! Great idea! Now I was so fucked up I couldn't come so I asked her if she maybe would give me a blowjob. She agreed and gave me a blowjob (here is where the fuck up comes) When I thought I came I actually peed in her fucking mouth, no shit. I thought I came but my prostate thought otherwise. 

She gargled a little bit and then spit it out...Never spoke to her since and sometimes when I see her mother, she gives me this weird look. I don't know if she knows...

TL;DR: Lost my virginity on someones driveway with a girl I didn't give a shit about and peed in her mouth. 
","TIFU Girl gave me head, I thought I came...I was wrong![Slightly NSFW?]",1517
elfa82,139,221,1jxto0,905,"I had just got out of the bath while my wife was in bed using the laptop.  As I walked to the cupboard to grab a towel, she whistled at me in a taunting cat call kind of way.  Since I was soaking wet, I decided that I was going to go and give her a big hug and get her wet.  As I half danced, half skipped across the floor, she realized what was about to happen.  At the last minute, she stuck her foot out to intercept me.

I tried to stop, but my momentum, the wood floor and my sopping wet feet decided otherwise.  I slid into the night stand, with both of my feet sliding underneath.  The top of my foot got a small cut, and I feel like I twisted my ankle.  Couple this with the fact that my upper body hit her foot and I feel backwards.  I landed on my wrist, with my elbow jabbing into my ribs.  My 6 yo son came bursting into the room to protect his mom and make sure she was okay.  Upon seeing my naked and writhing in pain on the floor, he decided to jump on me to teach me a lesson about teasing my wife.  He landed right on my spine and hurt my back.

Now I am laying in the other room, my ankle hurts, my wrist hurts, my ribs hurt and my back hurts.  My wife and son are still laughing at me from my bed.

TL;DR: Tried to soak my wife, ended up slipping, falling and bruising more than my ego.",TIFU by trying to bug my wife,1126
teamfailz,208,392,1c0uku,903,"So today I got home after school and try to do something new. I throw on a porn video and get all lubed up. But I saw something sitting on my desk today and thought
""what the hell, I'll do it."" I put some lotion on that sharpie and stuck it up there. It came out pretty shitty and it wasn't enjoyable. I washed up, cleaned up, and had this green fucking sharpie that smells like shit sitting in a sink. I have my mom and sister coming home in an hour and we have trash pickup daily so I couldn't put it in the trash can.

After 30 minutes I threw the sharpie in the apartment complex driveway. I go talk to my friend for 20 minutes and decide to get some ice cream. As I'm filling my bowl, I see a group of kids no older than 12 pick up my anus sharpie and start tossing it in the air.

I decided I needed to see more so I take my dog out and look to see 5-8 young kids playing **toss the sharpie outside**.

FML

TL;DR a group of 10 year golds play toss with my ass dildo
",TIFU: Poopie sharpie.,1295
DeuceActual,146,127,y5ozi,904,"I am (was?) a multimedia editor at an e-learning development company.

My boss is the manifestation of a fat, loathsome, jerk off.

I was running an hour late, because fuck, and may have been driving somewhat recklessly trying to get to work as fast as possible.

I cover the 30 mile trip in record time, somehow miraculously dodging every traffic jam, red light and speed trap on the way in.

Upon laying my eyes on the building parking lot, a sudden wave of relief washes over me, as I notice my boss hasn't arrived yet.

""Good."" I say to myself. ""He'll never know I was late."" I relax a little. I let my guard down. I cruise towards my parking space without a care in the world.

I take a moment to notice the morning mist off in the distance. I notice the sunshine dancing off the puddled remnants of the rainstorm the night before. I notice the birds flitting about the breezing trees...

I did not notice that my boss had parked his big ass vehicle in my parking space and was walking out of it when I tried to pull in, subsequently bouncing his tubby ass off of my front bumper, against the back of his SUV, from whence he ricocheted back onto the hood of my mid-sized car.

TIFU.",TIFU by running over my boss.,1031
[deleted],79,279,1gqv04,907,"I was feeling sexy this afternoon so about twenty minutes ago I sent my girlfriend a joke picture of me flexing with a t-shirt on with my wang hanging out of the bottom. This was the first time I've **EVER** sent her any form of naked picture. She texted me back in horror saying ""OMFG you're gonna die, (sister) opened the phone for me because I was driving."" Now half of her family has seen my penis. I'm still laughing about it.

*left a word out

**SUPER UN-INTENTIONAL FUCK UP**
I'm logged onto her account right now and didn't realize that I posted it on here. Oh well, she has a sense of humor... I hope.",TIFU by letting my girlfriend's sister see my penis.,1186
IMakeBadDecisions,159,313,1eiote,904,"We didn't have any lube or anything, so my wife says, go get the almond oil. I run out of the bedroom fully aroused just bobbing away. I reach in the cupboard and retrieve said almond oil. I run back in to the bedroom completely ready to get us all oiled up. I unscrew the cap so fast it flies off and I can't find it, no matter it's not that important. I turn over the bottle and get my hand full of said liquid and proceed to douse my wang with it. Not a full 3 seconds had passed and I immediately jump out of bed while saying, ""THIS IS WRONG, SOMETHINGS NOT RIGHT, THIS IS WRONG"" I run into the bathroom and start trying to rinse this devil formula off of me. It burned so bad!!! It was the worst pain my penis and balls have ever felt, they were on fire and turning red. My wife was on the floor cracking up trying to explain to me that I picked up the almond extract which is 47% alcohol and not the Coconut Oil which was of course oily and non alcoholic. I had to sleep with my genitals exposed to a fan all night. Learn from my mistake! LESSON TO ALL MEN, ALCOHOL ON YOUR GENITALS WILL BURN HOTTER THAN 15 SUNS!!

Edit: we were about to engage in butt cheek sex, as in just sliding back and forth between the cheeks","TIFU by putting Alcohol on my penis, for lube, for sex.",1217
penguinsalad,180,368,1ebf4s,898,"Yesterday afternoon, my mom told me that she needed my laptop tomorrow (today) morning to work because hers was broken. Later that night, I was watching porn. I usually open a lot of tabs of porn videos, and do other things while they buffer so I don't have to wait while I'm at it. So I finish up and close my laptop. So the next day (today), I wake up to my mom's thunderous roar. She was pissed off and yelling about how embarrassed she was and shit, so I demanded an explanation. She told she went to our urbanization's clubhouse with my laptop because our Internet signal fucked up. She wanted use the clubhouse's Internet wireless signal, but she couldn't join the network (because she sucks with technology), so she asked a group of strangers to help her out. So these people come and check my laptop and my mom notices these shit-load of tabs, and she clicks them. So there they are watching daddy's little girl taking a bbc, and Faye Reagan on all fours, and other jizz-filled and screaming orgasm high quality shit. So my mom tells them: ""Sorry, that's my son's,"" and they laugh at her. These people probably thought she was some fucked-up porn addicted public masturbator or some shit like that. I thought it was hilarious and she was pretty mad, but I could feel in her voice that she thought it was pretty funny, as well. She left my room, and although I was thinking how bad I fucked because my mom found my porn, I was thinking that there couldn't have been a better way for my mom to find my porn. Better than catching me with my pants down and fapping in my room; Outside, in front of random strangers, making her look like its hers, and me, far away. It was a pretty good unplanned prank, so I guess it's two-fold. It's a fuck up, but it isn't.

TL/DR - Left porn tabs opened. Mom opened them in front of random strangers.

EDIT: I forgot to close the tabs, I don't leave open porn tabs open.

EDIT: Some people are mad at me, but hey, chill. This is what TIFU is all about. I know I fucked up.",TIFU by making my mom look like a porn addict,1266
Alexi_Strife,177,240,1gd5nj,901,"So I thought I lived in a house of like minded people who all enjoyed the same shows, in jokes, etc. Well, turns out I was wrong. 

I brought home some hot and sour soup a few days ago from the take out place down the road and put it in our fridge. Mind you it was in a brown paper bag. Having just finished season 4, I thought it would be funny to write on my bag ""Dead Dove Do Not Eat"". 

I come home from work/etc two days later and there is a letter on the fridge. I'm apparently being kicked out for keeping dead animals in the fridge. They said they called animal control to remove the bag of dead bird (who didn't even open the bag? Really?) and then continued to go on about how I risked the health of everyone in the house and now the smell of ""death"" won't come out. 

I had to leave to run errands and will come back to talk to them later about it, but all I can think of is how I made a huge mistake. 

UPDATE: So I got home and confronted one of the roommates. While I do get along with all of them, one is known to be a tad bit over dramatic, and... well kind of a liar (we've had minor problems with her exaggerating things in the past). Turns out she never did call animal control, but thought it would be ok to say she did as well as speak on behalf of the two other tenants. I found my soup in the trash can outside, kind of invalidating her point. When asked about the smell she went on to say it ""must have been the power of suggestion"" and began to reprimand me for lying about it being a dead bird. The second roommate, is unreachable but I am going to guess she got the joke, and if not, I will send her the gif from the show. I'm going to talk to the person who owns the house about this, cause this is all just kinda over reacting a bit too much. I knew this person was gullible (as I gathered from her collection of fung shway books and hippie crystals) but I didn't think she was this bad. 

",TIFU by quoting Arrested Development,1141
Nuke-The-Whales,182,315,1kmr5t,897,"I awoke this morning to feel the guy I'm seeing pushing up behind me, indicating it was time for some morning sex. 

His A/C wasn't working, so it had become extremely stuffy and hot overnight. I decide to turn the fan on HIGH, and proceed to jump on top. Bad idea.

NSFW details aside, while on top of him I begin to feel uncomfortable as I go through the motions. I realize about half-way in that the fan blowing on high is blowing DIRECTLY onto where our body's intertwined. 

The combination of wetness, air and the up-and-down motion starts making a few sounds here and there. I shrug it off, and continue. At this point, I can REALLY feel the air being pumped up me, so I suggest we switch to doggy.

This is where I regret turning on that machine sent from the devil. He gets behind me, and the blowing air somehow makes me feel even worse from this position. 

Suddenly, what sounds like a massive trumpet note blares from my vagina. He keeps going, but I could tell he hesitated a second.

Now, being the class-act that I am, I find this noise absolutely hilarious. I try to hold in the laughter as he is about to finish. He pulls out, and I can hold it no longer -- I begin to laugh out loud.

With each incessant exhale of laughter from my mouth comes an equally loud exhale of air from my vagina. I laugh harder as the ""quieffs"" get louder and louder.

I kid you not when I say that I laughed for a solid 45 seconds straight while my vagina made uncontrollable, extremely loud farting sounds. 

This wouldn't have been so bad if I hadn't been the only one who found this amusing . . .

Cue the awkward tension as I try with all my might to stop the laughter and thus stop the morbid sounds escaping my vagina.

Needless to say, we finish up, and lay in utter awkward silence until I finally manage to say, ""well, I should head out.""

**TL/DR - Turned a fan on ""high"" during sex, air was pumped into my vagina, quieffed a few times, died of laughter, thus causing louder and uncontrollable noises to escape my vagina**",TIFU by turning on the fan during sex.,1212
soxfan17,82,308,1mkqdn,891,"Yesterday (wasn't today but close enough), I was sitting in my dorm room just doing some homework. Out of the corner of me I see a fucking mosquito that has probably been the one pissing me off at night so I had a rush of adrenaline. 

After a few attempts to clap it between my hands with little success, I wait for it to land on the wall. So, it lands on the wall and I slam it as hard as I can and for some reason I yelled, ""WELCOME TO AMERICA, BITCH!"" as I slammed it. No big deal right. Well, I forgot that an international student from China lives in the room next to me and the wall I slammed is the one between our rooms. I hope she doesn't think I'm too racist.

TLDR; killed a mosquito and sounded like an asshole.",TIFU by killing a mosquito,1199
MTgolfer30,149,254,1l3kxv,890,"This is a long one, so bear with me.

So this happened five years ago, but since I just found out about Reddit, I thought I'd explain what happened. If any of you lived in ABQ in 2008, you know what I'm talking about. I was living in Albuquerque for a short time, and was about to head back home to Montana the next morning. I decided to go out drinking with some friends, and since I didn't want to get a DUI, I parked my car a few blocks away from the downtown bar area. I thought it was an incredibly convenient place to park, because there were no parking meters and no ""No Parking"" signs whatsoever. So I meet up with some friends for a farewell bash and drink late into the night. The next morning I get a call from my mom at 7am telling me to call this agent from the FBI. Having just been woken up, I thought this was a joke, or I was still drunk. Probably a bit of both. So she said call this guy back, and when I got on the phone with him he asked if I had a Ford Escort wagon. I said yes, and he said ""you might wanna head down to your car as soon as possible."" Okay? I start walking from my friends house down to my car, and looked up and saw a ton of helicopters flying around. As soon as I turned a corner I saw roughly 40 police cars and police tape everywhere. I thought ""oh man...i really hope this isn't my fault!"" Well come to find out, it was. My car happened to be parked in front of an old federal building. Since I parked at night and there were no street signs, I assumed it was safe to park there. Since my car was packed with all my shit, they assumed there was a bomb in  my car. They busted out my back window with a bomb robot and threw all my shit I'd packed out on the street and sidewalk. News reporters and news helicopters were out in full force, trying to get me to comment. Anyways, long long story short, the FBI cleared me and sent me on my way. The ABQ police however, were incredibly pissed off I wasn't arrested. Oh, and the whole 1100 mile trip back was driven without a back window.

UPDATE: so here are a couple links with pictures of my car and some police tape.

http://alibi.com/blog/xy_800/Central-Shut-Down.html (A main street shut down....OOPS.)

http://alibi.com/blog/23657/Bomb-Scare-Fallout.html (Yep, that's me.)",TIFU by setting off a bomb scare in downtown Albuquerque.,1144
_namaste,197,242,1cs9lz,885,"[Here is a little illustrated photoset of the journey.](http://imgur.com/a/F8YqY#0)

This started a few days ago, but as it has finally come to a bursting end as of an hour ago, so I feel I am ready to share how I fucked up and got Cellulitis from lady-scaping. 

I like to keep my area well-managed. Unfortunately I have been buying really cheap, disposable razors to do so. I have never encountered many problems with this method in the past, because I take precautions beforehand and am sure to moisturize said area properly. I must have done something wrong this day.

About 30 minutes after my shower, I start to feel an uncomfortable sharp pain in my pubic region. I go to the bathroom to check it out, and sure enough, I have a small, red dot which I recognize as being an ingrown hair. ""NBD"", I tell myself. I'll use a hot compress. I figure that it will raise a bit and I can get it out using sterilized tools. WRONG. After messing around with it, I can tell that it's not going to budge. Being the obsessive popping type, I just couldn't leave it alone. I never thought a few extra moments spent trying to remove an ingrown hair would end this badly...

Fast forward two hours. Normally at this point, it would have just stayed as a small, only slightly uncomfortable dot, worked its way out naturally, dried up and been forgotten about. Unfortunately, the pain is still there, and it's now stinging and burning really, *really* bad. I thought it was probably just from all of my poking around, so I dismissed it, fell asleep on the couch (it was about 10pm), and into dreamland I went.

I wake up at 6am. I am dripping sweat, my entire abdomen is burning up. Something is not right here. After I get my bearings, I lift up my shirt and pull down my sweats slightly, only to see, terrifyingly, that the dot has now swollen into a massive lump, and there's bright, pink, hot skin all the way up to my belly button. It hurts like a bitch. My temperature is at 103. I am FREAKING out, so I drive to the med center and embarrassingly (and slightly dillusionally) explain my situation to the person at the desk, while families with crying, sick children pretend not to hear my misfortune.

When I finally got into the doctor, I shamefully strip down into the gown. She had this look of complete shock when she had me lift it up..I could have sworn the monstrosity was pulsating at this point. She informed me that I had contracted CELLULITIS from this god-forsaken ingrown hair. She said that I needed to promptly begin taking a high dosage of antibiotics and using steroid cream/ointment every few hours. She refused to lance it in the office, I do not know why, and suggested that I continued with a hot compress once I got home. I was also made aware that if I wouldn't have caught it within 24 hours, I literally could have died due to the toxicity of my blood.

KAY... So I spend the day pantless, crying, sweaty, feverish, with a hot washcloth resting on my crotch. Finally, in the evening, I start feeling some kind of stirring down there. It itches to an extreme measure, so without thinking, I reach down and try to sooth it. I immediately catch the corner of my fingernail on the thin part of the skin, or the ""top"" of the wound, (what now became the opening). IT EXPLODES. I have never felt such a mixture of relief and extraordinary pain at the same time. It felt like someone had released a million tons of pressure that was being held in my labia, while simultaneously rubbing hot ass peppers all over the open wound. 

Anyway, I'm okay now, just sulking on my bed and in pain, eating horse pills to make sure the infection is completely gone. Lesson 100% learned.

TL;DR: I shaved my pubes, was a dummy and tried to take care of an ingrown hair on my own, got an infection in my blood and almost died in a really embarrassing way.

*edited some misspelled words.",TIFU by shaving my pubes and getting Cellulitis. (Warning: Gross/NSFW),1127
Draygn,111,270,1qpx4x,883,"So I went to pick up a curry from my favourite Indian takeway this evening.

""That'll be £10 mate""

I give him 11.

""Have a good night pal""

""You too!""

""Bye!""

""I love you.""

God damn it. I can never go back there.",TIFU by telling an Indian bloke I love him.,1153
moonbutton,187,113,ued77,882,"I work as a waitress at my friends' family business, and I tend to bring in some wicked tips, but today I fucked up. How did I fuck up? I did not tie my shoes correctly and when I was parking at the restaurant one of the laces got stuck on the pedal and I stupidly tried to kick it off. That was when my truck crashed through the wall. Customers were sent running in every direction.

No one was hurt, but the restaurant is closed for the week while they make repairs. I'm not fired, but no tips until it is paid off.

**EDIT:** Because some questions and comments have come up more than others, I am going to address them in this short follow-up: when I broke through the wall, it was a wall that was mostly a window so all I really broke was some glass. The estimate for getting it fixed is pretty reasonable, and since I make minimum wage plus tips I offered to help pay for it as a measure of personal responsibility. Some people have mentioned a news reporting of this incident, but my little crash never went to the news, nor was it that explosive for the customers, so that report is just another unlucky restaurant.

Also, because I had not realized the stereotype when I first posted this, I am Asian, making my crash all the more hilarious.",TIFU an entire restaurant.,995
4giveMe4iHaveSinned,118,289,1lvqo7,885,"This didn't happen today, but just this past Sunday. Before going to church, I decided to have a quick, innocent fap. Fast forward a few hours, and church is over. I'm still in church at this point, and decide to check my phone. Turned it on, and since the porn video was the last thing I watched, it's the first thing I see when I ""un-standby"" my phone. I'm shocked that I didn't close the tab after I finished, but I'm thankful that the video didn't somehow automatically replay for everybody to hear, and now I can just close the tab and delete my history. Nobody saw, so I'm in the clear, right? Nope. I have a Galaxy S4, and the ""Close tab"" button is right beside the ""refresh"" button. I accidentally hit the ""refresh"", and before I knew it, the sound of this girl taking it is blasting through the church, full blast. Time to find a new church to go to.",TIFU by watching porn before church.,1174
thelovepirate,177,192,1c1xth,882,"This was about a month ago, but please don't hold that against me.    
     
    
      
I was alone in my girlfriend's home a couple weeks ago while she was off at work. I was rummaging through her bathroom drawers for some fingernail clippers when I came across her bottle of [Nair Hair Removal lotion](http://4.bp.blogspot.com/-lJrJQO2eGdc/Tkh9cIWw99I/AAAAAAAAB08/FzEPQAdyDsM/s1600/nair-neat-hair-removal-vintage-retro.jpg).     
      
I was curious, so I went for it. I applied a fuckload of Nair all over my junk, my balls and pubes were completely coated in the stuff. And for good measure, I made sure to get it in my asshole to get the hair out of there too. I had been meaning to groom down there for some time, and my pubes were starting to get pretty unruly.     
       
I knew the basics of how Nair worked. Lather it on there. Wait. Wipe it off. No need to look at silly directions, right?        
       
I just assumed the longer and thicker your hair was, the longer the Nair would need to take. So I sat there, butt naked on my girlfriend's toilet. I brought my laptop in with me. I watched an episode of Adventure Time. I could smell the hair starting to burn, but I just assumed that was supposed to happen, since it is a cream that melts your hair off.     
      
I watched another episode of Adventure Time. Then another. Then another.     
      
By that time, my nether regions were really starting to sting, so I assumed we were getting towards the end of the Nair Process.     
       
I watched one more episode.     
       
I sat there for five episodes of Adventure Time, almost a whole hour with Nair lathered all over my junk.       
      
It was now really starting to hurt.     
     
I wet a towel with warm water and wiped it across my skin.     
       
What happened next was possibly the most excruciating pain I think I've ever felt in my life.      
      
I saw red for a second and fell off the toilet, onto the floor. I looked at the towel. I shouldn't have looked. What I saw was a giant smear of hair, skin, and blood.    
     
It hurt so fucking bad, and the worst part was there really was not time to grieve, because I knew that I needed to get the rest of the Nair off of my skin before it got even worse, so I tried to dab the towel ever so lightly on my bleeding junk. It hurt just as bad.    
      
In agony, I limped into the shower. I thought, maybe if I turn the shower on a really soft setting with cold water.     
      
That didn't fucking work. Each drop on my skin felt like daggers, but I had no other choice. I laid in the shower on my back with my legs above my head, so my asshole and dick could get all the water.      
       
I cried. I cried the whole time. I was literally laying on my back while hair, skin, and blood melted off of me.      
        
I eventually got the strength to get out of the shower and lie on the floor of the bathroom. I laid there with my eyes closed for what felt like forever. Eventually my nether regions started to blister and puss. I knew at that point I had fucked up big time.     
      
I called my GF, told her what happened. At first she laughed, but I told her she needed to take me to a doctor immediately. When she saw the damage, she wasn't laughing anymore.     
       
She took me to a ready clinic, while I laid in the backseat with a towel gingerly wrapped around my body. We got to the Clinic, and after the most awkward and painful doctor's visit of my life, they put some sort of healing cream type thing on me, which stung at first but eventually made the pain go away, and wrapped me up, like a baby wearing a fucking diaper.      
          
       

**tl:dr: I used nair and got second degree chemical burns all over my nether regions.**",TIFU by melting my skin off.,1074
Sexy_Beast_2000,93,224,1awfyp,887,"This happened about a month ago on a really hot day in Australia. The temperature was about a little above 40 degrees Celsius and I was damn thirsty. I went into the kitchen, grabbed a glass from the cupboard and filled it with ice cold water. Nothing could go wrong at this point and i was feeling good from the drinking that ice cold water. Because it was hot i decided to hold the cold glass up to my forehead, cooling myself down. I was walking around the house for a bit with a glass stupidly held to my head for ten minutes. I walked through the hall about to get another drink, little did i know my dog was sleeping in the hall. I tripped over my dog and smashed the glass and my head on the ground. I ended up with 30 stitches on my face and 10 on my hands. I fucked up Reddit.

Edit: Hey guys looking for pictures of my accident on my computer. Ill get them up ASAP",TIFU by drinking a glass of water on a hot day.,1111
SemenInMyEyeOhWhy,164,319,1qa17c,878,"So I was just stroking the ol' sausage today when in a horny stupor I decided to find out what it felt like to cum on my face.  I figured if so many pornstars do it then it couldn't be that bad right? WRONG.  It got all over my eyes and burned like a motherfucker.  Now my eyes are red, hurt like hell, and my eyelashes are encrusted with semen.  Every time I blink I feel the throbbing shame.  Never again.

TL;DR My eyes might be pregnant.  Will report back in 9 months.


Edit: Wow, a lot of people know how it feels apparently.  My eyes are back to normal now for anyone concerned.  But the shame is still there.  It will always be there.",TIFU by getting my own semen in my eyes.,1197
jarizzle151,204,182,1cxg5a,873,"So for some time now, I've been working with a few coworkers and we like to play little games with each other.  Turing the desktop upside down, reconfiguring office furniture, you know, trivial office humor.  So I decide that on April Fools, I'm going to get an Eviltron and place it inside my coworkers printer.  She had to be at work at 3am so I know she would be out of it and the noises would scare her.  They didn't.  Instead she handed it back to me saying 'nice try.'

Fast forward to last weekend. One of our old co-workers from the building came in for some IT work.  She has always been a little pushy with me in a fun way so I decided to play a little prank on her.  She is a mid-twenties single mother of 2.  She left to use the bathroom and I slid the Eviltron into her laptop bag.  Thought nothing about it the entire weekend until I showed up to work yesterday and was blindsided by the events that transpired that Friday night.

Apparently, the device went off when she came back from the bathroom but my in-office co-worker realized I had put it in there and was playing along with the gag.  The ex-coworker which I will call ""Lisa"" asked if she hear a little girl laughing.  My buddy who was obviously in on the gag now played along and said 'no.'

Fast forward to Friday night.  Lisa puts her kids to bed and throws her laptop bag under her bed.  The Eviltron is still active and from what she told me said 'Can you hear me?' and it startled her.  Having a burgulary happen a few months before, she was on edge.  I did not know this event had occured.  Next, Lisa says she heard what she thought was a door opening and she immediately grabbed her kids and all ran into the bathroom where she locked the door and called the police.  The kids are crying and Lisa is visibly shaken when the police get there and she points them to the direction of the noises.  They eventually find the device and she is utterly embarrased.

I came into work and my coworkers told me the happenings.  And now I feel like a giant douche in the middle of a turd sandwich.  She is really pissed at me and I'm sure she's going to get me back some how.",TIFU by hiding an Eviltron in my co-workers laptop bag.,1055
TitusAndroidicus,285,116,tqk4m,867,"I was doing some homework today. One of things my psychology professor wanted was a link to a specific psychology experiment. I found one, copied it, and before I could send the email... my boner hijacked my brain and convinced me to fap instead of finish the email. Found a good fap link, copy+paste into browser, successful fap session. During my post-ejaculatory mental fog, I pasted it into the email and sent it before I even realized what the hell I had done. I... I think I have no choice but to drop out now. I can't show my face in that class ever again. I mean, it was filthy porn too. I'm fucked.

**EDIT:** For science, here's the link I sent her:
http://www.xvideos.com/video38930/big_tit_bubble_butt_interracial_fuck

God help me.",TIFU: Emailed a porn link to my professor,983
WeaselScout,158,307,1hd5rv,874,"(DISCLAIMER) [this happened to a friend, not me. I am writing it in his perspective]

I saw these condoms at the store that numb your penis to make you last longer. Because I was hanging out with my girlfriend later I decided to get them. Once my girlfriend and I started making it nasty, I instantly knew it was going to be a while. The condom worked because I was going for a very long time, but I was going too long. Her mom was going to be home soon so I just took the condom off and she gave me a blowjob until I finished. What I didn't realize was that the numbing substance was still on my dick, and it made my girlfriends mouth numb. It was like she just got a shot of novacane at the dentist. She couldn't eat, drink, or even speak properly and the worst part was that her mom was coming home any minute. We are 17 and her mother had no idea that her daughter and I engaged in any sexual activity. When her mom got home she saw her daughters mouth like that and since she couldn't speak I had to tell her mother what happened.

TL;DNR: girlfriend gave me a blowjob after I used a numbing condom and it made her mouth completely numb.",TIFU by using a numbing condom.,1181
tifuthrowawayy,144,272,1bdtf7,867,"So I made a throwaway for this story because it's humiliating as fuck.

So I'm nearing the end of my shift, I work at a restaurant chain such as Friendly's, and i'm sweeping and mopping the floor. Throughout the day I've been cutting little farts here and there because it happens. But anyway, I'm mopping the floor, I'm in my power stance mopping the shit out of it, and it happens. This corn induced chemical air bomb eviscerates my asshole, silently but more than deadly. I smell it and about vomit. No one is around, but go fucking figure here comes my manager. He stops, sniffs, says ""do you smell corn or something?"" To which I reply, ""I don't know, maybe one of the cooks were making something?"" He looks at me, ""did you, shit yourself?"" My response, ""In all honesty I may have.""

I go check, and sure enough I've left a strip of corn paste in my bloomers. I'm embarrassed as hell, so I try to start wiping it out of my boxers with a paper towel, but to no prevail. It just smeared it around. I walk out, staring at everyone, they don't know but I do. I go to my manager, trying to avoid catching the noses of passerby. I tell him I'm done and want to leave, he surprisingly lets me, I get into my car, feel it smush around more, and fly home to where I can change and cry. ",tifu by mopping the floor at work.,1139
Besessenes,232,365,1ib0ra,861,"Yesterday me and a friend were drinking, for it was saturday, and we´re young and...bored. Whatever the reason was, he had some weed there as well and we decided to smoke some of it, too.

This combination fucked me up pretty badly and i stumbled over a wire and hit my head real bad (at least i guess) but didn´ feel pain at all.

My friend has the great idea maybe I don´t feel pain AT ALL in that state. So we start pinching and slightly hitting me, felt almost nothing.


I go to bed still terribly wasted, and remeber a cut from a week before, and how bad it hurted.

So I eventually grab a razoblade, and start with a little cut on my thighs, to ""see"" if it´s painful. Nope.
(I can´t wrap my head around why I thought that was a good idea to begin with...) 
So i cut the word ""hi"" in my leg. Not really painful.

I don´t remember exactly what happened next, but today i woke up to  different versions of ""hi""´s and other words cut into my thighs. And blood. 

Not really deep cuts...but..shit, IFU. Hurts like hell now, looks like crap, and i have to wear long jeans in summer for weeks now ´cause I don´t want people to think I´m some kind of self-harming person. 

Tl;dr Carved words on myself while wasted, look like something out of a horror movie now.



Edit: I uploaded pics. They´re not as gory as you all may expect, but hey, at least kinda proof. Enjoy my dumbness. Aaaand they´re made with my phone, for I don´t own a camera. So please don´t start whining about that, too. 

http://imgur.com/a/TvkXk",TIFU by getting so wasted i carved words in my leg and forgot about it.,1226
themeowzart,188,359,1hyz7g,862,"Today started out as a wonderful day--the girl I like (who looks like a Victoria's Secret model so that's what I'm going to call her) was managing at work, and our shifts ended at the same time. The whole day went well. She had been talking about wanting to see Despicable Me, and there was a movie theater about 5 minutes away with a showing right after our shifts. I asked if Victoria's Secret Model wanted to go. She said yes. +10 Ego.

Fast forward to the end of our shift. We're outside the movie theater waiting for the people we're meeting. Victoria's Secret Model changes her shirt in her car so I get to see her in her bra. That was not relevant to the story--it was just awesome. Go in to buy our tickets. My debit card gets declined and I reach into my wallet, red-faced, to pull out the last $8 I have until pay day on Friday. -5 Ego. Had I not bought her coffee this morning, it wouldn't have been so embarrassing. But I'm a chivalrous fuck.

Victoria's Secret Model picks our seats at the very top of the theater stairs. Movie starts. Occasional funny comments from me earn her laughter. +10 Ego. Being that we rushed from work to the theater, I didn't have a chance to piss before the movie started. I made an effort to hold it in as long as I could, but eventually I couldn't ignore it. Not wanting to end up on TIFU by wetting myself, I excused myself to the bathroom. 

Now I'm about as graceful and balanced as a sleep deprived and possibly intoxicated walrus--I can stand absolutely still and find myself start to sway--so I focus extra hard not to make an ass out of myself in front of VSM. My shoes could not control their ridiculous attraction to each other, and I fell to my knees after 3 steps. -5 Ego. I hear VSM cry out, ""Oh, themeowzart!"" I laugh a bit to try and project an air of not giving a fuckedness. Get to my feet. Think to myself *hey, themeowzart, you should totally save face by doing some cool little hoppy things down the rest of these stairs and show VSM how these floor protrusions are your bitch. You can't possibly fuck this up again!*

Oh how ~~wrong~~ completely fucking beyond mistaken I was. The steps were odd (3 small steps and then 1 big step), and I somehow started running but couldn't stop. Thank god for that seat near the bottom of the stairs, catching my knee and sending me ass over ankles down in front of the whole audience. -20 Ego. ~~Like a pro, I regained my composure, gave a bow with a grin, and calmly exited the theater to applause~~ Nope--I ran, limping, like a handicapped mule out to the bathroom while the crowd snickered and whispered after me.

**TL;DR Fell for a girl.**

Edit: Because there was some confusion, I am a girl as well. Yes, she is bisexual. She probably knows how I feel, but it's never been explicitly stated. 

Update 1: Texted her after the movie. She said she had a lot of fun hanging out with me, and would like to do it again sometime. She will, however, make sure everyone at work knows about The Fall.",TIFU by eating it in front of the girl I like--and a movie theater full of people.,1221
indubitabl,176,256,1astgf,857,"So today I was visiting family because it's my aunt's birthday. My grandmother asks what I am always doing on my phone because I was reading it and laughing earlier. So I break out my laptop ( because I have later classes so I was going to class right after ) and as it starts up i'm trying to describe reddit to them. Anyways it boots up and I open chrome to type in reddit, at this point i'm typing as fast as I usually do and I press enter after the first the letters ""RED"". Because it's always the first thing to come up but instead redtube came up. My eighty year old grandmother gasped she was one of the most innocent people I know and I think she might have died inside a little. She started to actually cry so they just asked me to leave.


TLDR: Tried to show reddit to family popped my grandmothers porn cherry instead.",TIFU by trying to show my grandmother reddit,1113
sabertooth66,121,150,uanpi,857,"I got let out of work early today so decided to get a haircut. Luckily the woman who has been cutting my hair for two years was  there. She offered to wash my hair which I knew might knock me out, but it's my favorite part of a haircut. 

Sure enough I fell asleep just long enough to accidentally let out an awful fart. Eating McDonald's for breakfast AND lunch is an unkind thing to do to your stomach. I woke up in time to see my hairdresser holding a hand over her mouth and gagging loudly. I still had no idea what was happening. But then I smelled it and knew what had happened. Within seconds she had puked all over the floor. The other woman working in the store came over to help her out but also started gagging at the sight of puke. They both went into the back room to gather themselves. I left her a tip for washing my hair and slipped out of the building as quickly as I could. 

My hair was still wet, and I still need a haircut. 

",TIFU. Fell asleep during a haircut and let out a terrible fart. Chaos ensued. ,1007
dvboy,182,257,1htcbt,855,"Came with some delightful malware hijacking my browsers to findwide.com. Still not fully clean, but working on it. Hopefully there is not more under the covers. Beware folks.",TIFU by downloading Open Office from openoffice.us.com instead of from www.openoffice.org,1112
jdmf87,61,179,yils0,851,"[Original post](http://www.reddit.com/r/tifu/comments/y7ilh/tifu_by_mentioning_i_wanted_to_go_back_to_school/).

TL;DR for that post/comments: I mentioned in passing I was looking at grad school options to move out of my current field and into accounting; Boss thought I was planning on going to school *this year* as in starting next month. I called the office on my day off a week ago and asked her if I could start doing more training in accounting and cost management to get some hands-on experience before I go back to school. She said she wasn't going to be giving me any more training and wanted me to train other workers on my specific job tasks since I wasn't going to be with the company much longer. Ya know, generally losing her shit. Since she had brought me into the company, I guess she felt that it reflected badly on her. End TL;DR. 


So after reading Reddit's comments and discussing with my elders in other fields, I decided to go in and talk with my boss and put her fears to rest. She and I were supposed to have a meeting Friday, but she completely skipped out on it. Not looking good. Saturday morning I get a text apologizing for missing the meeting and offering me breakfast at her expense. Free food, fuck yeah. 


I meet her at a breakfast place close to my apartment, we chat and catch up for a while, since we've known each other for about three years now, and then she starts asking me veiled questions about my schooling. I told her, point blank, that she and I had misunderstood one another, that I was looking at schooling options several years out and there's no way I could meet the deadlines for Fall 2013 admission and that I was looking at Fall 2014 at the earliest to start grad school. That calmed her down a bit. We started discussing work and I find out that, when I said I wanted to leave my current field and get into accounting and cost management, she thought I meant the industry as a whole, not just my specific field, and that I was planning on quitting my job as soon as possible. I assured her that she had misunderstood and I just wanted to change fields, not industries. That calmed her down significantly. 


More chatting, more coffee, and she mentions that her boss (the big boss) heard about me wanting to move into cost management (her specific field) and eventually wanting to move to our company's head office in DC. Guess I caused quite a stir in the management offices. Anyway, Big Boss wants me to start coming in one-to-two days a week to start shadowing her so I can learn accounting from her. So now I'll be doing my current job three or four days a week and the other one or two I'll be shadowing and getting hands-on experience from someone with 20+ years of experience in the field I want to study. 


Today, I didn't fuck up. ",TIFUpdate: I'm the guy who told his boss I'm going back to school,1030
Wilfie_Cross,144,188,1f6u5e,854,"I'd never attempted this before, but proceeded (with great care), with the only razor in the house at the time - Dad's face one, but he was never going to find out. The fuck up wasn't in the the shaving itself - everything went smoothly, and I then went off to school. 

BUT - I later got a call from my Mum, yelling down the phone 'WHAT DID YOU SHAVE THIS MORNING, THE DRAINS ARE COMPLETELY BLOCKED!'. So I was like 'Umm, my face'. She didn't buy this, so I hung up. 

I later went home to find my Dad, the voice of reason - 'I'd rather you hadn't used my face razor, but it must have been his legs, go on son, show your Mum your shaved legs'. Shit. So I pull up my trouser leg to reveal my hairy legs - my parents look shocked. 'I shaved my balls, I'm really sorry'. 

A shit storm of anger proceeded - 'WITH MY RAZOR!' 'ALL THAT HAIR CAME FROM YOU BOLLOCKS!?' 'DID YOUR GIRLFRIENT ASK FOR THIS?!' 'GO AND CLEAR IT'

I spent the next couple of hours picking my pubes out of the blocked drain. And my Dad brings it up frequently around my friends and family. And I owe him a new razor. 

tl:dr: Shaved balls with Dad's razor, blocked the drains, had to confess, pick out my pubes, and Dad told everyone. ",TIFU by shaving my balls in the shower,1042
TheWierdSide,322,408,1g1cy3,848,"An hour ago i put on some amazing amateur porn i found on the interwebs and while waiting for it to buffer, i decided to work myself up really hard by edging myself on some GW posts.

The video took almost an hour to buffer(fuck you, internet) and by that time i was ready to fucking explode.

I'm laying down on my back and jerking it while looking at the laptop screen on my left, I hold off until a really good scene in the video(further edging myself) and grab the tissue box in preparation.

Only....there were only two tissues left in the box.....i think ""Fuck it that'll do"" and proceeded to hold the tissue in front of my dick to catch the sperm.

I proceeded to have the best hand-fap of my life and the feeling was so intense that i opened my mouth and moaned like a sex-crazed monk. Right at this moment my sperm shoots out of my dick, tears the tissue in half and lands **INSIDE MY MOUTH.**

Stunned....i just swallowed...


**TL;DR** swallowed my own cum.

**EDIT:** [This is the porn i was watching](http://www.xvideos.com/video4510324/cute_amateur_teen_couple_homemade_creampie_zuzinka#_tabComments) **{OBVIOUSLY NSFW}**","TIFU. I'm sure this has happened to someone else, right? RIGHT??!?!.",1256
Ohfuckitstuck255,297,313,1h5lv8,843,"Before I begin, know that I am a teenage girl.

The catastrophe took place this morning while I was masturbating. 
There I was, on the soft, carpeted floor of my bedroom, mid-fap (schlick?). Reclining comfortably next to me was a golf ball sized wiffle ball, white and hollow. 
So I was several minutes into my sesh and was coming up to my orgasm when I thought, *""Oh hey. Let me find something to put in there to make it interesting.""* So I preceded to shove the foreign object into my vag. 
Soon after, I finished the job and was ready to take out the toy and **OH SHIT. THE DAMN THING WON'T COME OUT.** 
I tried and tried to wrap my fingers around it to pull all to no avail! I truly expected the lube made in my gennies would suffice for removing the ball, but oh, was I wrong. 
There I was, no pants, imagining a panicked call to my mother about something stuck in my cunt. 
In an attempt to get it, I grabbed the first thing I saw which was a pair of rusty pliers that I had been using yesterday to remove staples from my wall but upon entry, quickly realized that I couldn't see what I was doing and repeatedly pinched myself.
Finally, I realized that I needed to hook one of the holes so I grabbed a paper clip from my desk, bent it with the pliers and went fishing. 
I hooked the little devil after a few attempts and gave it a tug.

TL;DR Stuck a toy in my cunt, regretted it greatly

EDIT: here's the culprit and hook 
http://i.imgur.com/zKN5sIS.jpg",TIFU by getting a wiffle ball stuck in my vagina,1156
worriedaboutroommate,197,145,11zrdc,845,"So [from this post](http://www.reddit.com/r/tifu/comments/11xmu9/tifu_and_almost_kissed_my_roommate_but_pussied_out/) I saw everyone said to just go for it. It's a complicated living situation, hence my resistance, but since the near-kiss I've felt regret, rather than feeling like dodging a bullet. 

I saw [this video and it pretty much sums up our relationship](http://www.cracked.com/quick-fixes/biggest-red-flag-in-history-relationships/). Not naked baths, but we're one of those friends who are weirdly close. Like cuddle, sleep in same bed, hold hands, that sort of thing. Other chick are definitely bothered by it. Call me friendzoned or a pussy all you want. I already know this.

I got home from work and internetted while she made dinner, and showed her that video. She laughed, and said something like ""That's so like us."" I broke out some wine, and we went from laughing about the video to talking about our relationship. I know, not the sexiest move. But important.

Essentially our talk was along the lines of ""why haven't we?"" rather than ""will we?"". It came down to the complication of our living situation- it isn't as easy as just-move-out-when-the-lease-is-up. It was a very long conversation, so I can't recap all of it, but it covered a lot of issues- both of our relationship issues, our family issues, our living situation, our friendship- we talked all the way through dinner, and ended up talking on the couch. She was curled up in a corner of the couch, and my arm was behind her on the back of the couch. We finally started to talk about our feelings for each other. She was shy about it, so I took the initiative and told her how I felt about her, and gently stroked her cheek while I did. She told me she had feelings for me too, strong ones. I asked her if she thought our feelings were strong enough for us to take a shot. She tried to get me to answer, but I insisted that she go first, all the while I was leaning in closer and closer. Our faces were getting closer and closer, and she was doing the doe-eyes again. I felt like a slick motherfucker.

The second she said ""yes"" I closed the gap and kissed her. We made out on the couch for a while (kissing is so awesome) and she let me go as far as feeling her up under her shirt. When I tried to go downtown she stopped me and told me she didn't want to rush anything, so I nodded and kept kissing her. We made out more, then cuddled a little, and eventually she decided she was going to go to bed. I joked if she wanted me to join her, but she laughed me off. She gave me a goodnight kiss and went off to bed. 

Still masturbating alone tonight, but masturbating with hope rather than regret.",TIFUpdate: I almost kissed my roommate,990
AmericanGeezus,119,238,1oc5aj,839,"I am a full-service marketing 'consultant' for small businesses. I do everything from determining what sorts of advertising my clients need to the pixel services to make those advertisements. Today I discovered that I only halfassed my file backup system. My main drive failed today, not sure why its failed its not a concern right now. When I plopped in a new drive to re-install windows with I selected my backup drive instead, I don't know how I managed to not realize what drive I was selecting but I fucked up. All project files for the last 4 years ontop of all raw camera files since 2007 are gone. No way I can rebuilt all of the project files for my current clients before print deadlines. At least I keep all the financial stuff kept in google docs. =\


Update 8 hours later: WELL Zoids New Century Zero IS INTACT! Also, 95% of my photos are recovered. Fun fact .ai and .pdf are pretty much interchangeable in some cases but still cant seem to recover the bulk of my design files. Time to take another aderall and start to organize what was recovered i guess. Thanks for all the advice chaps.",TIFU by destroying my business with a single misclick.,1077
I_Blue_The_Doctor,99,231,1j3g7j,839,"So my family is having a big reunion this weekend and my mom wanted a specific kind of mosquito repellent that she could only find on Amazon.  Since I have Amazon Prime, I said I would 2-day ship it to her house so that it could be there in time for the festivities.

Also, last fall, my now ex-girlfriend was moving to a different city for work while I finished up my masters.  In order to make the distances more bearable, we decided to order something to make the experience more enjoyable.  Since the company making this was a startup, they were plagued with manufacturing and logistical delays that many startups are, leading them to continuously push back the expected ship date.  Since I am moving soon and had no idea when they would ship, I changed my address to my parents address to assure that I would be able to still get them, should I have moved before they arrived.

This morning my mom receives a box labeled to me from FedEx and obviously assumes that it was the mosquito repellent that I had shipped to her, so she opens it without a second thought only to find various sex toys for both male and female intended for her (now single) son.

TL;DR:  Mom was expected package for her, addressed to me -- got a packed addressed to me, opened it - dildos.

(also, they were the Hera and Zeus set from Love Palz)",TIFU by sending my mom sex toys,1070
Ocarina_Of_Lime,197,395,1ptk8f,837,"So I'm in the Army, and today after a very long week full of typical bullshit (don't get me wrong, I love my job but it has its shitty parts), I decided to go see Ender's Game at the on-post movie theater.

Now, at theaters on Army bases the National Anthem typically plays before the film during which everyone stands and salutes if in uniform.

Being tired from this week, and having showed up about 20 minutes early I happened to fall asleep. Lucky me, I was woken up in time for the movie...by my company commander who happened to be a row in front of me, during the middle of the Anthem. Right as I was snoring like a motherfucker.

Cue everyone staring at me. Oops.",TIFU by disrespecting the US in a theater full of servicemen.,1232
ararararararagi,93,189,1mq947,836,"Around one year ago I was looking for work in the sound engineering/music area, so I decided it would be a good idea to register a domain name with my full name to make myself look more professional to employers. So I go ahead and register with uk2.net, ""myfullname.com"".

It gets a little technical here, but is relevant to the fuckup.

The thing is that I already had my own hosting, with a VPS provider. I pointed the domain name to the IP address for my server, but I didn't have a website made yet. So I set up my server to redirect the URL to my Soundcloud, at least for the time being.

I put the URL onto my CV and sent it out to prospective employers.

Not too long after that, I found myself a job, forgot about the website and figured I would just let the domain expire. I also switched to another host, and didn't bother to setup the redirect again. So the URL wasn't doing anything, as far I knew.

Cue back to today. I get an email from uk2 to tell me my domain is due for renewal. Curious, I open up the URL again ""myactualfullname.com"". And what comes up? A picture of a guy pissing on another guy's face. Another picture of a guy being fisted while wearing leather bondage. ""Gay Fisting, Leather and Pissing"" in the title bar. Yep, my ""professional"" URL was directing to a gay porn site.

It turns out the IP address of my old server had been reinstated as the IP for a server hosting a porn site.

I quickly logged into uk2 and swapped the DNS servers back to defaults again and deleted the entires on the DNS server I was using. But anyone who understands this kind of stuff will tell you it can take a day or so before records get updated across the world. As of writing this, it still points to that site..

I have no idea how long it has been like that. Potentially a few months to half a year. I really hope no one found a copy of the CV I sent out in the past and decided to look it up..

**tl;dr: unintentionally hosted gay porn on my professional website, put the URL on my CV and sent it out to potential employers**",TIFU by registering a domain with my full name,1025
larholm,103,163,18vtt9,829,"I was changing the door handles on the doors to my living room and my bath room, so I start out by unscrewing the old ones completely.

Suddenly I remember that I have to pee, so I head for the toilet in my bath room    
- and slam shut the door behind me.

I realized in an instant what I had done, but I couldn't open the door from the inside    
- because I had just unscrewed the door handle completely.

I tried to use all remedies in my bath room as an impromptu door handle, but to no avail;    
I ended up having to smash my way out and fucking up my doorframe.

Edit:

Here's the glorious aftermath, [one broken doorframe](http://i.imgur.com/pc5fC7n.jpg).",TIFU by changing my door handles,992
Troll-bi-wan-kenobi,119,265,1a29ho,833,"So Saturday I was with my girlfriend and we were driving around the city searching for fun things to do. At dinner, she ordered steak, potatoes and gravy. After dinner she wanted a taste of my baby gravy so I willingly and happily let her have it. After the blowjob fest in the back of my car, the only way to clean up was to use these napkins I found in the back seat. I wiped us up and found a little empty bag of pork rinds that I stuck the cum wipes in. I was going to take the bag out to the trash when I got home but I forgot. The next day, I'm driving my grandparents to the Deli so we can grab some brunch. On the way home, she finds the bag of pork rinds and starts digging through it picking up the napkins telling me to not put my ""snotty tissues"" into a potato chip bag. I corrected her and said it was a pork rind bag but I was not about to correct her about the snot actually being semen. She got some ""snot"" on her hand and wiped it on her dress. Needless to say, I fucked up.

TL;DR I left my fapkins in my car and my grandma rubbed her hands on them.

Edit: no my grandma did not blow me you sick fucks, yes my girlfriend didn't swallow woopdy doo",TIFU By letting my Grandmother touch my semen,1098
jaaaaaaack,142,170,yr8vr,825,"Just another beautiful morning, so I thought at first. Then, some relatives dropped over for a visit.

Me, being the most unsocial person in the family, decides to sleep in a little more, since I have no idea who these relatives are, and I don't really want to say hello to them. 

So there I am, sleeping on a thin mattress on the floor, when someone yanks my hair. I ignore it, thinking that it's my little sister, trying to be annoying. But the yanking continues, so in my sleep-ridden state, I toss my hand backwards and my palm collides with something squishy. And then I hear crying.

Enter me, apologising profusely to my aunt's cousins' sister's mother or something and her bawling two-year-old son that I've just accidentally hit in the face. 



**tl;dr**: who doth awaken the beast shalt pay in tears.
",TIFU by accidentally punching a baby in the face.,995
CaptainRandus,237,458,1q8t5b,825,"SHE PISSED MY FUCKING BED!

EDIT: I'm getting a lot of comments asking for the story. So since, i'm still seeing people asking, and have since been called a rapist, i'll share.

**really not much to it, my band was third to play, had a pretty good buzz on before the show. Bands were done at 1 (bar closes at 2, first band stopped early, and for the first time in my life, a show was over early). So we all sat around getting destroyed drunk. After the bar closed, a few of us had beers in the back of my jeep (No drinking and driving).
Called a cab finally, because my son was at my mothers, and the girl said ""Split a cab with me, we're going to the same place!"" and i said ""Cool""
She came to my place (im about a 10 min walk from my mother's place, so i didnt bring her to where my son was. She came in , basically stripped down naked, and yeah. I woke up in the middle of the night afterwards.... oddly enough because i had to piss.
She was gone in the morning.
I know it's really not much of one, but that sums it up haha**",TIFU by bringing a girl back to my place after my band played...,1283
solidcat00,221,266,1niiy1,823,"On a plane to Riga from Moscow I became extremely drunk. I hate flying so I brought a flask of vodka on the plane. I wake up a day later tied to a bed in a hospital. My money was stolen. They said an ambulance had to take me from the airport. I have no idea what happened but I am terrified that I might be banned from flying... The hospital cost 66 lats but I have no way to pay it. Luckily, I have already paid for the hostel so I can stay here for a few days. My visa is being processed and will be ready Friday but what if they won't let me on the plane? I have a credit card with no money so I am waiting to talk to parents who are in Canada... I don't know if they can transfer money to a Russian credit card. Thank you for reading... Wish me luck.

Edit: Does anyone know how to transfer money internationally?

Edit 2: Lots of great comments. It makes me feel a little less alone.
Some updates - my sister sent money through Western Union but since my visa is being processed I don't have an ID so I have to wait until tomorrow. Living off oranges and nuts. I called and asked about my flight and gave my reference number. They told me when I fly and no mention about being banned. Not sure what to do about hospital bill but I guess they won't keep me in Latvia to pay?

The flask was bigger than a normal one... I drank it quickly and with the altitude I guess it hit me stronger.

BTW, I'm Canadian, not Russian.

Yes, I have a problem. I must quit drinking before it destroys me completely.

Finally, I'm not really sure what help the Canadian embassy can offer.",TIFU by getting drunk on a plane,1089
beboshoulddie,180,248,16lco5,823,"*BACKSTORY: A while ago, my English teacher assigned everyone a discursive essay on a topic of our choosing. I decided I would do gay rights, being gay and all. It was the day before it was due and so I rushed it all and, more importantly, didn't check over it.*

------------------------------------------------
This morning, I was called out of class by Mrs English Teacher. In one hand, she brandished my essay. She looked me dead in the eye. 

&gt;""Mr ShouldDie. Is this a joke?""

&gt;""No miss""

&gt;""So PRAY TELL ME, why have you written all this NONSENSE about fat people?""

She showed me my essay. I didn't realise that at several points my touch typing (see note at end) had failed repeatedly and replaced the word ""gay"" with ""fat"". Here follows some excerpts of the aforementioned essay:


&gt;Even in the countries that do not criminalize being fat, citizens often decide to take matters into their own hands. This is often referred to as 'fat-bashing'.

--------
&gt;In certain states in America, fat marriage has now been legalised.

---------
&gt; A large amount of religious people just do not like fat people because they are told to.

--------
&gt;The Westboro Baptist Church regularly holds anti-fat parades

--------
&gt;In at least 8 countries in the world being fat is a crime punishable by death.

*sigh* I feel like an idiot. And I have detention. Great. 

**EDIT:** Touch typing doesn't mean I wrote my essay on an iPhone. It means typing without looking ~~at what you are typing~~ the keyboard. ",TIFU by writing an essay on fat rights,1071
loudness_,441,276,1l6qrl,823,"I've never been one to leave things alone when I don't agree with what's happening.  Today (well, last night, actually) I fucked up by getting involved in a physical fight between a couple that was happening on the street outside my apartment.  No, I didn't get hurt or arrested;  I fucked up by getting involved, and it ruined my night, because my girlfriend of 9 years thinks I'm an idiot for helping out.

I had a long day, but was just coming back from a weekend business trip.  I work in a creative field that involves lots of traveling, lots of long hours, and huge projects with millions of dollars at stake.  I had a major project this weekend with a client, and it went better than expected.  I returned to the office Monday to a standing ovation from my co-workers, and was incredibly happy with my work.  Rather than take my friends up on their usual post-work round of celebratory drinks, I had one goal in mind:  a dinner-and-drinks date with my girl of 9 years (we live together, are engaged, etc. etc.  Very serious relationship).  

As we were leaving our apartment, I heard a woman scream.  I look to my left, and see a man, slightly smaller than me, with his hand around a woman's throat.  She looks terrified, and is being held up against a brick wall while he pounds said wall around her, yelling at her loudly.  

I don't know if I was supposed to censor myself, but I immediately spoke up and started walking towards the scene.

""This is not happening.  Get your hands off of her RIGHT NOW.""

The dude looks up and sees a guy larger than him (I'm 6'2 with a football player build, he a somewhat skinny guy about 5'11), and immediately issues one final slap to the woman and lets her go.  I start yelling at him while walking towards him to chase him away.

""If I EVER see you in my neighborhood again, I'm calling the police.  If I ever see you lay your hands on this woman or anyone else EVER AGAIN, I'm bypassing the police and laying you out right where you are, you understand me, asshole?""  The whole time I'm yelling at him, he's backing off like he knows he fucked up.

Then, as I'm calling the police to report this jackoff, his girl/victim starts yelling at me to back the fuck out.  I turned around and looked her square in the eye and told her the truth:

""Look, be as pissed as you want, but you don't deserve to put up with that crap.  Respect yourself more than that, he obviously doesn't.""

My words fell on deaf ears, as she ran after him.  They both disappear into the night, and I call in the incident to the local police, with a complete description of the assailant and victim.

I turn around, and my girl is livid.  ""Why do you always have to get involved?  You don't know if that guy had a gun on him, he could've killed you!  You don't know how crazy these people are, he could've gone off after you!""

Date ruined.

We got in the car, and all the way to the restaurant we'd chosen, I got to hear how I'm completely insensitive to her needs -- after all, this guy saw her as part of the incident, and she was now scared that he'd come after her and assault her on the street.  She's scared that he might have a weapon and come after me, and injure her in the process.  

I heard on and on for the next 20 minutes about how big of an asshole I am, about how I have no consideration for her safety, and etc. etc. etc.  On and on and on, to the point where I'm almost in tears because she's being so insensitive.  

She then transitions to the silent treatment.  We get to the place we're supposed to have dinner, and she refuses to leave the car.  Tells me the night's ruined, and to take her home.  I do.   

We get home, she does her normal routine of getting on the iPad and blocking me out.  Anytime I say anything, she cuts me off and says to shut up.  That I'm an idiot.  That I can't ever just leave anything alone, and that she can't believe I'd put her safety in question over some ""ghetto fight"".  I got to hear a lot of negative things about myself.

After taking it in stride, knowing I did the right thing, I finally blew up at her.  I told her that if she were in a similar situation, I hope someone would step in to her aid.  And that I don't particularly care if she's upset, that I know my actions were sound.  I may have saved that girl's life;  I may have prevented a serious injury;  I may have wised her up to not having to live a life of abuse.  I may have done absolutely no good, and things won't change for either of them, but I still had to try.

I sat up, alone, feeling really shitty about myself.  I still stand by what I did, but I can't shake how horrible my girl made me feel.  First chance for a night out together in a week, and last chance for a while due to our horrendous work schedules, and it was ruined by me getting involved.  I know I didn't really fuck up, but it sure feels like it.

TL;DR:  Fucked up by stopping an incident of domestic violence.  Girlfriend was more concerned that my involvement put her at risk, and spent the rest of the night telling me what an awful person I am and using it as a chance for many personal attacks.  ",TIFU by stopping an episode of domestic violence.,1099
sadhorsefucker,169,167,183en6,822,"Last night I was fapping to my favorite weird fetish, My Little Pony porn. After doing the deed, I just turned off my monitor and went to bed without thinking anything of it. Fast forward to this morning, my Mom comes into my room and asks if she can use my computer to check her e-mail. Still half asleep and laying in my bed, I said sure. The severity of the situation didn't really hit me until my Mom was about to turn on my monitor. As soon as she turned on the monitor, she was greeted with a screen full of Rainbow Dash's ass in very graphic detail. I went into full panic mode and jumped out of my bed while she sorta just gasped and held her hands over her mouth in shock. 

At this point I could have done anything else to better resolve the situation than what I was about to do. I could have closed the window, turned off the monitor and tried my best to explain. But instead, still in full panic mode, I punched my monitor as hard as I could and broke the screen. 

My Mom left my room in a hurry. I'm typing this on my laptop now and I haven't left my room yet today because I don't know if I can ever face her again. Not only does my Mom think I'm a horse fucker, but now she thinks I'm a crazy, violent horse fucker. 

I'm so sorry, Mom.","TIFU by not closing my horrible, disgusting porn before going to bed last night",989
A_Sea_Anemone,144,343,1qmy0a,823,"Edit to title: TIFU by NOT looking in my coffee before drinking...


I have braces and sometimes food gets stuck in them. So when I fucked up and took a drink of my coffee, I thought the thing I was feeling in my mouth was leftover food. Crunch... feels squirt.... WRONG. NOT FOOD, FLY. Big disgusting fucking fly I just crunched in my mouth. I vomit immediately ALL over myself and still feel nauseous thinking about it. :( I fucked up today. ",TIFU my by looking in my coffee before drinking.,1166
wisdomteethsuck,109,326,1oaen2,820,"So I'm in a photography class at school, and we were touring the dark room for the first time. Naturally, it was dark, so everyone was commenting on how creepy it was in there. When the safety light was on, the room had an amber glow to it, just enough to illuminate the equipment and large sink/ chemical storage in the middle of the cramped room. My teacher was telling us how to use the sink, as the water was prone to jutting out fast and violently and needed to be operated carefully. She warned us that this sink could get to be 120 degrees farenheight, which set my twisted mind rolling.

I'm a writer. Normally I don't dabble in horror/murder mystery, but this dark room got me thinking. It would be such a perfect set up for a horror movie.

The teacher took a third of the kids into the next room, which was too small to hold all of us.

In her absence, I decided to break the silence and tell the class what I'd been thinking about. In excruciating detail.

""Can't you just imagine someone coming up behind you and dunking your face into the scalding water? You would drown and burn your face at the same time. No one would hear you scream. No one could even see you in the dark.""

Then I saw the looks on their faces and decided to shut up. Now they think I'm a psychopath.",TIFU by convincing my photography class I'm a serial killer.,1146
Saxophobia1275,127,240,1eyv9q,821,"I (a male) was walking across campus at my university past our big clock tower. I hear a girl yelling through a megaphone about her experience with date-rape, and I think ""uh oh, there's one of the feminists meetings here"". I only say uh-oh because this isn't the university sponsored feminist group, it's the one that's kind of infamous on our campus for being radical and violent. I'm very much for rights for women, but vandalism and blackmail just isn't how you should do it.

So I'm kind of zoned out walking past the clock tower to class. The megaphone is super loud and bouncing off all the walls and hedges so I can't tell where it is coming from. The megaphone girl was just getting to the part where all men suck: ""After my rape every male figure in my life disowned me, my Dad, boyfriend, and all my guy friends. But it showed me that I don't need them in my lives"" and she's sobbing while telling this.  

Right as I start to think ""man this is really heavy"" I decide to look up to see that I have walked straight into this meeting and am standing about 5 feet away from the girl with the megaphone. She has stopped talking and is staring at me along with roughly 50 girls (who I'm sure have the most awesome opinion of men at this point) giving me the death glare. This moment could only be made worse by my wardrobe choice that day. I was wearing a shirt I had ironically bought for parties a few days earlier that brandished a large and colorful ""PARTY WITH SLUTS"" on the front. After standing still for what seemed like an eternity I quickly NOPE-ed the fuck out of there.

tl;dr
feminists probably want me dead",TIFU by not paying attention to my surroundings,1061
twitchyw,158,196,134ln1,818,"I was at a bar with my buddy last night. I somewhat know the bartender from previous friends and hobbies that I've been into, but never really talked to her much other than small talk. She has a great sense of humor and can be pretty vulgar at times. 

So I've grown a fancy towards her ever since I've been going to the bar she works at and chatting with her. 

Last night she tells us this funny story of how her dildo broke,  she drunkenly ordered way too many, and other shenanigans ensued. 

As I was closing my tab, I call her over and ask, ""Do you want my number?"" To which she pauses and stares at me, then asks, ""Why?""

For a few seconds I stood there not knowing what to say, so I blurted ""Because you said your dildo was broken, and I thought I'd offer to help out.""

She stares at me for another couple of seconds and starts laughing and saying 'what the hell?' a few times. 

She gave me a hi-five on the way out for the weirdest line she's ever heard and the weirdest thing I've ever said to her. Nice. 

tl;dr Don't use 'you said your dildo was broken...' as a pick up line

Update: Sorry about the delay. I decided not to update the story until I went back to the bar because nothing really came of the whole situation between the first post and now.

 It was a bit more crowded this time around so I didn't get many chances to talk to her (the bartender). It seemed like everything was initially normal and not awkward at all. I followed some of your advice and didn't bring up the broken dildo again. I'll try to go back sooner than next week (if she works between now and then) to try to talk a little more. 

Thanks for your patience, but so far nothing has come out of it. I'll keep trying though.",TIFU by using the worst line ever,1014
thebornotaku,114,133,xnuye,813,"So today, I fucked up my tongue.

I was helping a customer look for something in the grocery store I work at, and the item wasn't on the shelf. It was a certain brand of frozen ravioli that we sell. I told her I'd go in to the walk-in freezer and take a look around. So far, fairly normal. No problem.

I go to the walk-in, open it up and go inside. I look around and don't see any boxes with that company's logo. Then I see the big, metal wheeled carts that we stack the bags of ice and other frozen products on. They're bare metal, and about 6' tall. I see the bare metal, and in a moment of infinite genius, I think to myself: ""*I wonder if my tongue would get stuck to that like in the movies*"". (I live in an area that experiences no snow or ice in the winter, so I honestly would have no way of knowing)

Well, in another moment of my infinite genius, my brain decides ""*Let's not just wonder... let's find out! Experiment time!*"" Tongue comes out, touches metal, and the shock of the cold causes me to jerk my head back. I feel resistance as I jerk back. Then I taste blood. Then I see, on the cart, a small little patch of tongue that used to belong to me.

Luckily the damage I inflicted on myself wasn't too bad. IT stopped bleeding after a couple of minutes and it doesn't hurt any more than a moderate food burn would.

**tl;dr: I'm a fucking moron**",TIFU my tongue.,946
deletethisacc,140,220,1nojh9,815,"I was on the freeway and violently sneezed like 5 times and by the time I could recover, the airbag was in my face. Totaled the car, fml. ",TIFU by sneezing while driving,1035
NeonRedSharpie,111,272,1k7cas,812,"The sun shone through the bedroom window a little bit too early this morning and the alarm went off a little bit too loudly.  The dreams and visions of niceties gave way to the cold, harsh reality of a Monday morning.  The sun appeared to be battling the cold air for extreme supremacy of the small ecosystem outside of my apartment.  After a few levels of Candy Crush and a Temple Run failure, I got up, trudged to the bathroom, and looked in the mirror.  What looked back was a sad example for a human being in desperate need of a shower, and a new lease on life.  I washed my face, brushed my teeth, and turned in to the toilet.

Lifting the seat and dropping my pants, I closed my eyes and enjoyed the sweet release of a morning piss.  I was thinking of all the projects due at work before my end of summer vacation on Wednesday.  I was thinking of how waking up early was going to pay off and I was going to be able to relax in the afternoon.  I was thinking of how my shoulder kind of ached from sleeping at a weird angle.  What I wasn't thinking of?  My cat.

I heard him first before I ever saw him.  I heard the strained meow and the skitter of claws on the porcelain.  I heard the frantic chirping of a kitty in peril.  I sighed briefly and opened my eyes to a sight I will never forget.  He was perched with all four paws on one side of the toilet.  He was looking up at me with big wide eyes.  At that moment in time, time itself became a moment.

We locked gazes and shared a sympathetic glance as he slowly plummeted into the toilet.  Time seemed to slow as he realized his fate.  It was mere milliseconds before a urine soaked feline became a speeding bullet through my apartment.  I sunk my shoulders, finished my business to the sounds of pained meows and frantic skitters, and flushed the evidence down the toilet.

Now came the fun part; corralling a two year old cat that is closer to a thrashing bull.  A wet cat is one thing, but an orange and white cat that is tinged a sickly shade of yellow is a whole other monster.  As I walked out of the bathroom, trying to keep my wits about me, I saw the destruction.  A thin trail of liquid, undoubtedly spread by his tail, led me on my travels.

He had stopped off on his favorite chair for a spell.  It was followed quickly by a jump on the coffee table, over to the couch, and up onto the sofa table.  Not satisfied with his new-found hiding spot, he traversed the gap onto the dining room table, ran through the kitchen, and ended up sitting in his favorite spot.  That's where I found him.  Sitting at the entryway with his favorite toys, cleaning his paws.

I thought about just going back to bed.  I thought about giving up and ignoring the problem.  I thought about getting dressed and just going to work.  But then I saw him cleaning his paws.  I saw him licking the urine tinged toilet water off of his previously crisp, white, paws.  I went in the bedroom, got a shirt, and headed outside.

I needed my gardening gloves for this.  I thought about getting the hose, but then I remembered I don't have a hose.  Looking outside onto the still scene of nature, the serenity of chirping birds, the frolicing of baby bunnies, I knew everything was going to be ok.  We were over the hump.  Soon it would all be forgotten.

I put on my gloves, walked back inside, and turned on the tub.  I walked back into the entry way and picked up my smelly cat, if only to keep him from cleaning more of his fur.  I made the slow walk to the bathroom, angry cat in hand, with the Imperial March playing in my head.  The water was barely coating the bottom of the bath, so I had to stand there, holding my cat at arms length, while the water level rose.

Finally a suitable depth, I took a deep breath, and dunked him in.  I wanted to hold him under until the bubbles stopped, but thought better of it.  All was going according to plan: one hand scruffing his neck and the other vigorously scrubbing his fur.  His flowing ginger locks were becoming clean again and his crisp icy white underbelly was showing through.  I reached for the kitty shampoo and let go of his neck to do it.  It was then that I realized my final mistake.

Today I fucked up by not shutting the door.",TIFU by Not Shutting the Door,1084
cum_guzzla,161,274,1b476r,807,"The other day I was feeling particularly frisky. I thought I'd treat myself to a nice wank with the aid of some moisturiser. Searching through my medicine cabinet the only moisturiser I could find was some really expensive stuff, and I just couldn't justify the use of it for masturbational purposes. My eyes set upon some antibacterial hand sanitising gel - you know - the stuff with the incredibly high alcohol content. I squeeze some out into my hand to remind myself of the sensation - it was the same as always; that cooling feeling as it quickly evaporates off the surface of your hand. Couple this with its inherent viscosity and my mind was racing. Surely this would be the best wank of all time? 
Had I just stumbled across something beautiful? 
What could go wrong, I thought to myself. 
Well, after preparing my love truncheon, I squeezed another big dollop onto my hands, rubbed my hands together and got to work.
My first port of call was my balls, I like getting those two rascals involved when I masturbate, but my god was this a mistake. The immediate burning sensation that emanated across my scrotum was shit-droppingly bad. Like the retard brother of ""deep-heat"" who hasn't quite learnt to control his retard strength yet. But, being the true masturbation warrior that I am, I threw caution to the wind and continued. 
I made one stroke, just one stroke from the head of my penis down to the base. I'd like to say I persevered through, but, truthfully, that was all I could muster. The head of my penis was on fire, all of those fragile nerve endings were being stimulated in a way that was novel to me and so ferociously painful. I was truly petrified. The pain started to pulsate over the entirety of my junk as I jumped up, fully erect, and began to frantically glance around my room to think of a way I could remedy this situation. 
I ran to the bathroom, tripped up on a towel on the way, but that was the least of my worries, and started to run the sink with nice cool water. Standing on tip-toes I lifted my balls over the brim of the sink and dunked them into the water. MISTAKE. The pain intensified and became hotter and hotter. As a newly broken man, I summoned  the strength to grab the moisturiser I had previously contemplated using, before this whole debacle. I held it in my hand and thought to myself ""If this works, universe you are a cruel, sardonic, evil mistress"". Lo and behold the shit worked. Within seconds my entire cock and balls were bought back to room temperature and the pulsating pain started to subside. I lay there, naked as the day I was born, on the bathroom floor, slowly chuckling at the viscous irony of the entire situation. ",TIFU by using hand sanitiser as a lubricant. ,1081
ojgod,191,243,1ikhev,803,"At my probation office I'm asked to provide a urine sample. This is ordinary but always worries me because I have quite possibly the most nervous bladder in existence, so I always chug amazing amounts of water to compensate. Today I was sure I wouldn't have to drop so I came in unprepared and completely pee-less. I chug 6 bottles of water in 20 minutes, the desperate attempt of a nervous wreck to force his body to produce urine. Downing my seventh my P.O. comes out and starts to be very verbally rough with me and that only added to my anxiety. 
I gagged on my water because of that and soaked his shirt with 6 1/2 bottles of water and the small breakfast I had earlier. And the real kicker? They considered my specimen diluted. 
Edit: Grammar ",TIFU by drinking too much water,1046
Modus_Pwninz,92,172,12o1j7,804,"Long story short, in the wee-hours of the morning after my fiance got home from work, we decided to have some sexy times.

She likes having her ass slapped pretty hard, so while she was riding me, she asked for me to slap her ass. She specified that I do it hard.

So I...attempted. However, at the same time, she lifted her ass up a bit higher than usual during the up-thrust and my hand missed her ass entirely and landed squarely on my balls.

I've never been hit in the balls so hard. Sex stopped immediately and it is the only time I've laughed my ass off (I had to, it was so ridiculous) while in excruciating pain.

I wouldn't be surprised if I'm now sterile.",TIFU by slapping myself in the balls during sex.,976
CupcakeGirl84,152,213,1qkp6q,807,"First thing's first, the job I have is very physical-I'm always on my feet, lifting heavy things, up and down ladders, sweating, and being active and gross in general.  I definitely don't wear granny panties but at work I usually wear pretty generic bikini style panties that are comfortable and don't ride up with all the work I do.



So I was stumbling around like a morning breath zombie today looking for my work clothes.  Of course I can't find any clean underwear.  Finally, I spy a pair of gray boyshorts on the floor-passes the smell test=clean.  I noticed there was a small (pencil eraser sized) hole in the crotch, but that's no big deal, not like anyone will see them.  So I suit up and don't think twice about it, and head to work. 



As my day gets going and I'm walking all over the place and moving around a lot, I start to feel unhappy in the underpants region.  Something feels weird, like pinching or chafing.  I am really busy so I discretely try and do the pinch and pull to get the fabric away from my crotch and keep going about my work.  But no, that's only a very temporary fix.  The discomfort is becoming worse, and almost painful to the point that I'm kind of starting to walk spread legged and keep trying to squat a bit and am trying hard to keep a grimace off my face.



Finally I get a moment to hobble to the bathroom and pull down my pants in front of the mirror.  It was that hole.  That goddamned hole.  And peeking out of the hole, angry, was a part of one of my pussy lips, like a tiny angry thumb.  And let me clarify yall, I don't have huge dangly lips.   But somehow it had gotten itself through the hole in the fabric and gotten itself stuck there.  It was almost PURPLE and not feeling good.  You know how it feels when you put a rubber band around your finger?  Yeah.  *But on my labia.* 



So then I had the joy of pulling my pussy lip out of my underwear hole which DID NOT FEEL GOOD.  It was chafed and swollen (not in the good way) from being crammed in that hole.  Then I was faced with what to do with my underwear.  I knew I couldn't keep wearing them, so I had to figure out how to smuggle my panties out of the bathroom all the way back to my purse in my locker without anyone seeing, and then spent the rest of the day mortified that anytime I opened my locker, my panties would fall out.



TL;DL: wore panties with a hole, my vagina tried to escape.       

Edit: wow, this blew up more than I expected.  And I'm super glad I'm vindicated because it's happened to other girls too!  Today=pristine, non-holey panties!  Happy lips.",TIFU by wearing the wrong underwear to work (NSFW-language),1020
Full_Of_Win,196,197,1ltleh,801,"Today during my psych of sexuality class I made the mistake of bringing up what a fleshlight is. I ended up having to describe it because everyone was like 'uhhh a what light?'. I said something like ""It's shaped like a large flashlight but its designed to be a fake vagina.' And my teacher was like 'Interesting, well, how do you use it?' I thought the answer was pretty obvious, so my immediate reply was ""What? You flip it around and stick your dick in it."" everyone laughed. Now everyone, even the teacher assumes I have one. After the lecture I asked the professor if she would like to see what one looked like and she said 'Yeah, if you don't mind bringing it into class.' Shocked by her response once again I fumbled to explain that I don't have one and what I ment by asking her that, was I had popped up a picture of one on my phone that she could see. 

Impressed by it, she asked me to email her the link to the site.

I did it.",TIFU by bringing up the fleshlight during my Psychology of Sexuality class.,998
Paragora,76,92,13jdog,804,"Last night I went out and drank with some friends (we're second years at a university). We came back to the dorm last night and went to sleep. I sleep on the bottom of a bunk bed and one of my roommates on the top. I set my alarm for 9am (had class this morning) he climbed up and we both slumped to sleep. Little did I know in my drunken stupor I moved my roommates ladder to his bed. 

The next morning when my alarm clock went off, I slept through it. My disheveled self slept through it. My roommate decided to turn my alarm off for me. He didn't know his ladder was missing so he stepped down from his tall bunk-bed and fell to the ground, while one of his arms was holding on to bed rail. His arm got stuck as he fell. then it broke. 

A large and gut wrenching crack was followed by a loud ""HOLY SHIT FUCK ASS AGHHH SHIT FUCK"" 

He's in the emergency room still. 

Reddit, Today I Fucked Up.

Edit: Fuck Up of the Week, I'm honored.
Also, /u/crappystickfigures helped make a drawing of the event [here](http://i.imgur.com/jHuVA.jpg?1)

",TIFU by setting my alarm clock.,896
akoostik,119,167,19c82o,798,"Woke up this morning for an interview I was really excited and hopeful about.  Last minute, I decided to do a massive trim of my beard. Somehow my beard was so thick and badass I managed to break the trimmer. Now I was running late for my interview.  On the way I stopped into CVS and got some shitty $20 trimmer and shaved the rest of my face in the car. I looked like a wreck.   I'm pretty sure I had pubes still on my shirt!  I didn't get the job.   ",TIFU by deciding to shave my beard last minute before an interview.  My trimmer broke halfway through the process. ,965
not_gordon_freeman,144,203,1poggo,800,"So I went out tonight.  I thought, ""Hey It's Halloween, maybe I can try and hook up with some random girl and it will be fun and awesome.""  Most of the night was lame, couples out together, people not in costume, not many people out in general because it's a thursday, etc, etc.

So, I end up getting good and drunk because I feel like a random hookup is not happening, and I eventually break off from my group of friends.  The bar I'm at is closing up so I walk over to another bar next to the one I'm at to roll the dice.  I smoke a cigarette and everyone is paired off with someone or in a group of dudes 5 deep.  I see a hot girl standing by herself.  I start talking to her and she sort of recognizes my costume.  She immediately jumps to me taking her home.  I agree and we hop in a cab back to my place. 

She says she's cold and starts rubbing my legs.  I just take this as her being assertive about what she wants and not leaving anything to the imagination.  She says some other stuff that I don't really hear, but I pay no mind because I assume she's giving instructions to the cab driver.

Eventually we get back to my place and she says we can do everything if I want, which seems weird to me, so I say we'll see, trying to play it cool.  At this point I'm properly drunk and was content with just going to bed with an attractive girl next to me. I escort her in, and as I bring her into my room she basically explains that she's a prostitute.  So much for me being charming or attractive or witty or whatever the fuck I was thinking I was.

It doesn't end there though.  I call a cab for her to get out of there, the first cab comes and calls, but I miss the call due to shitty reception in my apartment.  The whole time she's freezing while lying in my bed, in my not terribly cold apartment so I semi-cuddle with her, which she's cool with.  Eventually the second cab comes and I escort her out, pay for the cab and she leaves.  The whole time she was here I felt awful for wasting her time during prime bar time.  I felt like the biggest idiot, but she was super nice during the whole ordeal.

edit: perhaps the most embarrassing thing about this is that I'm a grown ass man and need to call my mom and explain this to her because I used one of her credit cards for the cab rides, since my card wasn't swiping properly.

edit2: deleted a brain fart in the first line.",TIFU by bringing someone home.,1003
Helen_of_TroyMcClure,79,192,1btdpe,796,"Mild fuck up, but a fuck up nonetheless.  I work at a drugstore, and I was refilling the fancy change machine at one of the registers yesterday (it dispenses the coins when someone pays cash, meaning I only have to worry about the bills when giving change).  I'm refilling the nickel slot because it's pretty low, and as I drop a coin into it I notice that the cashier before me had put a dime into the nickel tray in the register, which I had just dropped into the nickel slot.  *Whatever*, I figure, *a dime is way smaller than a nickel so there's no way that'll clog up the machine.*

So this morning I'm working the same register, and this old lady's change ends up being $0.05.  So I just hear a *click* and no change comes out, so I ended up just giving the lady five pennies instead.  I call the manager over, he just has me turn the machine off and on again, still no nickels coming out of the nickel slot.  They ended up having to take the machine apart to figure out what was wrong, and the manager says, ""Well, here's the problem, some dumbass put a fucking dime in the nickel part.""  I am that dumbass, and no one will ever know.  Except the entirety of reddit.  And my girlfriend.",TIFU by putting a dime into a change machine.,988
HelloKidney,190,205,1g30vn,794,"As I pulled into the parking garage at work this morning, I had Pandora playing on my phone, connected to the stereo. I don't recall what the song playing as I pulled in was, but apparently it was the muthafuckin JAM! It was so the jam that I needed to hear this song in its entirety. Right now. So I plugged in my ear buds, grabbed my work bag, transferred a few things into it from my purse, threw my purse in the trunk. I then went off, beeboping along to this amazing song (whatever the fuck it was) on my long walk into work. 

(((Fast forward almost 9 hours...)))

I finish the long walk back to my car, relieved to be nearing an air conditioner once again on this sweltering 110 degree day. I unlock the door and think, ""Hey, what's this? ...Two beeps?? ...Shit! I forgot to lock the door! It's been sitting here unlocked all goddamn day! OMG, you idiot! ...Well, thank goodness for honest people."" I press the ignition button. The car turns OFF. ""Wait a minute...WTF?!?"" 

Apparently I left the doors unlocked with the engine running in a parking garage on a 110 degree day for NINE HOURS straight. Just burning up fossil fuels and filling level 6 with deadly carbon monoxide for nine frickin hours. 

Today I definitely fucked up. I feel like one of those absent-minded parents who drives away with their kid on the hood of the car.",TIFU by pretty much BEGGING for my car to be stolen.,999
facetious_journalist,318,332,13avym,790,"Right, I'd been waiting to see this movie for what seemed like a fucking age. Mention this fact many times at work and once again at a dinner party on the eve of the debut here. I know that this might seem sad but fuck you - I wasn't going to be getting much sleep on the count of the film. Aaanyway, my sister-in-law's sister was at this dinner party and pipes up that she's been dying to see it too! Yay! So my brother's wife says that I should take her the next night. Fucking lady troll - all I wanted to do was sit on my own in the dark and eat criminally expensive treats.

She was staying with my brother at the time and he wanted her out of his fucking house for the night so he could do the old horizontal river dance in peace. Being the meek little cunt I am, I agreed. 

Star-swipe to the next night. Pick her up and she's gone all out for it - I mean low neck line and some sort of fuzzy shoes. Still in work clothes, thought about getting changed but felt uninspired. We get there and I pay for the tickets and the treats, almost 60 fucking dollars. Fuck my fucking brother and his wife. 

Sneak a quick cigarette outside before the session begins; date looks unimpressed. I offer her one and she just asks for a drag from mine - hadn't had anyone ask me that since the big college herpes epidemic of '09. We go in and find some seats that were just OK, could have gotten better ones if I was there on my fucking own.

Lights go out, blah blah blah and the movie starts. Holy shit. The colour, the sounds and the visual ecstacy of it all. Just fucking brilliant. Then it began. The tomfoolery. What the fuck is going on? My date was trying to play footsies with me - by which she was ruining these $500 shoes on my fucking feet. Trying to push this out of my head and focus on the theatre of it all. 

Her idle hand crept toward my leg like the first horrifying tingles of a jellyfish sting. I was trapped. God fuck this shit, I just wanted to watch this movie. Any other time, day or place, she would have gotten the ram jam matinee without even the slightest rise. But not now. This was my time. My fucking James Bond time.

Ignoring her like a liberal arts graduate, I finally get some peace. She just gives it a few more goes to which I retort with the forseeable ""shhh"". Movie ends, best modern day Bond hands down. Just spectacular. Five fucking thumbs up. Go and see it if you already haven't.

Get in the car to drop her back at my brother's abode. Date is already texting on her phone - her fingernails tapping loudly and out of time to Nick Mason's drum beat playing over the radio. Get back there and my sister-in-law and my brother are waiting out the front by the mailbox. We both get out and bang. Verbal salvo number one. Sister-in-law is yelling at me in the middle of the street! What is this, Detroit? Anyway she and her sister storm off into the house. Brother is like, ""come on, man.""

He took his wife out to dinner and wined her ass up good. He had his pants off and dick in hand when his wife saw a message from her sister, saying that I was being a jerk to her and so on. She storms out and leaves him there in the bedroom with nobody except lefty five fingers for company. Tell him I'm sorry and we bro shake on the promise of weekend rugby beers and other fraternal activities. 

TL;DR: Took a date to Skyfall, too into the movie, ignore date which leaves brother with dick in hand and a broken smile.",TIFU by taking a date to see Skyfall,1122
issuesmayexist,141,199,14cjnb,783,"Greetings once again, all ye dwellers of TIFU. 

[My last thread](http://www.reddit.com/r/tifu/comments/13uidx/tifu_by_combining_magnets_with_my_urethra_nsfw/) caused some considerable comment. Many of the comments were along the lines of ""old man, you really ought to get a doctor to look at your area."" This, combined with a certain odd sensation in my bladder, made me concerned enough to consider it. My main worry was that there were balls left inside me, and without an X-ray I would never truly know. So, last Friday, I went.

I made an appointment at the GUM clinic. GUM (genitourinary medicine) clinics are excellent for those, like me, who perhaps do not want too much documented in their permanent medical notes. They are, much like here, anonymous. Ish. 

I arrive, I fill in a form (surprisingly enough, none of the questions were enormously relevant to my case) and in I go to speak to the nurse. 

At this point I was concerned that I wound just freeze up and not be able to string together anything remotely coherent. Oddly enough, though, it turns out that (again, much like here) semi-anoynimity removed all barriers of shame. I was eloquent, I was articulate. 

She was confused.

She went and got the doctor.

She was confused. This was new to her. But she was as old as God and pretty hardass, so she also mocked me appropriately (evidently something above the pay grade of the nurse). I had it coming. I didn't mind. She examined me (it was extraordinarily non-sexual) and, slightly fumbling for ideas, tried using the demonstration buckyballs I had brought along to detect any magnetism from the outside. This worked exactly as well as you might expect.  

The next step was an X-ray of my gonads. Poor little fellows hadn't yet been through enough abuse, it seems, and a dose of gamma rays was their next challenge.

Thing with X-rays is, they don't normally do them for STDs. So I was sent up to X-ray with a brown paper envelope with a letter inside (which I did *not* look at but which presumably read ""this guy...""). I was taken aside, ushered past the queue of old creaky people, and set up. The poor lady couldn't say ""penis,"" which caused some trouble when I had to... arrange myself for the scan. We finally got things sorted. It's important not to have overlapping layers, you know. 

Anyway! The part you all came here for. The X-ray was NEGATIVE. I have NO buckyballs inside me, thank all the deities (an operation would have been the only way to remove them, if there had been any stragglers). 

I hadn't realised how nervous I was until the good news was relayed to me by old frowny piss-takey doctor lady. I punched the air. I may even have vocalised some sort of ""awwww yeah."" She was unmoved.

She told me not to do it again.

Listen to frowny old doctor ladies.

**TL;DR: surprised old lady, got lucky** 

P.S. Apologies, this update doesn't really have the *pop* of the previous entry, does it? Alas, with updates, it is ever thus. Dipping greedily back into the depravity trough and coming up dry.

*EDIT:*
*[Shadekitty delivers a scintillating narration once again!](http://soundcloud.com/rac91790/gum-clinic-tomfoolery)*
Thanks, Shadekitty!",TIFUpdate by combining magnets with my urethra [NSFW],982
classifrass,125,230,1e0el9,787,"I just had surgery and so my body has been acting a little strange this week. I knew I was due for my period but I wasn't quite expecting how it chose to arrive. My boyfriend's parents are taking care of me while I recover, so this morning I went to take a shower (glorious!) and I paused a few seconds to steady myself (abdominal incisions, ouch) during which time the floodgates opened and I splooged period all over their white bath mat. Frantically, I tried to scrub it off but it went through the mat onto the floor beneath. 

Cut to: me doing the walk (hobble) of shame by his father to put it in the laundry. I really, really hope it comes out and no one asks me why I felt the need to wash the bath mat that was JUST washed two days ago.

UPDATED 7:00 pm EST: Thanks for the protips and the kind responses! I just ""came clean"" to boyfriend's Mom and she was super compassionate about it. Actually, more like she laughed her ass off, apologized for laughing, laughed more, and then hugged me.
Best news is: bath mat looks good! No crime scene tape needed.
Nice when these TIFU's have a happy ending. &lt;3",TIFU when I got my period all over my boyfriend's parent's white bath mat.,1017
tifubandpractice,384,253,1alk20,780,"Throwaway because she reads here some times.

So I bought a tablet because I was moving, and planning to keep my gaming computer in a public area. The intent was for the tablet to be, primarily, a medium for streaming porn to private parts of the house where I could enjoy it and not be creepy with porn in the living room.

Anyway, she and I play together in a band. I play bass, she plays flute. At practice last night I handed her my tablet so she could look up sheet music for a piece we're working on. I notice this look of amusement on her face as she opens the browser but it doesn't hit me until she hands it back...it opened to my last session.

So there she sat, in the middle of band practice, as I reveal my tastes in porn to her. She didn't say anything, just opened a new tab and pulled up sheet music. Handed it back to me when we were done, and that's when it hit me that she had seen. 

Dunno how to face her now.

**update:** asked her out tonight, shot down again :/ oh well, worth it.",TIFU by letting my crush use my tablet during band practice,1033
mindspew,93,280,1n7fsf,787,"I am so sorry.

 
I am late 20’s, 5’7”, lean with muscles, getting nicely drunk at a house party that I don’t know the hosts, or their friends. But I was invited by a stranger at the first party I was at... I rolled in with no beers as I had no money but really, there’s almost always extra beers at the middle of the evening, right? I am happy, outgoing and looking forward to meeting new chicks.

 
I don’t remember much about you (lots and lots to drink) but your robust drinking style makes up for any otherwise dealbreakers as I eye-lock you across the crowded kitchen. I am at the fridge, I open it up and grab 4 bottles of beer, signaling to you to meet me at the other side of the kitchen island to pick up your fresh beer.

 
When after fighting through tightly packed bodies I find you making your way to the meeting spot… I realize it’s going to be a very exciting night for you and me; you like beer. I smile at you and hand you a bottle. Looking at my other hand you ask where those beers are going? I reply with a smirk that maybe I’m feeling thirsty. You tell me the price to meet you and talk with you is 2 beers and I had better hand over another bottle immediately. Actually, I was planning to feed you another beer but didn’t think you would want to know that intention up front.

 
Sweet! You can hold onto your own stash! We talk, argue, smile and both continue to drink like prohibition begins tomorrow. Soon I’m forging back into the kitchen to rescue the remaining 2 bottles out of the bottom drawer where I hid them earlier, fully annihilating the expensive designer 6-pack that was never mine to drink. This party has real adults, in their 30’s, that buy the good shit, unlike the post-college party I started at.

 
Blackout. Yeah really. Can’t remember anymore at the party, aaaaaaaaandd not really sure how we left and how we ended up at, your place. Yep, your place. That’s where it happens. I think we begin sex, but not sure we finish, either of us. Maybe I fell asleep on top of you and you enjoyed this passive cuddling?

 
I wake up in a panic. I have to pee. NOW!

 
F#ck. I’m in some strange house, you brought me here in the dark and didn’t turn on any lights as you led me into your lair…. I’m so f#cked. I have no idea where the f#ck I am. I have no idea where your bathroom is!! I NEED TO PEE!!!!

 
You keep your bedroom ultrabrutal tidy, some OCD I’m sure. Maybe your binge drinking is an effort to balance the obvious control issues? But it’s cool because I’m in pain I’m trying so hard not to pee as I stand up in bed to walk off the end and onto the floor. Thank god there’s nothing out of place on the floor in the dark for me to twist an ankle.

 
I think I’ve just sprained my stop-pee muscle; I have never been in this type of pain! I can’t do it. I can’t. There is no way I can wander about your house naked, with many housemates in many rooms, searching for the bathroom with the toilet, continuing to hold back the tsunami of urea and uric acid and nitrogenous wastes. Fml.

 
The urine is now backing up, backing up up up into my brain. My brain is full of urine. I can’t think. I want to cry, moan, I want to sob hysterically. This is pain that morphine and fentanyl in no way can block, no way.

 
I see your closet door. I hobble the long 3-feet to the door and open it. It’s pitch black inside your closet, nothing. I need to let this tidal wave out, now! I am drunk, please remember this; I likely have a Blood Alcohol Concentration of over 0.250 and by that I mean a lot! I am soooooo drunk, and asleep! I need to piss like yesterday, I am mad drunk and completely unconscious as I stand teetering naked at your open closet.
 

And, I, pee.

 
This doesn’t seem too bad. I mean, it’s completely dark, I can’t see a thing, there’s nothing inside this closet? It’s empty? I am peeing. Much better to piss a little inside an empty closet rather than pee all over your bedroom. Ohhhhhhhhhh, yes, I am peeing.

 
Still peeing full force I totter a little bit inside the closet. Shit, there are shoes on the floor, lots of shoes, all over the floor. Peeing feels so good, nothing could feel better than complete surrender. I am peeing all over the floor, all over the shoes all over the floor. I cannot stop. This is going down.

 
Then I get a good idea. If I pee in one spot then I’ll completely soak and ruin whatever is there, but if I swing all around, if I pee a little here, a little there, a little over there……. Yes, that’s consideration. I am a considerate one-night stand and I’m no amateur at drinking and dating. I got this.

 
So I begin to swivel my hips and let it fly where ever it may go, in the pitch blackness. I do my best to move my stream, never too long in one spot. I feel good, I am working a plan, with kindness and compassion in my heart, I pee a solid unending stream of hot stinky urine. And then I realize that I don’t need to pee only on the floor, I can also spread it over the blouses hanging on the low rod and the things in piles on low shelves. If each item gets just a little spray then nothing is ruined. She might not even notice.

 
I pee. I pee. I pee. This will never end. I am getting tired with this work. I stop swiveling my hips, I think I’m going to throwup. I remain still, and keep peeing. Playfully I do a thing that all men and boys know, I tilt my hips backward and arch the stream upward. I figure I’ll try to tag some high targets before the peak force of my pee wanes. Just spreading my work out, trying to not ruin any one thing.

 
Peeing. Slowing down, now. Slowing down. Feels good to finish this load. Felt like about a quart. Yep, that is certainly possible when a man drinks a f#ckton of beer. A full hot oily quart of fresh piss.

 
Done. I swagger back to bed and feel like sexytime but also feel like celebration will bring my stomach up thru my mouth, so I gently slide back into bed. I try to swallow some water from your Nalgene sport bottle but my insides don’t want that. Well, they probably do but I fear I’ll puke immediately. And I crash.

 
Gotta pee!!! I open my eyes, it’s barely getting light out, your windows are large and have no curtains or blinds on them. I see you sleeping facedown, have no idea what your face looks like. Can’t remember from just 5 hours earlier at the party. My head hurts, and I gotta pee. I gently stand up in bed and walk over to the edge and step down to the floor, your room is so clean. I grab my pants and put them on in awkward struggle as I move to your bedroom door. I find the bathroom just immediately down the hall, and I pee. I don’t flush because I’m considerate and don’t want to make noise so early in the pre-dawn morning.

 
As I re-enter your room I look over at the closet. Oh yeah, that weird dream….. that was really f#cked up! But…..  and I walk over to the closet, put my head inside, and wait. AHHH F#CK!!!!!!!!!! It smells like a f#cking rat cage!!!!! Nasty urine. EVERYWHERE!!!!!!!
 

Hurrying with fear I pick up my shirt and snatch my shoes from beneath your bed. F#ck my socks? I really don’t give a shit about them at this moment. My undwear too! Don’t need it!!!!!

 
I quickly lope out your bedroom door, shirtless. I cruise down the hallway, down the stairs, it’s getting lighter outside. The stairs are creaky 1920’s wooden but speed is my defense, I must keep moving fast. I must evacuate, now! I can’t seem to figure out which path is the shortest to the front door. I can’t see the front door but I can sense where it should be. F#ck it, I’ll navigate the back of the house, I’ll go out the backdoor.
 
Goddamnit! I have no idea where I am and no idea how to get out of this hell hole!!!

 
I run to the left and then forward, finding the front door. I stress out, freaking that maybe it’s a keylock deadbolt that needs a f#cking goddamned key to unlock from the inside! F#ck f#ck f#ck f#ckitty F#CK!!~!!!

 
Spin two small knobs, unlock the door, grab the handle, push it open…. and escape in my pants no underwear, with shoes and shirt in hand. And I run!!!!!!!!

 
I knew nobody at that party where we met. I only knew about that party by a stranger I met at the prior party. But you don’t know any of that. I can’t recall your freakin name! Maybe you’ve forgot mine? As I run away I take great pains to avoid looking at any street signs, I want to get 10 blocks away in any direction before I learn where the f#ck I am. I want no reason to ever ever ever stroll past your house….. just to look……

 
Eventually, I look at a street sign and learn that I’m somewhere on Capitol Hill, but totally no clue just exactly where and really not the first clue on how to efficiently begin walking home. No matter; presently lost, 6 miles of walking in the light rain in a cotton short sleeve shirt, no socks….. this is the easy party. This is easy. I can do this.

 
Escaping that hell hole of a house with a closet putrifying from 1 quart of hot oily urine sprayed all over every single item……  that was the hard part. Escape. Success.
 

--

 
The next part is fiction, at least, I have no way of knowing what actually happens but I’ll do my best to paint a realistic epilogue.

 
You wake up, face down, your head hurts when you turn it. You may or may not remember “me” from last night at the party. You may or may not remember “me” from last night inside your body. It’s light out, but there’s no sunshine ‘cuz this is Fall in Seattle so it’s raining. Of course.

 
A little bit later you do remember “me” and you remember “me” in all the ways there are to remember. A smile comes to your face, but slips off when you look about your bed, then you look about your room and you don’t find “me.” You instantly consider me a thoughtless dick, in all senses of that phrase. I ducked out after our one-nighter without even a cute note. I leave no trace to ever being there.

 
Your head hurts but you know from your solid career of binge drinking that a glass of Emergen-C with painkillers followed by some herbal tea will be your friends in recovery. You step out of bed and see my socks on the floor by the side of the bed and my underwear hanging from a shitty sculpture you made in highschool but still can’t seem to get rid of. You’ve no idea how or better yet why my worn-out and centerline-stained underwear are hanging from your art?

 
“Maybe he’s still here? Maybe he’s making tea for me? Maybe he’s cooking a sweet country breakfast and using any food he finds in the frig I share with 4 passive aggressive bitchy girls?”

 
You walk over naked to your closet. You open the door. You reach inside to get your comfy robe. You grab your robe and put it on.

 
The overfull and cloistered closet smells like your 10-gallon fish tank when you were in junior highschool and had 6 mice after the original fish residents all died from lack of care. Your closet smells like 4 homeless men have used it as a common urination spot for several months.

 
WHAT THE F#CK!!!!!!!!!

 
--

 
Honestly, I can’t even begin to imagine what you must have thought, felt, endured from my actions. The questions you have will NEVER have any answer that is safe and reasonable.
 

“Who in the F#CK was that guy that picked me up, f#cked me (or not?), and then after I fell asleep he creeped out of bed and sprayed 2-gallons of oily stinky potty urine on everything I own??!!!!!!!!!!!!!!!! Who does that??!! WHY ME?????!!!!!!!!!!!”
 

I. 

Am.

Sorry.
 

This happened nearly exactly 20 years ago, in Seattle, on Capitol Hill. I have finally felt the need to attempt to apologize, in some form. I have suppressed this memory, I have not thought about it. But today 2013 the entire memory was completely unearthed, no longer suppressed under a bedrock of denial.
 

I am so so sorry. So sorry.




TL;DR – I sprayed a quart of pee on all her clothes then disappeared

EDIT:  I  just remembered why she had no curtains or shades on her windows even though there was a streetlight across the road that lit her room up, she said she hated curtains because they couldn't be kept clean and dust free. She was a dust / germ freak.
","TIFU featuring beer, pretty girl, piss and cowardice",1067
Pepser,116,202,1leu9r,783,"So to be honest it was yesterday-night that I didn't feed my cat. I was tired, the cat is overweight and asks for more food three times a day so I thought she could wait until morning. 


I keep the cat food on top of the washing machine, which is in the attic of my house. This morning I found cat food all around our washing machine as our cat decided to help herself, I cleaned it and fed the cat. 


Today I went to work, picked up my kids from daycare afterwards, came home, turned on the washing machine, put on sesame street for my kids and started cooking dinner. 


After about 15 minutes the fire alarm goes of. So I start running around like a chicken with no head and check al the smoke detectors downstairs but non of them had a red light. So I grab the fire extinguisher and run upstairs. Half way up I slip on the huge amount of water that comes of the stairs and badly bruise my arm and ankle. I then leave the fire extinguisher downstairs as fire does not seem to be the problem, and get upstairs again to find out water comes from the attic and leaks into a smoke detector, causing it to start the auto destruct sequence of our house. 


I then hear something fall off the stairs and my 11-month old scream like he has never screamed before, so I run/slide downstairs to find out my 11 month-old had followed me up the stairs since I also TIFU by leaving the gate open behind me. He also slipped and now has a huge bump on his head. 


So then I picked up my screaming 11-month old, check if he is OK, try to comfort him while running up the stairs again and trying to find a way to stop the auto destruct on our house. Which luckily worked. I then go to the attic to find that our cat apparently jumped on the plumbing behind our washer, so that two tubes got disconnected and the washer pumped water straight onto our attic floor. 


So I come downstairs to find that my two year old has used this unsupervised time to first put my phone on some eastern European language (I don't know how to put it back) and secondly is trying to microwave his rabbit (toy). 


Tl;dr: So not feeding my cat resulted in a water damaged ceiling on our second floor, a huge bump on my kids head, a bruised arm and ankle, a huge mess in my house and my phone in a language that I do not speak.  ",TIFU by not feeding my cat,985
MadSusie,128,127,12sshb,786,"I spent an hour making home made lasagna, and just when I was about to put it in the oven...I missed. The pan tipped over, and everything spilled out. 

http://imgur.com/l8ITU",TIFU putting my lasagna in the oven.,913
Bscott411,96,181,1cbqu5,781,"I was at work recently and started feelinging ill. My stomach was really sour so I decided that a pack of peanut butter crackers from the vending machine would help, they were the near neon orange kind. After and hour I wasn't feeling any better so I decided to pack it in and go home. The entrance for the interstate is a ramp that slopes uphill and you have to merge rather quickly without hesitation. So I get up to speed and enter the fray right behind a garbage truck in the right lane. In the left lane is the typical Pennysvania asshole driver that doesn't understand that the left lane is for passing. Right behind me is a woman in a SUV that is riding my ass. The sweet smell of rotting refuse is overwhelming to me. The very next exit is the one I take to get home, I just need to make it another mile. We'll I didn't. I leaned out the window and blew the entire contents of my stomach all over the lady's SUV behind me. Midstream I noticed that it was ompalumpa orange. It covered her entire windshield. To make it worse, she was out of windshield wiper fluid. I watched her in my review view fruitlessly try to wipe off the contents of her windshield. It only smeared it. As I exited I realized she was doing the same... I thought to myself this couldn't be good... She pulls up beside me at the red light. Rolls down her window and I do the same. I prepare for the torrent of obscenity. She looks at me and asks ""You alright?"" I answer her that I am and that I'm sorry for the mess I made. She looks at her vomit laden windshield and says with a puzzled face ""It's orange!"" The lights changes and she pulls away to turn at the next street. Somewhere I owe a lady a car wash. ",TIFU: by vomiting on the interstate.,962
roasthouse,428,228,1bk8cr,776,"This past week I have been helping some good friends of my family move out of their house. Very nice respectable people (Husband and wife). So the other day the husband (Lets call him bob) my two friends and I are helping him pack his garage when he offers for us to smoke some weed with him. Being the pothead I am, he didn't have to ask me twice. So he pulls out this funky looking pipe and I jokingly say, that looks like a crack pipe! And we all laugh as he says that he just got some wax. Well I have never smoked wax, so he teaches me the way he does it, and I light my hit. I do what he tells me and then I get a very funny taste in my mouth. I instantly say ""Wow, that doesn't taste anything like weed I've smoked."" And Bob replies ""Of course it doesn't."" I look at him with a puzzling look on my face and he says: ""You didn't smoke weed, you just smoked amphetamine. You know meth-amphetamine."" As long as I have known this man I knew he was a pot-smoker, but never knew he was a meth addict. I guess it all makes sense now, because he can rebuild a car or bike engine in one night. (On meth I'm guessing).

TL;DR I thought i was smoking marijuana, but I was tricked into smoking meth. ",TIFU by accidentally smoking meth.,1004
AuchnotOuch,138,236,1n4owv,771,"**See photos below**

First off, let me say to never try this unless you do your research thoroughly. I thought I had, but obviously not:

So this happened over the weekend, and my partner told me to share it. 

I had to go to a political science convention in a major city in Texas, and I had been struggling with my weight because of some new medication I had been prescribed for my depression. Unsatisfied with my size, and not being able to fit into my suit jacket properly, I turned to the internet for tips to lose a few inches for a day. I came upon an article that explained how models use duct tape to lose a few inches around their waist for photo shoots. I told myself that I could handle that for a day, a day in the heat of Texas, and feel confident about my appearance in front of Texas representatives and a Senator. Here's how my day went:

4am- Took a shower and wrapped my waist in duct tape. I was feeling generous so I used a whole roll of duct tape.  

5am: Forced to use absolute proper posture, I gallantly floated to my car and held my breath to sit and drive to campus.
 
6am: Carpooled with my Political Science advisor and another student. Sat in the back with perfect posture and short breaths for a 4 hour drive.

930am: Convention starts and I am feeling great, and I am complimented on my appearance by some the students.

10am: First speaking panel begins. At this point, I can feel my chest tighten, and the room gets hotter, but no biggie.

1100pm: First panel ends, and I have to go to the bathroom. It was quite the challenge. I had the most perfect posture for any shitting session in existence.

1130pm: Lunch begins and I am sitting with other students from other universities across the state. I start seeing stars, but control my breathing. Everything is still okay.

1230pm: Second panel starts with the Senator speaking. At this point, there is a layer of sweat wanting to escape from underneath my duct tape girdle, but cannot due to the concrete stay of the tape. I adjust my sitting position and feel a sharp pain in my side; my skin tore. I started panicking, but kept my breathing in check and bit my cheek to help keep the pain at bay.

130pm: Senator's panel ends, and I go for a meet and greet. At this point I am sure I look like I had a stick up my ass, but I push through wanting to meet the Senator. After the meet and greet, I decide to go to the bathroom again. As soon as I sit down on the toilet, I can hear my skin, combined with the noise of the duct tape, tear. It hurt like a little bitch.

230pm: Third panel starts. I am sitting next to the guy that came with me, and I start to see stars again. No ounce of effort puts my dizziness and light-headedness at bay, so I struggle to a standing position, tell my partner I'm not feeling well, and head back to the bathroom. 

245-315pm: I completely undress myself in the stall, choosing to rip off the duct tape as a last resort. I didn't want to have to bear the excruciating pain of duct tape being removed from my waist, especially my happy trail hair. I use this time to air out my whole body, and try and relax. But to my dismay, the pain of blistering and the uncomfortableness of not being able to breath properly, I decided it was time to remove it. 

315-430pm: I slowly wedge my fingers through the girdle, biting my tie to take the pain. It smelled horrible and was drenched in sweat. I find the end of the duct tape and start pulling off. It was easy unwrapping the layered bits, but when I got to the tape on skin part, I was so much in pain, I almost passed out. It took me a good 45 mins to remove most of it, but it got so unbearable, I sat on the toilet seat for a breather. At this point most of my skin was exposed, so breathing was back to normal. My mistake in taking a break was exemplified when I didn't realize I had some duct tape hanging low enough to be in view. Some guy walked in, saw it, and freaked out. Hoping I wouldn't get shot for appearing to use duct tape to strap myself with weaponry, I hastily removed the final bits of tape. This was my second mistake in the stall. I thought using my own spit would help ease it off, and I took a leap of faith by ripping it all off in one pull. *KSHRETK.* I successfully removed all the duct tape, but unfortunately ripped off a good 6 inches of skin. I swayed until I leaned up against the wall, trying my hardest to stay conscious. I don't think I had ever experienced such pain in my life before. I was bawling my eyes out, and biting my tie as hard as I could. After like 15 minutes, I took a deep breath and put my clothes back on, which was painful as fuck since my shirt rubbed against my exposed sub-dermal skin as well as numerous blisters through out my stomach. Luckily, it turned out that the guy that walked in was the guy who came with us, thank god, and returned with my teacher. I embarrassingly explained to them what happened and they couldn't contain their laughter. 

430-8pm: The ride home was complete silence, with the occasional glance in the rear view mirror, followed by a cackle. 

**tl;dr** Duct tape really can be used for anything, even weight loss. 

**EDIT** [Here are two photos so you can see the damage. It doesn't look so bad, but trust me, it hurts like a bitch.](http://imgur.com/YGUabqK,r5uU66X) 

**EDIT2** Yo guys, I am not stupid. I understand the healthy way to do this is to workout and eat right. That is what I have been doing. The reason for my stupid decision is I had ordered a suit jacket from amazon. It arrived late, the evening before the convention, and was the wrong size. There was nothing I could do. 

**EDIT3** Yo guys, I am stupid. ",TIFU by losing a few inches.,1007
Gumby2369,65,264,1exs8k,774,"So I was procasturbating as I normally do on my summer vacations and I stumbled upon a Pokemon meme. First mistake. I had the strong urge to throw Pokemon Ruby in the old Nintendo DS and train those little bastards till they could be trained no more. So began my epic quest to find my NDS and after about ten minutes of searching, it was acquired. 

I had said device in hand and suddenly realized that Pokemon was nowhere to be found. Now usually I'd search for hours but this time, I knew, I fucking knew that it was under my bed. I have a king size bed mind you. It's pretty close to the ground so I couldn't get under it sooooo, using my not so super strength, I hoisted the king size mattress along with the box spring up with one arm. Second mistake. 

I locked eyes with the elusive game cartridge and in an instant of complete and utter stupidity I bent down to grab it. Completely dropped the box spring and mattress, effectively smashing me in the back of the head and pinning me between the frame and the box spring and mattress. I walked away with a massive headache and a hurt back. Needless to say, my Swampert is at level 62 and I'm about to give the Elite Four an ass fucking for the ages. ",TIFU by having a sudden urge to play Pokemon,1038
kate_335533,181,173,1i7odl,770,"Yes. I'm a stripper.

I'm doing it because it pays better than being a barmaid while I'm studying at uni and the hours are flexible.

Anyway I knew my dad and my brothers were on a stag night. What I didn't expect was for them to come into the club I worked at, when I'm mid-dance.

I know they saw me. I finished my dance and vanished out the back, but I don't want to go home now, because I'd told them I was doing office work.",TIFU by my family seeing what I really do for work,943
Stuck_in_the_VCR,177,210,1gnnxv,774,"I read an artificial about how cats like their food warm as though it were freshly killed so I thought ""Hmm, I'll microwave my kitty's wet cat food and she'll enjoy it 10 times more!"" Worst idea I've ever had. It was the worst smell ever. It filled the entire house up with the most awful stench I've ever smelled. I'll never be doing that again.",TIFU by microwaving cat food.,984
[deleted],127,207,15rxnr,765,"We had to run across town to get them cut off. She lost circulation in her hands. I had to follow her and keep giving her rum to keep her calm. I mean, they were pink! Why would pink handcuffs be real? WHO DOES THAT?

edit: Because I keep getting asked- They were not my handcuffs. My friend bought them from a thrift store, didn't realise until later that they didn't have any keys, so she just left them on her table. I thought ""hey wow toy sex handcuffs cool"" and put them on my friend. I laughed, and then handcuff-buying friend came in and said ""oh my god why did you do that they don't have keys!"" which made handcuff-wearing friend freak out and try to get them off, but she only succeeded in tightening them. *And I wasn't trying to have sex with her, what the fuck.*

It went okay.",TIFU by assuming sex handcuffs don't need keys.,972
UncleCornPone,206,120,1c728r,757,Sort of a ambien blackout where i must've thought that going into the foodtruck business was a great idea...and won both auctions.  Now I have to figure out how to get out of it.,"TIFU by purchasing (on ambien) not 1, but TWO food trucks for a total of $53,860. I do not even cook.",877
flatmop,72,205,1df0zs,760,"So I got home and the window cleaners were in the neighbourhood. I really needed a piss, so as soon as the guy had been paid I went upstairs to the bathroom to relieve myself. The blinds were open (you can see where this is going), but I thought; ""meh, he'll start downstairs at the front"" and besides the it's that kind of warped glass that distorts the light so you can't see through clearly. 30 seconds later, and I saw nothing other than the window cleaner's ladder appear outside, and heard footsteps on the rungs. The floodgates were open; there was no way I was holding back this piss. I decided to frantically try and close the blinds instead (the toilet is right next to the window). This was where the shit hit the fan. About the worst posssible thing happened: the blind cord jammed halfway, and as I struggled desperately with the cord my trousers (that would be pants) fell down as the guy's head appeared outside. In a last ditch effort to preserve my dignity, I dropped to the ground, and spent the next minute or so hiding under the sink in shame with my trousers around my legs to the sound of them laughing and taking the ladder down before deciding to start somewhere else. Oh, and I got piss all over my socks.

tl;dr couldn't hold in a piss, blinds got stuck, window cleaner saw my dick, hid under the sink in shame.",TIFU by accidentally flashing my dick at the window cleaner,965
WunderOwl,199,131,10xr68,754,"but I'm trying to pull it off


Update (12:47pm): One of my coworkers gave me a ""Jeans today huh?"" Which I responded to with a firm, ""Yep."" and kept walking. Hiding in my cubical seems to be the safest option.


Update (3:42pm): For anyone still with me I have decided to go all in on the confident ""I'll wear jeans if I want"" angle and my coworkers have seemed to accept it.

End of day update: [how I felt walking out of the office](http://i.imgur.com/9WbAL.gif)","TIFU It's not casual friday, in fact it's not friday at all",885
tresvian,123,203,1bb5xn,749,"Regular day, regular hour in the morning that I wake up to go shower.  I shave if it starts becoming too itchy, a nuisance, or it just looks dumb. I had the great idea to shave in the shower instead of at the sink.

So, there I am in the shower naked as fuck.  Everything was going well until I dropped the fucking razor on my dick.  Now I have 2 and a 1/2 paper cuts **ON THE TIP**.  IT HURTS TO PISS AND FAP.



THANKS OBAMA

[EDIT](http://i.imgur.com/76AkvMW.png)",TIFU when I was shaving my face.,952
stickyturtle,175,155,15kjrt,751,"We have this iMac in our study that pretty much no one in the family uses since everyone has their own laptop. The only time that computer gets used is when one of us has pictures to upload, since there's tons of free space on there and viewing pictures on the huge screen is awesome. 

My parents took a trip to South America recently, so when I got back from college for the holidays they wanted to show me the pictures they took. All was well until my mom remembered they had taken a video of a hot air balloon ride they had taken and wanted to watch it. We searched the computer thoroughly but could not find the video anywhere. My parents seemed kind of upset about it, so as a last ditch effort I went to 'All Videos' in Finder to try and find it.

PORN.

So much porn.

I had no idea what to do. I knew both my parents were standing behind me looking at the screen, I scrolled down really fast but kept running in to more porn. I quickly closed the finder window.

""Umm..I don't think it's on here guys.""

""Oh, I guess it got deleted...that sucks."" My dad said before spinning around and bolting out of the room. My mom left a few seconds later while I sat at the computer and contemplated leaping out of the window of our 11th floor condo.

EDIT - I am a girl, so my mom probably doesn't think that it's my porn. Maybe she thinks it's my brother's, but he's only home like once every two years so that's pretty unlikely. It also makes me taking the heat for the porn kind of weird, I feel like my mother would rather her husband be watching porn than her daughter having a ridiculous porn collection saved on the family computer. 
",TIFU by accidentally showing my mom my dad's porn collection. ,906
Scotch_Rawks,71,207,1ewiyh,753,"So I was walking through a parking lot with my older brother, when I noticed a hilariously shitty parking job. I pointed it out and made a comment along the lines of ""wow, how does somebody like that acquire a license?"" to which my brother replied, ""hey now...maybe they just have terrible eyesight."" 

I should probably take this moment to explain that I'm one of those slightly-louder-than-most talkers. However, I'm USUALLY always very aware of my surroundings, which made this so much worse.

I turned to my brother and exclaimed very audibly, **""well that's why blind people shouldn't be allowed on the roads!**""

And then I heard the clicking. Not ten feet away from me, just behind my right shoulder, was the most evidently blind man I have ever seen. Complete with shades and cane (that's what the clicking sound was, him repeatedly tapping left and right as he walked) and looking - sorry, *facing* right at me.

The worst part is, after the initial embarrassment, my first thought was ""thank God he couldn't see me"" So yeah, I think I've earned the asshole of the day trophy. 

",TIFU by making the wrong joke at the wrong moment,960
eat_vegetables,220,489,1cr0jd,747,"The NoFap community recommended I post this to r/TIFU

###How r/NoFap ruined my only chance at a potential relationship 
    

A couple months ago, I went on a 2nd date with a girl from OKcupid. Originally we planned to go snowtubing but the snow had melt. Instead she invites me over for dinner. I get there, it's just us and it’s going really good. But then, her roommate and his mom shows up. We all hang out and play board games. Now her roommate’s mom is really hot, (and since I was 21 days nofap) I decide to playfully flirt with the mom. The mom is totally into it. It gets late though, and she eventually leaves. It's only me, my date and her roommate left. I suppose her roommate didn't enjoyed me flirting with his mom because I was cock-blocked the rest of the night. 
    

At about 12:30am, we're all very tired and the roommate asks if i'm going to spend the night, (*awkward*). So, they set me up in the ""Guest Loft"" which is an alcove/cubby about 6 feet off the ground right next to this girls room. I'm so exhausted that I just crash instead of waiting up for her to finish brushing her teeth (I should have waited). I’m asleep in this guest loft, right next to this girl's room and I start having crazy sexual dreams. One of the dreams is so intensely sexual that I wake up right away realizing something bad. I look down and see that I justed blasted about 21 days worth of jizz into my underwear (wet dream).
    

I think “holy fuck this is bad - You can't get invited to a girls house and then jizz all over her guest room bed.” I'm freaking out, perhaps I should just run out to my car, leave and never return. I don't know what else to do. So I decide that is my plan. It’s really cold outside and I remember that my sweatshirt is on the floor next to the bed. So i lean over the bed head-first to grab my sweatshirt... except, i totally forgot that I’m in a loft. I end up diving head first down a 6 foot drop.
    

At the last moment, I catch myself on a panel of wood and cabinet. Unfortunately I break both of them, cracking the wall and causing a giant banging sound. Now i'm fucked, I just jizzed all over the place broke her cabinet and the wall, everyone must have heard it! So i run to the bathroom in my sticky underwear while carrying my jeans. Finally some good luck. It’s looks as if all the jizz stayed in my underwear. But now I have to figure out what to do with a destroyed pair of underwear. Do I try to hide it somewhere? Where? They must have heard the crash. They are probably right outside looking to see what happened. I quickly ball up the underwear and shove it down my pants. I go back to the bed and no one is there?!. I look around for jizz evidence. I can't find any, but its dark (i'm like 90% sure that it all stayed in my underwear!) Now my only concern is the smell. I mean, c'mon it's 21 days’ worth of cum. And, she's sleeping, at most,  15 ft away in her room.
    

Anyways, I start to get tired, think *screw it* (she lived 45 min away, it's not like it was a coworker and I would be permanent known as the creep who masturbates all over your guest room while you sleep). So I laydown and fall back asleep. I wake up to sounds of the girl moving around the house. She goes downstairs, so I have quickly make the bed while looking for any cum stains (I didn't see any!). I put all my clothes on while she comes back up the stairs. She jokes about how I'm trying to break her house into pieces. All of a sudden, in slowmotion, i see her nostrils flair. She is starting to smell the jizz! I quickly make some excuse about having to grab some mouthwash from my car. I run out to the and secretly pull the underwear out of my pants and stash it. Now, I made it thus far. I decide to push my luck,  I come back into the house and we hang out for like 2 hours, nothing awkward at all. 

I spent all the next day waiting for a text message: ""Did you cum all over the guest loft?""


    
    


**tl;dr** 21 days nofap, I go on my first date in over a year. I spend the night and paint the guest room.  ",TIFU by NoFap (not masturbating) before going on a date.,1236
beastmode747,228,367,18bag8,743,"this actually happened two years ago but i am new to reddit. 

One Christmas day my parents had both sides of my family over for turkey dinner. roughly about 25 people in total. half of my family is catholic (no sex before marriage) and the other half is pretty much just a bunch of laid back funny relatives. 

after the fantastic turkey dinner me and my girlfriend (at the time) decided to sneak off to my bedroom and get a little weird. the deed was going well when i noticed that my chest had a literal puddle of blood on it. ""what in the actual fuck"" i said. my girlfriend than looked up at me and realized that she had the worst nose bleed in history. blood was pouring from her nose like the fucking Nile river. blood everywhere, all over my sheets, blanket, pillows, me...

i then panicked... what do i do now! in order to get to my bathroom i needed to walk past my kitchen without my family noticing the horrifying murder scene. i got out of bed and tried to wipe all of the blood off of me... not smart. i now have a gallon of dried, smeared blood all over my body. ""fuck it"" i throw on a pair of shorts and try to sneak past my kitchen

as im tip toeing like a ninja past my family my little sister stands up and yells ""what the hell did u do!"". i am now standing in front of my family full of dried blood in shorts and no shirt trying to think of what to do. my grandma was mortified and my parents were embarrassed. i ended up having to clean up, sit at the table for dessert, and explain to my 25 or so family members A) why i was full of dried blood. and B) why i was having sex before marriage. ",TIFU by having sex with my girlfriend on Christmas day.,1110
CooterSquirrel,53,185,1cgvs4,745,"I'm typing this one handed because my left hand is in the process of swelling up....

About 5 minutes ago I was in the back room of my office building pulling the files for a few of my clients... Rested my hand on top of one of the filing cabinets, and apparently there was a hornet chillin there, because it stung me the second my hand came to rest.

The stinger went into the webbing between my index &amp; middle fingers, catching me totally off-guard, and my immediate reaction was to flail around and say ""SON OF A BITCH"" very loudly.  As I was flailing.... my hand went up.... my hand came down.... my hand made contact with my nuts.... and I made contact with the ground.  ""GOD FUCKING DAMNIT SON OF A FUCKING CUNT"" is a vague estimation of what I said while lying there tearing up &amp; breathing hard, although I can't be sure - there are a few seconds that were totally lost....

I got up, stood there for a second, took some deep breaths, then looked up.... My grandfather, who is a coworker of mine, was standing in the door to his office with a very concerned look on his face.  Behind him was a little old lady with a look of pure shock on her face, and I realized she had a perfect point of view to watch that entire episode take place and was sitting there scowling at me.

Gramps kept asking if I was okay, what happened, etc etc..... I stood there for about 30 seconds breathlessly apologizing again &amp; again to this little old lady, who was speechless at first and then grudgingly accepted my apology (""that *did* look very painful"").... Then I retreated to my office for Advil and, of course, to immediately report to the internet the extent of my fuckup.

My fingers are swelling &amp; stiffening and my nuts are throbbing so fucking bad right now, holy shit this day took a downhill turn very quickly...

**TL;DR** - [Fuck ~~bees~~ hornets](http://i.imgur.com/pO46F.gif) (thanks to /u/googie_g15 for the gif)

Edit - Pain in the hand is subsiding quickly, pain &amp; nausea in the abdominal region are starting to sink in heavily.  Whyyyy....

Second Edit - Pain is finally subsiding (unless I move).  The nausea persists... Apparently lunch isn't happening anytime soon

Third Edit - Been home from work for a half hour or so, still a little sore but laughing about it now.  Just got a call from my grandparents, apparently Gramps went home and told my grandmother... Could barely understand her on the phone she was laughing so hard.  I got the ""hahaha oh sweetheart, we love you..."" with the implied ""*even though you're a complete moron*"" (in the most loving way possible, of course) So I guess my whole family is going to know about this and I won't live it down.  Ah well.... Today I did indeed fuck up","TIFU - Got stung by a bee, punched myself in the nuts, swore at a little old lady",930
kicksmalone,157,262,1jw5f5,747,"So I'm visiting my grandparents and uncle today for a sort of nice family get-together. They live downtown in a fairly small appartment; about 3 rooms, a kitchen, and a bathroom. 
The problem is, I had eaten two entire buckets of extremely spicey Buffalo Wild Wings, and had to drop a massive care package about an hour into the visit. I saw that the bathroom was very close to the dining room, in which we were all sitting and enjoying some nice apple pie. I planned on holding it until after the meal, but the oncoming storm of chocolate rain refused to be held back. 
I excuse myself from the table and sit on the can. Not a second later the brown waterfall begins splashing into the water, accompanied by sounds which I never thought my stimach would be capable of making. This continued for roughly 25 minutes, with short pauses in between the torrential shitstorms. I could hear the sounds of fidgeting and discomfort coming from the other room, and by the end I felt embarrassed but extremely relieved. 
I am currently sitting in the living room and trying to make conversation, after having to clean my watery shit off of the inside of the toilet as the water could only take down at most 1/3 of it. 

But the moral of the story is, a man's gotta do what a man's gotta do. 
tl;dr: my grandparents had to listen to me shit a mountain after eating Buffalo Wild Wings the day before. 
",TIFU by making my extended family listen to me rip ass. [probably NSFW],1009
neravistele,265,338,1i4i3e,745,"The title is pretty self-explanatory. A friend I haven't seen for over a year now and I met up today with both of our grandmothers present. We spent dinner messing around under the table, and went over to his house. While watching the Aristocats (best movie ever) on tv we were busy touching eachother and got a little worked up, and what other way to relieve tension by sucking a dick? So while I was working away he suddenly tensed up and said, ""Oh shit! Your grandma!"" It turns out my mother was on the phone and wanted to talk to me, and Grandma walked in at exactly the wrong moment. The boy ended up getting ""the talk"" from my EXTREMELY Catholic grandmother, and I ended up getting it from my mother. I swear, the best way to spread news is through a network of old women. 

Edit: People keep saying there are no gender specific words for myself. Sorry! I'm a girl. 

Edit 2: I know a lot of people are calling me a slut, and I realize that my behavior here makes it seem that way. I recognize my behavior isn't condoned by most people, but for those who care I'm still working out some problems and I'll be okay. I don't actually do this often (to the slut-shamers.)",TIFU by blowing a friend in front of my Grandmother.,1083
stuck_at_starbucks,164,230,121xl2,743,"In my club, the bar is connected to the stage so you can walk around the bar and collect tips. There's a handrail six feet over the bar so you have something to hold onto while you're up there. I figured out pretty quick that the handrail will easily support my 110 pounds, so I was ass naked doing some spiderman shit up there to get attention from the customers. Well, part of the bar flips upwards so the bartender can get in. Guess which part of the bar I was dangling over. 

Well, my manager was looking down at a clipboard and didn't notice me up there. I was focused on not falling to my death and didn't notice him down there. Naturally, I decide to swing on down right while he was passing under me. Wham, my ass and ahem, ""lady parts"" swung directly into his face and he got a nice taste of booty. I panicked and let go of the handrail and fell right on top of him; he panicked because there was a vagina in his face and wasn't ready to catch me so we both went down. 

The whole club almost died laughing and people threw a total of about $200 at us, so at least some good came of it. 

Surprisingly, I'm not fired.

Tl;dr: While working at a strip club I swung down from where I was hanging just in time to land on the manager. ",TIFU and put my bare ass on my manager's face. (NSFW),973
cantreallytell,217,205,1ihcqm,746,"Yesterday evening My Kid Fucked Up by sliding his booty off the toilet without hoisting his weight up first.   Screams and blood followed.  I sent his pediatrician a snapshot of his sliced willy upon which she immediately said ""Pack him up, the way it's positioned it could easily de-glove.""  

For anyone unsure, picture pulling a glove off a hand.  Now make that skin.  Gag.

I got home from the ER after midnight.  He got three stitches, a shitty sugar-free popsicle he refused to eat, and a bitching scar in the making.

",TMKFU by sliding off the toilet seat carelessly,951
jazzillaa,124,177,193fol,744,"Okay to clarify so it's not AS weird, I record my lectures in class and one day I forgot to turn off voice memos and I went to the bathroom. This one guy wanted to go over my notes (because they are fabulous) so I decided to be nice and burn him a CD, and I forgot that there was me going to the bathroom on one of the tracks. Oops...

Edit: I'm female by the way.

Edit 2: No I'm not posting the audio of me peeing...",TIFU by giving a boy in my class a CD with a track of me peeing,921
DontJustStare,350,362,1r5y5m,742,"Usually, I don't eat breakfast, but that didn't matter because my crush was working at the cafe this morning rather than tonight, so that meant I was going to buy breakfast. *(Don't ask how I knew he had a morning shift this morning. I'm not a stalker; I'm just ..observant and resourceful.)*

Before I left I was sure to apply a little foundation and mascara; probably the amount of makeup a normal girl would wear. Usually, I don't bother as I am not the spend-forever-getting-ready kinda girl. Although he has always been friendly and nice, he has never done anything to give me the impression that he was interested, yet I always make the effort to look nice whenever I know I will be going to the cafe. (I know, kinda pathetic) 

Business was slow--probably because it had just opened and normal people aren't up so early, so it was basically just us two and his other coworker. I have liked this guy for the longest and we have hardly spoken other than about the food and other short chats, nothing personal, but this morning that finally changed. He initiated a conversation, and we wound up talking for a bit, including plans for this weekend. I was beginning to think he was going to actually ask me out! But then business started to pick up. He asked for my number, so we could talk more later. I played it cool on the outside, but on the inside I was doing a [dance](http://25.media.tumblr.com/tumblr_lu6b99ng2s1qew6kmo1_500.gif) . 

So, I reach for my bag to get a pen and paper to give him my number since he didn't have his phone on him. Being a little too eager and naturally clumsy, I knocked over my book bag, causing some of the items to fall out. **FUCK ME** Guess what pops out... My fucking dildo.

What can I say? I am a horny girl and it's been 6 months, hence my thirstiness for this guy. I had spent the previous two nights away from home, and I had to rush to pack this morning because I took so long to get ready and prettify myself. In haste, I stuffed whatever I could in the other bags and just so happened to place Sparky in the bag I carry around with the intention of removing it once I got home. 

My eye balls nearly pop out of the sockets in disbelief, and I hurried up and shoved it back in the bag as if that would make him unsee it. I knew it was too late; he undoubtedly saw my 8inch faux cock. *fuck, fuck, fuck, fuck*. 

I expected him to say he had to hurry and get back to work and try to get out of the situation, so I tried to make it less awkward by just telling him, ""Sorry, I don't have any paper. Maybe next time,"" I said in a nervous voice and got out of there. I don't think the situation could have been any more awkward. I just didn't know what to say. My face was down, avoiding eye-contact out of embarrassment most of that time, so I'm not entirely sure how he reacted, but he was probably thinking *WTF, I knew this bitch was weird, but damn*.

I am always cock-blocking myself by being a werido. Well, looks like it's just me and sparky tonight. :( *Forever alone*. 

**TL;DR: My crush for the longest finally gave me the chance to get the D and I cock-blocked myself by dropping my dildo.**


**EDIT:** A couple of points I want to clarify as it seems I was not clear. I do not carry this dildo around on a daily basis. I had brought it with me while I was away from home in a couple of nights. I was rushing to make it to the cafe as well as check out by a certain time, so I just threw my things in my bags. 

*(Sidenote: I clean my dildo before and after each use to prevent UTIs so even if I was carrying it around &amp; ret-ta-go at any time, it would not put me at any risk)*

Also, the cafe he works at is not Starbucks. I took the photo of inside my book bag (listed in a comment below) later that day in Starbucks to *prove* I was not making this up.

Lastly, the dildo came fully out, so it's not like there is a chance he could not have seen it. After it came out, I pretty much avoided eye contact or looking at him at all, so I don't know what he was thinking. 

Now that I have read each comment, it seems like nearly every person is saying the same thing, which is that he doesn't think I'm a weird freak. There is a chance that I may have been over-thinking this situation with my typical skewed, negative perspective. Perhaps, in a few days, I will revisit the cafe without bringing it up and give him my number (I liked this idea more than apologizing as it avoids making it more awkward IMO). I am just terrified of rejection, so I don't know if I will or not. If I do, I will definitely update!

**References:**

[This submission](http://redd.it/1qzppg) explains some of my ""gone wild"" (as some of you put it) photos. 

[This comment](http://www.reddit.com/r/tifu/comments/1r5y5m/tifu_by_dropping_my_dildo_in_front_of_my_crush/cdjxncj) includes the photo uploaded to *prove* this isn't a fake post.",TIFU by dropping my dildo in front of my crush,1104
XO1cat,78,182,1dc2gc,737,"I work in a students union in an office upstairs. My friend works on the reception, right in the middle of the main entrance foyer downstairs. We both are big fans of the walking dead and are both pretty much up to the same point in the series, her always being a few episodes ahead. We love to discuss the show after I have caught up, so I was very excited as I made my way down the stairs one morning to talk about the episode I had watched the previous evening. I was so excited that when I came to the foyer, with my friend behind her desk facing me on the opposite side of the entrance hall, I couldn't help but start lumbering towards her, head cocked, arms writhing and outstretched, loudly snarling, moaning and groaning, doing the best zombie impression I could. I thought it would make my friend laugh, excite her for the upcoming zombie conversation, and also to try and distract her while she dealt with the lone customer who was stood with her back to me, talking to her. The hall was almost empty save the girl with her back to me. As I lurched ever nearer, I was confused as to why my friend was not smiling at my funny joke, but instead looking horrified and almost frozen with panic. It was too late before I realized why. Only two paces from the girl with her back to me, I continued with my brilliant impression, idiotically ignoring my friends grimace and instead increasing the vigor of my performance as I drew nearer.


All at once, with horror, I realized what I was doing. I heard the girls voice as she noticed me and spun around. I could not break character fast enough. We locked eyes, my face contorted, arms akimbo, body bent. She had downs syndrome. She thought I was mocking her. The world stood still as my friend, paralyzed by the proximity of my shame and shock, stared at me, mouth agape. I had no words. I locked eyes with the stranger for what felt like eons before turning tail and fleeing outside.


Fortunately, there were few people about; the entrance hall and reception area is usually packed, so only the three of us know my cringe-worthy shame. 

**TL;DR - People with Downs Syndrome are not likely to appreciate your Zombie impression, no matter how good it is. **",TIFU by doing a zombie impression in the most inappropriate situation imaginable,919
MrJooMonkey,162,257,1f15cz,738,"So there I was showering, just minding my own business, when a sudden urge for a super fart presents itself to me. I let rip a monstrous fart, and before I know it a terrible smell wafts up to my nose. Now, this was no normal fart smell, but something completely different, so I turn around. My shower handle and below it are almost completely coated brown. I let loose a mini-nuke of fart-poop, engulfing my shower handle in a thick coating of liquid molten shit. I tried to wash it away by using a few different kinds of soaps and shampoos, but alas, the smell lingers. Still deciding what to do about the situation.
TL;DR: Let loose a mini-nuke of molten poop all over my shower.

Update: Hey guys, thanks for all the tips and comforting words. The smell is gone, and everything seems to be better now, but damn..... What a morning.
 
Edit: shower head into shower handle. ",TIFU by farting in the shower.,995
Djcalied,153,269,1egpdn,737,"Didn't think I'd be back here so soon... This happened 2 days ago. 

I head over to my friends house around the time he gets off of work was going to surprise him with some beers and a blunt to smoke, I get there before him and notice nobody is home at his house? Weird but whatever I go inside as usual no big deal, decide to smoke some weed on the upstairs balcony while I'm waiting. I hear a car pull up, figure its my friend and I decide I'm going to scare the shit out of him. I'm stoned and imagining the possibilities before deciding to just jump out of the hallway closet and startle him. 

I'm waiting... and waiting... finally I hear 2 sets of footsteps and girl voices and realize its his sisters getting home from swim practice. No matter I'm going to scare the shit out of these girls, going to be awesome. I wait for the perfect moment, just as they walk by the door, I spring out behind them yelling 'don't move!!' 

The older one just doesnt even turn around to look just screams and runs, the younger one goes Laura croft on my ass... spins around and punches me in my fuckin eye! A solid punch too I was more surprised than anything, of course we laughed it off. She felt really bad.

Here's where I fuck up, I let her take a picture of my black eye and now everyone knows I got a beat down from a 15 year old. I'm 19.

Tldr- Got put in my place by a 15 year old girl, whole town knows.
",TIFU and got a black-eye from a 15 year old girl,1006
regretloss,302,209,1peya2,739,"Small backstory: I'm in my second year at university, majoring in Art. I had an assignment about six weeks ago that I managed to persuade a friend of mine to model for me. She agreed provided that I didn't draw her face. She came over to my house, stripped down and posed for me. It was a complicated piece that was going to have several poses from her arranged in a particular way. But she started to get tired after about an hour. On her suggestion, I took photographs of her in the required poses and loaded them on to her laptop so that I could draw from them and then delete them when I was done and that if I needed any additional detail she could pose again but at least it wouldn't be as tiring. The work would still be done in a day but she'd be more comfortable while I worked.

This was fine except that while she went out to the bathroom or to get something to eat etc. I copied the photos from her computer onto a USB drive. Partly so I would have them in case I needed to edit later and shamefully, because she is also quite attractive. She never noticed, the work was finished and she deleted the photos thinking that they were gone forever. I thanked her and left, and things went back to normal.

I didn't think it was safe to leave the memory stick in my house as I couldn't guarantee that one of my roommate's wouldn't find it and look at it so I kept it with me. The photos were buried pretty deeply on the drive so I could use it safely around the place. Until today.

I got a call while I was working on an essay in the library and rushed off. I thought I put everything away safely but a few hours later I realized that the drive was not in my bag at all and that I had no memory of removing it from the computer. I went back but there was no sign of it and no-one handed it in at the desk.

I'm freaking out right now. My friend will freak out if these photos are leaked. It will probably kill her. I've abused her trust and she's going to pay for it. I can't tell (I just can't have that conversation with her) but I hate the thought of these being passed around and her just being blind sided by it.

**TL;DR, I lost a USB drive with nude photos of my friend that I went behind her back to get, and don't know what to do now.**",TIFU by losing a USB drive with nude photos of a friend,948
lilgrizz,236,275,16hjmm,740,"I arrive at walmart around 8:00 A.M. for my job interview. Everything was going perfect so far, which never happen's. I only had to wait 15 minutes before being called to the manager's office for my interview. I had already answerd five or six questions when i felt a strange cramp in my lower stomach. When the manager left to get the CSM manager for my second interview i had time to reflect on what i had done that morning. Woke up, Brushed my teeth, sliped my clothes on, grabbed my lunch and out the door I went. BINGO, I skipped the morning shits. During the middle of the second interview the cramp had got so bad, when i coughed i felt a small rush of warm air flow out of my butt cheeks. I waited a moment hoping it didnt smell to bad, it did. Thank godness the manager never noticed the stench, he began to crack jokes with me, One to many. Trying to seem focused on the interview and not the massive shit trying to escape my asshole I begin to laugh. Each laugh caused my stomach to begin to naturally squeeze the shit slowly out of my bum. Five minutes later the shit is halfway out and I can feel warm poop rather than the cushion i was once sitting on. The Manager began to smell my shit and asked me what the smell was coming from. I proceded to tell him that I had shit myself and would probably have to find a job elsewhere. As I stood up the smotherd shit began to run down my legs, the once khaki pants where now turned solid brown on my backside. As I started to leave the manager suddenly bursted laughing, ""HOLY SHIT SON I THOUGHT YOU WERE KIDDING"". As I was walking out the mangager began to make an announcment over the innercom ""Saying all Assistant Mangers report to the main office"". I then went home and made my girlfriend spray me off with the water hose. ",TIFU By Shiting myself at a job interview.,1015
ossman_,78,235,1iqt4z,736,"Cute gal comes out of the pub after her blind date:

 - How did it go?
 - I would have preferred if it was with you.
 - Cheers to that!

She walks off...

I'm going to be kicking myself for that one for quite some time...

**Update:** Ran in to her today. Apparently it was not really meant like that.

Some back story though. She met the guy on a dating app. But apparently he was not in control of his nerves so he couldn't get anything out during the actual date.

Upside though! I'm on the same dating app. And she found me and started texting me later. Fingers crossed. =P",TIFU by not taking a hint,971
JC08,96,263,1nd364,731,"I posted to random acts of pizza because I felt at wits end because I hadn't eaten in two days and some one was nice enough to order my a 12 inch pepperoni pizza!

I got so excited and gave my savior my information and waited. I waited and waited and it seemed like it was taking a while and then I get a phone call...the person who was kind enough to help me. The pizza guy had been ditzing around on my street for 20 minutes because I gave the wrong building number and it's fucking raining!

God damn I feel fucking dumb I'm trying to apologize for being stupid and I got the feeling that the person who helped me didn't want to hear any of it. I went out and found the guy and I couldn't even tip him because I'm so broke I can barely handle getting free shit clearly. 

I get back, rain soaked, into my apartment and try sending my savior a message apologizing for being a dumb fuck and no response.

Overall, I feel humiliated because a random stranger decided to try to help me and I made their life harder due to my fucking mistake. For me, asking for help is hard and over all I feel like a loser for screwing it up.

I had to get that off my chest. I'm trying to practice self compassion and I don't know how I am going to feel compassion for myself over this blunder.",TIFU with random acts of pizza,994
PurpleTrainRide,173,313,1gg0h4,726,"So it's 2:17  in the morning and I'm playing some COD, yep no life. So I see a pack of sour skittles across the room. Craving that shit I venture over to grab some. Noticing they don't display the new Green Apple flavor  
on the package I realize these things are old. I am hungry though and don't feel like venturing out of my man cave. 

So I take a handful and start to chew. Fucking pop three braces brackets, stuck in my cheek. So I'm spitting blood and stale skittles all over my new carpet. I get up and go to the bathroom, clean up and shit

Realizing my parents may be asleep I am hesitant to go to their room. But wait, they just got home from the bar so I'll tell my mom (usual designated driver.)

Open the door, hear creaking noises. Mouth hurts and is fucking bleeding so I open the door. Worst mistake. Parents are going at it, ""Oh go to bed,"" says dad, ""Nothing's going on."" 

Being fifteen I realize they are commencing in their mating shit so I get the fuck out. 

TL;DR Never eat stale skittles with braces. I'm typing this with a mouth full of toilet paper soaking up the blood as we speak. 

Edit: I had to get stictches but everything is fine now. I'm getting my braces fixed Monday
",TIFU by eating stale skittles,1039
Aithen,65,173,1mtqy5,729,"Let me start off by saying I work in construction. A lot of minor injuries happen on a daily basis so I have built a pain tolerance. Today was a bad day though.

I honestly felt like I was invincible since it was Friday... I fucked up when I decided to act like I was invincible too. So here I am on a work site in the middle of a cul-de-sac with only a port-a-potty as a bathroom... I need to shit bad but I can't use the nasty ""butt hut"", it is absolutely nasty. So I hold it... I mean it's Friday, I can hold out to shit in the comfort of my own home.

So here I am with about two hours before I wrap up to go home and I am nailing in some wood. I decide that to save time I will hit the nails once really hard with the hammer. Turns out I wasn't any more invincible on Friday than I would be on Monday... I hit my finger dead-on, full force. Now remember, I was Prairie Dogging at this time. The force of the impact caused me to get up screaming from the pain and uncontrollably shit myself. Needless to say, I spent an hour, driving uncomfortably home, followed by a clean-up and shower.

TL;DR: Work construction, hammered my finger... Felt like crap... I crapped... Bad Friday.","TIFU by getting the ""finishing blow"".",902
redhottt66,182,131,1du4q7,729,"We just got home from the grocery store and I'm cutting chicken for dinner. My boyfriend starts kissing my neck and rubbing my boobs. When we started kissing my panties fell off.  The next thing I know he is fucking me from behind and talking dirty. He is saying things like ""oh God your pussy feels so good"" and ""it's so tight""  then, ""oh God it's too good"".  
It ended abruptly when my 17 year old daughter walked in. FUCK!!!!!!!
She was not supposed to be home. She has been in her room trying to delete the image from her mind ever since. My bf has been hiding in our room in the fetal position.  I don't know how any of us will look each other in the eyes ever again. 😕🔫",Tifu by having sex in the kitchen,860
buffalocoinz,212,218,194q6y,727,"I had really bad cotton mouth so I grab my water bottle, fill it, drink it all, and then fill it again and drink it again. I go back to bed and I start feeling nauseous. I went to the bathroom because it was inevitable I was going to vomit. I then projectile vomited two liters of puke into the toilet. I had drunkenly eaten a bacon pizza last night so the puke tasted like bacon. The worst part was that the puke also came out of my nose which was rather unpleasant and hurt like a motherfucker. After puking I blew my nose and there were bacon bits in my snot. Not a fun morning at all.

Edit: I think it's funny how everyone assumes I'm a dude. I'm a girl. Girls eat bacon pizza and get hangovers too.",TIFU by waking up hungover and proceeding to chug 2 liters of water,945
assbox22,59,168,1j74gk,721,"Alright. From the title you may think that this is just another fuck up about jerking off after touching peppers. But no. This is worse. Also, this fuck up happened last night, but I had to suffer the consequences today.

I recently went to the dermatologist about these bumps on my skin which I thought were eczema. I was pissed about possibly having an auto-immune disease, but after taking a look at my arm, I was told I have a fairly common condition known as Keratosis Pilaris. If you're unfamiliar with it, it basically means that my skin is so dry, that hair follicles cannot break through my skin and so they pile up underneath and cause bumps. The dermatologist gave me several samples of a cream that would get rid of them. All that the cream does is make my skin peel so my skin will be soft enough for the hair to break through. You can see where this is going..

So, later that night, I put the cream over these bumps on my arms, chest, shoulders, stomach, face, and stray bumps in random areas. Right after I was done, I didn't think about washing my hands. But I did get a random boner and decide to jerk off. I put lotion on my hand, turned on the porn, fapped away, and fell asleep.

I woke up in the morning, and went to the bathroom to shower and brush my teeth. I took off my shirt, saw that my shoulders, chest, stomach, and face started peeling, and it itched like crazy. It was annoying because I also couldn't hide the fact that my face was flaking. I took my pants off for the shower, and lo and behold, my dick was peeling. Shaft, head, and somehow, my balls. The balls itched way more than anything else. I couldn't stop scratching. And since I was scratching bare balls so much, they started bleeding.

So there I am, in the bathroom, scratching my bloody balls and trying to flake all the dead skin off of my penis. I just decided to take a shower and try to ignore it, but it was no use. I was scratching my balls all day, and it was horrible.

TL;DR: I accidentally jerked off after applying a skin cream that makes me peel, my dick and balls started peeling, scratched my balls to the point of bleeding.",TIFU by jerking off (NSFW),889
xxsavage_mikexx,269,294,1ky3b0,719,"This literally just happened. My wife and I both  have discovered vine recently and I have been trying to get her to make some adult content for weeks. This morning after some banter I convinced her to, later in the day do it. So I get to work set up my station and text my boss that I am up and running as I do every morning. It was then I remembered my wife's promise, so I shoot her a text  "" hey how about you vine me some titties"" I hit send. It was this moment I relized I had't actually switched screens and  just sent it to my boss. My very attractive female boss... I immidiatly hit delete, but  not fast enough. I told her my wife saved her new cell under her name on accident and She said it was ok but i am shitting my self right now. 

I included my screen cap for proof
http://i.imgur.com/P0FCrxp.jpg",TIFU by asking my boss to vine me her titties.,1013
EazyDozeIt,145,187,19yzp3,727,"I went to a party last night. Drank way too much.  While fucking a girl in the back seat of my car I passed out.  Woke up at 6am with everything but my pants, boxers, and phone.  Get out of my car with no bottoms on.  A homeless person helped me find my boxers and pants under a car near by and found my phone with a shattered screen in the gutter.  No idea how anything got where it did. 

Update: Thanks everyone for making light of what happened.  Hope everyone got to laugh at my expense as much as my friends and I did.",TIFU Woke Up In My Car,914
a_swaggner,112,181,19xbcx,722,"My friend was in the Vagina Monologues at my university and I had absolutely no idea what to expect. All of my friends wanted to be close, so I followed them to the second row. One girl during it was absolutely hilarious and had me in tears from laughing. After she left the stage, I was thinking how funny she was and didn't pay attention to the introduction to the next part, where they explained the next monologue was about rape. The next duo goes up to start their monologue and I'm still reeling from laughter, so I assumed they were trying to be funny too. I chuckled a few times and my friends all looked at me like I was crazy. My laughter soon faded once I realized the situation. Basically, I felt like the biggest asshole of all time. I explained myself as soon as the show ended, but that didn't stop the dirty looks from nearby strangers.",TIFU by laughing at a rape joke at the Vagina Monologues,903
Alcapwn92,94,325,1q3njh,723,"So I was reading the front page Ask Reddit post on sex. Someone wrote how sex had a certain smell and the following comment said ""Sounds juicy"". For some reason I thought it was hilarious and had a quick laugh out loud. 

But there was a person giving a speech in front of the class...she is also the one person in class who has waited to give her speech on the last possible day because she was so nervous. 

TIL I am an asshole. 

Edit* Words. 
",TIFU by reading reddit in class.,1048
darnoc9265,303,318,1bwhpi,717,"A week or so ago, for my birthday, the family got 2 sister kittens. Cute as a button, aspiring to be true karma-getting machines.

This morning, one decided to hide under the couch. I decided to lift up the couch to check if she was there because I couldn't find her. She makes a sudden movement, startles me, and I lose my grip on the couch. 

She died instantly.

EDIT: UPDATE: I have a new kitten whose name is Gadzooks. He and the other kitten get along quite alright. Thanks to all for the kind messages.",TIFU by dropping a couch on my kitten,1035
baldgrant,65,136,17lhf3,717,"As the title suggests I maced myself twice today and neither time was on purpose. My father is a police officer and I had always been curious about the mace can on his duty belt. So today when he and my mother were out I got the mace can off of his belt and meaning to spray a bit in my hand (unfortunately I had the mace turned the wrong way), I instead shot myself in the eyes....

Now the only witness to me thrashing around on the floor like a poorly clubbed seal was the cat. After several minutes of thrashing I stumbled to the bathroom and flushed my eyes and thought I had recovered. I had not...

When my father and mother returned they noticed my very red eyes and my father accused me of smoking pot, which I denied and tried to explain what had happened. Unfortunately for me I got the can of mace to show him exactly how it happened and you guessed it shot myself in the face a second time with the mace...

On the plus side my father was laughing so hard as I flailed on the floor that no further drug talk was necessary.",TIFU by macing myself twice,853
NewRandomHero,114,222,184iz6,713,"The majority of TIFU stories are about people shitting themselves. Could we please only post *true* fuck ups? If you've shit yourself, please tell us your story on /r/ishitmyself. It should help clear some of the near-identical stories that are in violation of Rule 2: ""No unoriginal or ordinary posts.""

Do the Mods not agree?

Please upvote for visibility, ","[META] Did you really fuck up, or just shit yourself at an inconvenient time?",935
thr0waway53013,413,443,1fcb2q,713,"I live in a relatively wealthy town, but am personally middle class. My mother is a single parent and wanted me to have the best education, so she moved us here.

It's my senior year, I'm bound for college, and I knew prom was really expensive. Our tickets alone were $160 per person and there were all these small things I had to pay for in addition, like limo ($76), afterprom tickets ($50 each), prom weekend ($80). My mom had expressed that it was all very expensive and I felt awful, so I took up tutoring and paid for a lot of the small things on my own (I covered limo for my date and I, as well as afterprom tickets and prom weekend). I still had to ask my mom for $320 (she'll get $160 back from my date), and I knew it was a lot since I'm going to college next year. Even though I got merit scholarships and financial aid, it would still be around $40,000-$50,000 a year.

Last night before prom, I got a last-minute tutoring gig for $60 but in the whole rush of prom, stresses from prom drama, feeling that I had to pay my mom back, and running late, I got into a car accident. It wasn't huge, just a bumper, but it would probably amount to $500 to pay to the guy I hit plus $1,200 for my mom's car which the seatbelt needed to be fixed for.

I honestly felt the worst at that point. Telling my mom was awful. I bawled and cried and was so upset and she originally said not to worry about it, but today she got frustrated (understandably so) after learning about the seat belt thing.

My mom has been unsympathetic, and yes I understand it was my fault for getting into the accident, but I legitimately can't take it. She is not a very sympathetic person to begin with, and I know it's my fault for getting into the accident but I really just can't handle everything right now. I usually don't let money troubles get to me like this, but I just feel so helpless and unable to do anything. I'm an adult now and I want to be able to take responsibility for my actions, but I doubt I can turn up $2,000 in two days.

On top of all that, I go to prom in a few hours, and it's just been an awfully shit day. I've been waiting for this day for years, and it's supposed to be such a memorable night, and here I am crying and feeling awful and typing this on Reddit because I feel like I have no one to talk to about it. 

I just wanted to be pretty and take some nice photos. That's all.",TIFU... I just wanted to be pretty for prom.,1156
muleswithbinoculars,113,112,19ubcp,712,"My wife and I knew something was up.  The baby had shit at least six times throughout the day. On any given day her norm is 1-2 poops. But we figured something she had eaten didn't agree with her.

Yesterday morning I poured her a bottle of milk from a clear container in the fridge. It clearly had milk in it and even had her name on the side of it from using it to take her milk to daycare.

Fast forward to 5am this morning.... I'm pouring my coffee as my wife is dressing up her's. I look over to her and she is pouring creamer from one of those large Coffee Mate French Vanilla bottles into aforementioned clear container. I watch her as she puts the French Vanilla down and then pours in some Hazelnut flavored creamer too. 

I said, ""That's not the baby's milk?!?"" 

""No, it's my creamer.""

""Oh my God, I gave the baby a full bottle of that yesterday morning!""

""Well, the shit mystery is solved.""


EDIT: I should be clear that this is the ultra-sweet concentrated creamer Coffe Mate makes. Just the thought of drinking it straight makes me cringe.
",TIFU By Feeding My 1-Year Old a Full Bottle of Liquid Coffee Creamer,824
unipsych,263,173,17uc7u,716,"So today my mother was in a mood. A certain mood I know well, a mood that drives her to clean. So after deciding my room as her target, she begins to tear in with me by her side. She was going full honey badger, digging through everything, but I believed I had nothing to hide. Then, turning away from a pile I was sorting, I see her leaning over my bed, picking up the one dark item in my room. 
There, in my sweet mothers hand was a crusty, smelly sock that I had been fapping into for nearly a month. My vision darkened as I waited for my doom. My sweet, angelic mother looked upon the sock, and said, ""Something smells..."" Then, she did the worst act I have ever witnessed. Not realizing what it was, she took my smelly, crisp cum sock and took a nice deep whif. A deep sniff that stabbed into my soul like a knife. I calmly took it from her hands, and set it in the laundry basket. She still did not know, but that almost made it worse. TIFU...
TL;DR my mom accidentally sniffed my cum sock.

Edit: I had been washing in with the rest of my clothes pretty often, didn't think it was nasty... Apparently it is. I've grown, we've all learned. It's been a journey, gentlemen.",TIFU by letting my mom rummage through my room,889
furiouspanda1,99,71,xptvu,712,"So today I was tasked with cleaning the shower.  Already needing to use the shower, and with a total lack of common sense or prior shower-cleaning experience, I decided to take the ""two birds, one stone"" route: I would get naked, clean the shower, clean myself, job done.  And so, bravely ignoring the big orange ""WARNING! Irritant, avoid contact with skin and eyes"" label, I set to work.

Unfortunately, during removal of a particularly stubborn stain, things got a bit vigorous.  Appendages began to flap hither and tither, and before long a big dollop of all purpose cleaner had found its way on to my gentlemans sausage.  This being a particularly sensitive patch of me, the stinging began almost immediately, my little soldier covered in a itchy napalm of death.  Not my wisest move.

On the bright side, my balls are now both lemony fresh, *and* limescale free!",TIFU by washing my manlyparts with Cillit Bang.,783
aaronthebaron27,68,272,1nb4j7,711,"Quick back story. I've known the family for a few years now, every summer and easter break I've been working for them at a kids camp since I was 16 (now 21) they've become more like friends in a lot of ways and the eldest daughter and I have been fond of each other for a while. Fast forward and the daughter and I have now been an item for two years. (drunken hook-up WIN)

So...like every guy courting a girl, I visit the family for the first time, not as a friend but, as a boyfriend. Her mum has loved me for a while now and is incredibly optimistic about it and her dad is simply acknowledging this 'thing'. He's one of these all round great guys, funny, level headed etc but obviously has to keep a bit of a distance when a boyfriend appears on the scene to pluck away one of his three daughters.
The relationship with the family continues pretty much the same for the duration of us being together, mum loves me, sisters love me and dad LIKES me. Which, again, is fair. We have our banter from time to time, take little digs and he know's I'm a huge admirer of his stories. This guy has an ability to turn simple things into the most hilarious antics. He's a master of timing and wit. He's a big guy, 7ft odd, big broad scottish accent and whenever he tells a story he just captivates everyone with his signature smile and winking at people to let them know shits about to go down - meaning he'll be retelling a time of when he has annoyed his wife.

(went off on a tangent there - not so quick background)

So visiting now and again I started to notice that her mum was introducing me to people as 'A friend and a camp helper' Rather than 'Katies boyfriend' which, again, is fine. I was a friend before that but I jokingly bring it up one time at the table and we had a laugh about it.

So, it's summer. I'm back in the small village, where the camp is, where I grew up and where all my high school friends are for the summer break and it's the local festival. It was the Saturday where everything peaks and in the evening everybody heads to the one and only village pub. My friends and I had a barbecue at lunch and so we were well on our way to being more than a little drunk when we stumbled to the pub to meet our other friends. Of course, my girlfriends dad is there. The whole village is, everyone is rubbing up against each other in this tiny pub talking away. I know I'm completely wasted and try my best to avoid eye contact but the only way to get to the rest of our mob was to go past him and hope he didn't want to talk to me. He plucked me as we were walking and this is how it happened.

Gfs Dad : 'Aaron!!! It's good to see you, can I introduce you to my friend Laura?'
Me: 'Hey, good to meet you.'
Gfs Dad: 'This is Katies man friend' 
Laura: 'ha, good to meet you'
I was already a tad uncomfortable but...
Gfs Dad: 'Or should I say...the boy who's shagging Katie!'
This is when it hit me. I have genuinely never been so speechless. It was like one of those movie scenes where a dude is about to get run over and his life flashes in front of him but instead of my life it was every time I had had sex with this guys daughter! In her bed, in my bed, in the shower...all flashing in front of me and I'm just standing dumb struck, Laura's cackling and the Dad is looking at me with this big beaming smile, eyes fixed and looking for an answer. He's touched upon something I feel should go unspoken between a man and his daughters bf and here he is bringing it up!
Me: 'Well...yeah...ahu...' 
I was dumbstruck and yet he was still looking at me for a genuine answer. So, as any drunken idiot in that position would do, I mustered up some words I knew I would regret and said 'I do it well' Meeting his eyes. I stared right at the floor after that and walked away.

A couple of days later I popped by to see her and had to wait a little for her to come home so I sat in the living room watching television, her dad came in and we both stared at the tv in silence.

I think we both fucked up tbh.",TIFU by drunkenly talking to my girlfriends dad,983
elshiftyx,123,182,1j050v,710,"To give a bit of background, I haven't slept since Sunday because my job is a wee bit demanding at the moment. I recently moved to a new duty station and today is day 3 of my new job. On Monday, I had to cover a 24 hour duty shift for a colleague. This bled into my normal job on Tuesday. This is not uncommon, and I would normally have just caught up on my sleep Tuesday night. But not this time. Tuesday would be another sleepless night, as I had to return to work early that night for some training in a simulator (a giant video game in a small, mobile, sealed container... this detail is important). At this point, I have been on duty for roughly 48 hours, working tirelessly with another 24 hours to go before I could possibly get any sleep. The only way I have been able to cope up to this point was by self medicating with anything and everything available at my local 7/11. The human body has its limits. At a certain point, it will revolt. The following is a message sent to my brother detailing my untimely shitastrophe: 

The overwhelming nausea that ensued a record-pace consumption of a monster energy drink was only a foreshadowing of the catastrophe to follow. A mere 30 minutes into the simulation, my gunner became frightened by the sound of what he mistook for a buffalo stampede. His error in judgment was only confirmed by the noxious smell of what I assume is my own GI track dissolving itself in the corrosive cocktail of energy drinks, coffee, caffeine pills and a gas station hot dog. To liken it to a normal bout of flatulence would be like comparing a double homicide with the Holocaust. Imagine the entire cast of Bambi simultaneously processed through a wood chipper into a large metal vat and left to stew in a hot parking lot for three days. Now we're getting close. One could use the same metaphor to roughly describe the bowel movement that followed. I'm still unsure if it was fecal matter exiting my sphincter at mach 2 or just the remnants of what my colon used to be.

needless to say, eye contact is still a bit dodgy...

[TL;DR] Today I discovered my body's limit for ingestion of energy supliments. Professional relationships irreparably destroyed... along with a perfectly good uniform",TIFU by being in the Army... and substituting energy drinks for sleep,892
olgaslam,116,283,1h9m9d,712,"Not using a throwaway account because I didn't get explosive diarrhea in front of people. Anyways.
I was sitting in my grandma's house, eating her chips because shit, I'm a hungry teenager. All was going well, until a crumb missed my mouth. Oh, I'll just find it on my shirt later and eat it.
Nope. I suddenly felt a sting coming from my boob, and lo and behold, there was a chip sitting in my bra, and near my nipple was blood.

A chip stabbed my nipple.","TIFU by eating chips, not even naked.",995
PhatDaddy420,81,161,13tfu5,704,"So this happened Friday night, I had a friend come in from out of town, and it was about 7pm and we didn't eat yet. I had to bring a friend's laptop back to her quickly, she lives 5 minutes away. I tell my friend grab something in the fridge, I had mostly fruits and veggies, humus. Not his style, he opens the freezer, spots cookies.

Edit: These are highly potent weed cookies made with clarified butter (no ""grass"" taste).

He had 6 cookies, normally I wouldn't care, but these were some strong ass fucking cookies, as in, I have two of these cookies and I'm GONE.. This guy is a very casual smoker, like one or two puffs once a month if that. And he just had, what I would call A heroic dose of weed.

Anyways, I get back at my house, to find my friend playing some borderlands, I sit down, play with him, not knowing the above yet.

This is about 1h after I left ~40 since I got back, and my buddy just stood up and started pacing around, saying, man, this is so weird, I feel so weird.

A little confused, I asked him if he ate anything weird, or sniffed the humus before eating it (in case it was bad, but it's only 3 days old), and he tells me no, he just had a few cookies from the freezer.

My jaw dropped, I asked him how many he had, he said 4-5 (i checked and he had 6). He looks as me, with the same face of OMG, and says, what's in those cookies man..??

Here started the night of hell.

1h after cookies: Constant talking about random


2h after cookies: He starts freaking out, he's floating


2h1m after cookies: He starts bawling, thinking he's going to die and feels guilty about anyone he's ever wronged.


3h after cookies: Eyes closed, but still talking about his personal life, from life, death, friends, family, who he's slept with, everything.


4h He's passed out, it's now 11PM.


4PM the next day, he woke up, thinking it was all a dream.

He was upset I didn't warm him about the weed cookies, but I didn't think he would raid my freezer either, in the green container under everything stashed in the back, to avoid exactly this.

He said he thought he found the long lost cookie goldmine, and didn't think I would mind.

I didn't mind, I had ~40 cookies, but I think he will now not eat a large quantity of misc cookies in a freezer anymore before asking...

TL;DR: Friend ate some very special and potent cookies out of the freezer because he didn't like the food in fridge. They were very very potent weed cookies. Freaked out, and slept 17 hours afterwards.

I'd like to point out I'm a daily heavy smoker, and 3 cookies puts me on my ass, and half a cookie was enough for my friend to get a pretty good vibe. I have no idea what went on in his head, other than what he said and behaved.

I also took care of the guy, and not mock him, cause I'm not an ass.



UPDATE:

I was speaking with my friend, and I guess he's piecing everything back together, good thoughts, bad thoughts. He contacted his dad who he hasn't spoke to in many many years, as it was something that bothered him during the episode, trying to fix thigs with his ex (not the Eskimo), as he realized what he did, what he wants to do, what he wants to be.

He is saying as fucked up as it was, it ""change my life man, I've got a new outlook on things"". He wants to fix his wrongs, and be a better person. 

He's not a bad person at all, but I guess there are things that he's gone over that he doesn't feel right about and wants to fix it to appease his conscience. ",TIFU: I left my hungry friend in the house alone while I went to the store quick.,865
shoe-suede-blues,187,250,19n2ae,707,"**tl:dr Sent mass mail using registrar's email address declaring all of tomorrow's classes cancelled. Got caught.**

So I was playing around with this thing called Sendgrid. It allows you to send e-mails through a relay server. The important thing to note here is with these kind of servers, you can send an e-mail using any address in the ""from"" field. In short, it allows e-mail spoofing.

I had been watching TPB and WikiLeaks documentaries. I got carried away yesterday and sent a mass mail to my whole batch at midnight declaring that all the lectures of the next day have been cancelled. I used the registrar's e-mail address as the sender. That must be one of the stupidest mistakes of my life. The actual registrar then sent a mail saying that his account had been ""hacked"" and no classes have been cancelled.


Our university has the bloody Cyberoam. Cyberoam keeps a track of what kind of activity each user is doing. I got caught and had to meet the registrar today. With the all the logs in front of me, I can't even deny my actions. I had to give in a written apology.


I'll probably be called before the disciplinary action committee. It's a bunch of soul-less professors. I think I might get removed from the university hostel for a semester. That's bad because living anywhere else is very costly.

edit: i do understand that i have been an idiot, and very childish, wasn't really trying to hurt anybody..it was just a very thoughtless attempt at temporary amusement 

",TIFU by almost cancelling everyone's classes at my university,957
muffinsofgreg,130,102,17yyx2,703,"So a few days ago I went on a long hike in the mountains in SoCal with my friends. I'm the outdoors type, always looking to further my knowledge in survival and the wilderness, etc. Well on the end of our hike, we come across a bunch of pine trees.

I say out loud, ""Did you guys know that pine needles make a great tea? Just rinse them off first and then boil them, its cool because Bear Grylls does it all the time!"" So I pick a bunch of needles, put them in my pack, and forget about them.

Finally get around to unpacking my pack, see the pine needles, and can't wait to get some tea going! I wash them off pretty well, start the hot water maker, and put a good amount of needles in the bottom of a mug. I think, ""Great! Now I'll have pine needle tea, maybe watch some man vs. wild, and just relax"".

Pour the water, let it steep, smells great, mash the needles around the extract more of that lovely smell, and head over to watch some netflix on my computer. Here is how I almost died...Not sure why, but something inside of me was curious as to what exactly kind of pine needles I was using, and how much vitamin C this particular strain had. I've always heard they have more vitamins of some kind...well I'm interested in finding out exactly how much. Take a few sips of the tea, its excellent! Down half the glass, yum! Then I see a few pictures of people making pine needle tea....and it looked nothing like what I had grabbed.

Holy shit, well I know what I have is some sort of pine, but why are they so different? I've made tea before from needles, and I guess yea, they didn't look like what I was using now, how did my memory serve me so incorrectly? Well....search what the hell I was drinking then! Research...pictures...death scare. Oh what's this!? THESE needles I actually found are from the Yew Tree!? Oh, the Yew tree has been used as a form of suicidal poison for years!? Oh, animals that accidentally eat Yew just drop dead, and some lady in the UK was found dead after accidentally drinking Yew tea?? Great....

Well, after a small panic attack, I pulled a James Bond, chugged a fuck ton of salt water, and then jammed my toothbrush to the back of my throat to make me puke. And boy did I puke....

Was afraid to go to bed that night, was horrified that it would kick in in my sleep and I'd just die. I didn't die. But now I realize how freaking easy it is to die...life is so fragile. I'm just glad I didn't end up on the news for being an idiot.",TIFU by almost killing myself,805
spf19,117,133,16mc4r,706,"I work as a network security consultant.  I am ""a large human"" (25 stones/350lbs/160kg).

Account manager and I are called to a bank to consult with their board of directors about the state of their IT -- the gov't has threatened to (literally) chain their doors shut if they don't un-fuck their IT apparatus in a hurry.  

We're ushered into the board room and there are two chairs along the wall (presumably for us).  We do informal introductions/handshakes/etc, and as I'm sitting down, the president of the bank starts to stand and say, ""NOOOO!!!"", but its too late.  Mass in motion... stays in motion.

Instead of coming to rest in the chair, the chair decides to make itself into kindling and literally explodes into splinters.  

There I sat, on the floor, confused and more than slightly embarrassed, with bits of wood stuck in my arm, bleeding, and a stunned room full of very rich and typically very crotchety old guys.

After they saw I was (mostly) okay, that's when the snickering began.  At first softly, then... it became a roar.  I picked myself up as best I could, but there was no recovering at that point.  

When it was our turn to formally introduce ourselves, I began, ""well, there's no need to break the ice as I've already broken your chair..."" which was received with a GREAT DEAL of enjoyment.


TL;DR: broke a chair by sitting on it in front of the board of directors of a bank and still got the job we were there to pitch.


EDIT: forgot to explain why the pres said ""nooo...""  It was because apparently the chair was pre-broken, and purely coincidental that the fat guy chose to sit in it... didn't help ease the embarrassment though.","TIFU by destroying a chair with my enormity, in front of the board of directors of a bank",839
[deleted],64,103,w2r4h,699,http://content.usatoday.com/communities/ondeadline/post/2012/07/san-diego-fireworks-all-explode-at-the-same-time/1#.T_WalLrHaNM,TIFU request: Guy in San Diego who launched 20 minutes worth of fireworks all at once,802
ellybellum,138,130,190le5,700,"I take a microbiology class and in the lab we work with live bacteria.  I was chewing on my pen and then I set it down and my lab partner accidentally grabbed it and shoved it into a Bunsen burner, thinking he had picked up the metal loop (you use this to move bacteria) so he could sterilize it. Then once my pen was on fire, he put it into the nearest water he could find, which was a nutrient broth that contained streptococcus bacteria of some kind.  He gave the pen back to me and said sorry. Then the teacher stopped the class to make a long announcement and when he was droning on I put my pen in my mouth.  Not only did it burn me, but I caught strep throat.",TIFU - Microbiology,830
Iamnotindanger,171,169,1qbztg,702,"It's pretty simple really. 

I work in a pizza store, and this lady phoned up and asked for 6 large pizzas and lots of sides, to be collected. 

-20 mins later-

She comes in and waits for about 5 minutes because there's been a delay on one of her pizzas.

I go to the back to sort something else out.

5 minutes later, I come back. The pizzas are ready so I put them on the countertop.

""That'll be £60 please.""

""Oh, I've already paid.""

""Sorry who did you pay with?""

""That short asian guy over there."" - With a smile on her face.

So I smile, laugh, and say ""Okay, thats fine then"", and let her be on her way with her pizzas.

-------------------------------------
**The aftermath for those interested**:

Later that night (1am so technically the morning), my manager called me saying

""We're £60 short (on our system), do you have any idea where it went? Maybe you put some money in a different till, or put some in your pocket by mistake?""

I said, ""No, not that I know of. I don't have any money on me.""

**-Next Day-**

He phoned me again at 10am saying

""I've just watched some CCTV footage, and it shows you giving the pizzas away without a payment.""

So yeah it ends with the manager asking for a deposit from me (the full £60), just until he sorts the situation out, and gets the money back from her. He is going to bring the police into this.

We are not gonna let this bitch get away with that. She actually committed a crime, and even though it was my fault for not properly checking to see if she'd paid, she basically stole from us.

------------------
**Update: Some Good News**

Manager called me into his office today, he told me the woman paid up!

[No need for me to pay!] (http://www.troll.me/images/teblow/time-to-celebrate-and-i-will.jpg)

He basically told her that we have footage of her. Also we have no receipt of payment. She also said that she couldn't find her receipt... ^^I ^^wonder ^^why.

So she just paid up.",TIFU by giving away £60 worth of pizzas to a customer for free.,871
urbanbourban,103,138,1gil35,696,"This dude has been my best friend for 13 years. He is a music major at a very pristine school, known for it's incredible music program, and he is the best musician I know. He recently got a 2012 Subaru Impreza, and he has has it for less than a week. 

So... Saturday night he picked me up to go to the bar where he was filling in for his friends band. I didn't feel like spending any money, and I wanted to be sober (enough) to watch him play, so I brought a water bottle half filled with whip cream vodka. I guess I should mention that I had played golf all day, and was dehydrated before we left, so I drank probably four big cups of water right before walking out the door.  In theory, it was a damn good idea. Six shots worth of liquor consumed very quickly would give me a nice buzz for a few hours, right? 

Wrong motherfucker! I drank those six shots in about 2 minutes, and on the last sip, I had the misfortune of swallowing a vodka bubble. I tried to burp, but it came up as a little bit of vomit. All good, opened the door and spit on the street at a stop sign.  

30 seconds later, I felt a fucking train of puke coming up. I did my best to cover my mouth with both hands, but the water-vomit-nuke-puke was not going to be contained. I literally covered his dashboard, windshield, steering wheel, the entire front side of my body, my side window, and the floor. 

*Stunned silence*

Him: ""I don't know if I'm pissed or impressed, you covered my entire car but somehow missed me completely.""

So yeah, he was fucking pissed, I cleaned it up, and he played a great show. I will never live that down. 

Edit: The vodka tasted good going down and coming back up.",TIFU by vomiting all over my best friend's brand new car.,834
detap_rettiwt,98,143,14z3o7,697,"Boyfriend recently broke up with me, and while doing some Christmas shopping today at a sporting goods store, saw something I thought he'd want.  Then I remembered we broke up and started crying like girls do.  Found a display canoe and sat in it, cried some more, had a manager come over and ask if I could not sit on the display.  I tried to answer him but couldn't make words.  He and the rest of the employees avoided me the rest of the time I was in the store.  Ended up being too embarrassed to buy anything and left.

Edit: fucked up more by accidently telling him about this post. Awesome. ",TIFU by crying in a display canoe,840
issuesmayexist,199,275,1f2wd7,694,"Sadly today I return to you, TIFU, with another masturbatory cautionary tale. Some may remember me as [the Buckyballs guy](http://www.reddit.com/r/tifu/comments/13uidx/tifu_by_combining_magnets_with_my_urethra_nsfw/). After that incident, I hoped (and, indeed, swore) that I would never darken the door of TIFU again.

Alas.

Once again, I had some time to myself. Having fully explored the magic of sounding, today I was returning to an old standby of mine; self-bondage. Could I put myself in an insecapable situation for a predetermined length of time? Child's play! How dull. What could I do to make things more... interesting? 

I was cautious, TIFU. I was. I am learning wisdom in my old age.  You see, I tested the tabasco beforehand. I put a smidgen- a smidgen, mark you- on the head of my penis, and left it for a while. A nice warmth spread through the poor wee dear. Perfect.

My testing was inadequate.

I strapped myself up, and strapped myself down. I set the clock for 35 minutes; 5 minutes to finish the preparations, then 30 minutes of fun. And here, here is the part where I fucked up. I got a plastic bag, one of those little freezer bags. I shook the tabasco bottle into it a few times. Then I gently, lovingly, carefully placed my twig and berries inside the bag and sealed it up with tape. I now had a darling little condom-like structure, except encasing everything vital to a man. 

From here I moved swiftly. No time for second thoughts. I clicked my hands into place behind my back, and was stuck.

Why, you ask, was my testing inadequate? What had I neglected? The title of the post, O observant reader, may give you some clue. The testicles are deeply, horrifically sensitive to the effects of tabasco. My little soldier was quite happy; he was basking in the rewarding glow of work well done. His cannonballs, however, were not. 

Over the space of thirty seconds, what had been a mild annoyance escalated to the most painful thing I have ever felt. This is not hyperbole. I have broken arms, cut penises, lost love. This was worse. My gonads had been dipped in a sea of molten glass.

Fortunately, I had just enough reach to pull the bag off my poor suffering self. This made absolutely no difference. This was an emergency. I was genuinely worried I had some sort of chemical burn. Visions of hospitals and eunuchs swam through my fading mind. 

Long story short, I used my back up safety scissors to cut through some rather expensive bondage equipment and spent an hour dangling my red and angry self in a sink of cold water. Anything approaching normal body temperature brought the pain back, fresh and new, like a bounding young puppy eager to play. 

Stick to the oral tabasco route, kiddies.

TL;DR: [Idiocracy missed a trick.](http://www.youtube.com/watch?v=wAg1r6zw7Bg)

EDIT: the inestimable Shadekitty has once again lent me his dulcet tones. [Narration!](https://soundcloud.com/rac91790/ball-burnings)",TIFU by putting tabasco on my balls [NSFW],969
burntballs,77,168,12kveo,686,"So yesterday (yes it happened yesterday) my roommate met a girl, I'd seen her a few times because she came over, but today he decided to go over to *her* place. I was pretty happy, as anyone would if they had the house to his or herself.


So, about an hour after he left, I was feeling a little horny. I decided it was time for a good ol' fap session. I was sitting on the couch, watching Dr. Phil, and soon after, found myself stroking away to the moustache-clad man and the 400 pound lummox who was on the show &amp; had just publicly confessed she had cheated on her husband. It was great. I didn't have to worry about a thing. The house was empty, the curtains were drawn -- indeed, it was a fapper's dream.


Shortly after, I finished. Well, it was evident I didn't think things through. My seed was all over my hand, penis and boxers (I was fapping with my schlong protruding from my boxers). So with my free hand, I reached for the nearest thing: napkins. Unfortunately, these napkins were the very same my roommate used to dry ghost pepper seeds (he wanted to plant them later) and I suspect he also used them to dry his hands from their juices (he later told me he had been ""dissecting them"" for youtube, idfk). I cleaned up, and then **the burn started**. Oh my lord, this was WORSE than cutting jalapenos, WORSE than icy hot. My friends, you don't know the pain that comes with ghost pepper cock.


I had *no* idea what to do, so for **6 HOURS** I sat, writhing in pain, watching TV with my penis dipped in a glass of icy cold milk, which I refilled every half hour or so. My roommate came home and it was the most embarrassing thing I'd ever experienced. He couldn't stop laughing. Thankfully, it (mostly) went away when I went to sleep, my penis could only feel a mere tickle from the pepper.


The lesson here? DON'T CLEAN UP WITH MYSTERIOUS NAPKINS AROUND YOUR HOUSE!!!","TIFU by cleaning up my ""mess"" with napkins my roommate used to dry Ghost Pepper seeds...",854
toolazytomakesmthup,101,241,1hr22c,684,"I recently have lost a ton of weight. 100 pounds. But today was laundry day, and I was out of actual fitting boxers so I figured I'd be good with the enormous XXL boxers I used to wear. I was wrong.

I showered. And went into the living room. As I was walking, I kept pulling them up, but it was to no avail. Literally just as I walked past my entire family, mother, siblings, the whole lot, my boxers fell and my man bits were out. 

My brother yelled ""I saw his balls"". I slowly walked to my room, and it twas awkward the rest of the night. 

",TIFU by flashing my entire family.,925
WowzersInMyTrowzers,233,367,1k8nmg,681,"So imagine me (or don't), butt ass naked, legs spread open, doing the knuckle shuffle in the living room. I have a pillow under my ass for extra leverage, I'm sexting a hot girl, there's hardcore milf porn on the 54 inch telly, volume at 80, all the curtains closed, and my clothes strewn across the living room.

I'm gettin' into it. Shit's starting to go down. I look at the clock; it's only 9:30. Mom said she won't be home until midnight. This is my night. I almost felt like I was part of the POV vid. I was connecting with the vid on a spiritual level. I was climaxing, and with any luck this wouldn't be the last time that night.

I'm grabbing pillows, my knees are locking, here it is!... *BANG BANG BANG*

""Oh shit""

It's my mom. She's sick, has come home early, has to use the toilet urgently, and is banging on the locked front door. 

*BANG BANG BANG* 

""Let me in!"" She says. 

""Holy fuck"" I whisper. ""HOLD ON!""

I rush to throw on my clothes and open the curtains. 

*BANG BANG BANG*

I unplug my computer from the wall and rip the HDMI cable out of it as well.  

*BANG BANG BANG*

""Gah. ONE SECOND!""

I hide the lotion, wipe it off my hands, and hide my computer under the couch. 

I'm breathing hard now. I'm shaking, panting, my face is red, and my tent is half pitched. My stomach is about to fall out of my butt and my heart is in my throat. 

I run up to the door and let my mom in. Only after she lets the Four Horseman of the Apocalypse gallop out of her intestines and into the throne does she yell at me. 

""WHY DIDN'T YOU LET ME IN? THAT WAS HORRIBLE""

""Sorry I just got out of the shower.""

""Then why did it sound like you were in the living room?""

""Oh, uh, I don't know. Maybe you're hearing things. Are you ok? You look sick?""

""I'm fine"" she states sternly. 

She goes downstairs to go check on my sleeping brothers. I'm almost in the clear. Now all I have to do is get my lotion and computer downstairs. I run downstairs with all the aforementioned items tucked under my arm. I felt like an all-star running back. I toss the evidence onto my bed and run back upstairs. I can't look suspicious. 

She comes up and tells me she is going to go lay down. Her stomach is upset an it's just not a good night for her. 

""Ok. G'night mom!"" 

I did it. I had won. My masturbatorium was invaded by the mother ship and I had handled it like a pro. I walked down to my room to finish my fap, and what do I see? My computer. On my desk. Open. Milf porn full screen. Sticky note from my mom. ""Nice try.""

EDIT: Thanks for all the love guys. I realize some of you dont believe this story. Sorry to hear that.

Also, LOL to the guy who is going through all of my comment history and downvoting me... seriously? I feel so hurt /s

EDIT 2: To all you naysayers, shit wasn't even crumpled up

http://i.imgur.com/gmzrjHd.jpg",TIFU by jerking it in the living room. NSFW.,1048
TruckerTimmah,108,153,1melv5,676,"So a guy on Craigslist locally was selling a 1982 Mercedes Benz 240D 4spd with a ""blown engine"" the pictures looked good so i went and checked it out, because he only wanted $650 and anyone that knows me knows I'm a sucker for W123s. 

I get there, verify there is no rust, check everything, A/C works, interior is pristine, drive the car a bit. I get back and the car is idling really, really rough and vibrating like mad, with large amounts of grey smoke chugging from the exhaust. (this is a diesel that was out of tune) 

I said to myself ""all it needs is a valve adjustment"" and started counting out bills. He then came up to me and said the car was no longer for sale. Somehow he heard me over that diesel racket and I missed out on one hell of a bargain!!

The guy was not familiar at all with the OM616 diesel engine... Next time I should keep my thoughts to myself... 

Lesson learned. STFU when looking at a car. ",TIFU by accidentally telling the seller of a car what was wrong with his engine.,829
NinjaFishy,133,173,1dmgk1,681,"So I was out of a clean underwear supply, and as uni was beckoning I decided to let myself hang loose for the day, with a plan of washing the clothes tomorrow. The jeans that I usually wear are basically the type that really widen in the crotch area when I sit down, especially if the zips aren't done up. You can imagine what happened next as essentially everyone on the public transport and in my classes would have gotten a peek of my junk. The worst part is that I know it was noticeable, as given away by my friends wide eyed confusion when I saw him.

My god I don't want to go back to classes next week..",TIFU by going commando and forgetting to zip my fly,854
The_VIRUS_Empire,305,313,1d0cm5,679,"Sounds like a good thing right? I've been talking to this girl for a few months, we talk everyday for hours and I had been to visit her a couple of times before.*IMPORTANT*:she already knows I have a crush on her! Anyway... More recently I've been feeling like there really is a connection there so I was super excited to go and see her again. After a really nice day of hanging out and having fun we basically end up falling asleep together on her bed cuddling. A little while passes until she suddenly sits bolt upright and says "" I think it's time to go to bed. "" My heart starts pounding, thinking shit - should I have not cuddled her? I thought this had been going well! I ask her if I should leave and sleep in the spare room like I had done the time before. She says "" you can stay in here if you want "" my heart is in my mouth at this point. I get into bed and basically fall asleep with her in my arms, this is just fucking perfect! 
  Now the day after we hang out some more and I travel back home feeling like a fucking boss but whilst we chat that evening it transpires that she felt really awkward about the whole thing and didn't like me cuddling her, didn't like how I looked at her sometimes and claims to not know how I feel. She hardly talks to me now and I feel like the biggest idiot there ever was :C 

tl;dr - Girl invites me into her bed, tells me the day after that she didn't want me there.",TIFU by sleeping with my crush,992
mcnutty226,57,170,1lkrtr,669,"So I was hungover and tired and about to work a 7 hour shift. In my infinite wisdom I thought it would be a good idea to go for a long bike ride in 87 degree weather. After an hour of riding and feeling like shit I came home in very bad mood. I store my rode bike in my basement, which has this very annoying door that sticks and is hard to open. I turn the handle of the door but its stuck, so I pound on it again and again and again. On my final swing I miss the wooden edge of the door and put my hand straight through the glass, I then proceed to scream like a little bitch as blood begins spraying everywhere. Call 911, go to hospital. All said and done I severed my radial artery and radial nerve, requiring surgery, while I will have most movement I will most likely never regain feeling.

On the bright side I don't have to work for a while.

I'm an idiot.

http://i.imgur.com/ZoLLT2c.jpg
(NSFW GORE)

edit: Sorry for typos, done with one hand from mobile",TIFU by being hangover and severing an artery,839
hot_farts,161,174,ykx3a,676,"Happened today at 1:30 am when I was leaving a bar. Recently I have been getting bored of all the same cliche porn and decided to ramp it up by checking out the unspoken of (preggo porn, midget porn, beastiality... You name it) I have become so infatuated by this crazy porn that if you press the magnifying glass button on the bottom of my htc phone you get things like ""girl sucks horse cock"" and ""dirty midget gets cigar shoved in pussy..."" I know i have a little problem here... Oh well. I wanted to be asertive by giving her my phone which kinda gives her no choice but to enter her number, but her finger slipped over the magnifying glass button and the look of horror in her eyes as she slowly looked up at me was indescribable. She literally tossed my phone back at me and briskly walked away shaking her head. I looked down at my phone and an realized I should have deleted my history.

TIFU.....","TIFU by letting a girl enter her number into my phone, but forgot to delete my sick porn history.",850
digitalhawkeye,208,181,1fjmud,678,"Well not really today, but Friday night.  I had sent my gf a couple of sex toys while she was home for the summer (we're both in college, I'm 28, she's 22), and I made her promise not to open the box till I could get on Skype with her, sort of a surprise.  Well she was really happy to see the toys, started charging the batteries I sent, and I'm trying to get her to get frisky on cam with me.  I end up getting her to take her shirt off and I started playing with myself on camera, when her mother sans knocking, busts into my gf's bedroom and sees me in all my glory and my gf topless on the bed, and proceeds to flip the fuck out.  She asks about the package and my gf tells her it's not parent appropriate and that doesn't help anything.

I'm not embarrassed, I'm angry, but it gets worse, so much worse.  My gf calls me on the phone and tells me that her mom wants to talk to me.  Her mother proceeds to chew me the fuck out, claims that we're making porn, that we're breaking the law, compares me to a pedophile, accuses me of manipulating her daughter, accuses me of taking her daughters virginity (I did) and starting this downward spiral...  I mean her mother is super conservative, really old school, she'd probably think Amish girls are sluts or something.  Making maters worse is the fact that for reasons I don't really follow, my gf's bedroom door has no door knob, no lock, nothing, so there is zero warning if someone doesn't knock.  Now we've gotten away with a lot in the past, but this incident really made it clear just how much her mother freaking hates me.

My gf and I are fine, she knows her mother is nuts, but I am really genuinely worried that this woman might try to either harm me, or try to manipulate my gf (irony?) into breaking up with me.  I should add that her dad just laughed and said we shouldn't have been doing that, and that he might put a lock on the door finally.

I'm trying to laugh about it now, I think my gf is getting over it too (aside from having to live with the nutty old bat), but clearly her mother will not be laughing any time soon.

TL;DR:  TIFU by accidentally letting my gf's mother see my cock on Skype.

**EDIT:**  Let me first just say, wow, I've never seen this many upvotes in my life, Redditors are really kind of a sadistic group, aren't we?  Or at least have a healthy appreciation of schadenfreude.  That said, I do appreciate the supportive comments, and the solidarity from others dealing with parents who are nuts.  I still know I fucked up, but I don't feel quite as bad about it.  I'm hoping the mother is just overreacting and that we can make some peace, but time shall tell.",TIFU with my girlfriend's mother over Skype,859
maldegro,177,214,15g8su,672,"I don't celebrate a traditional Christmas. At least not on Christmas day. Instead I celebrate in Florida with naps, alcohol, and the family. Today, after a long stint with long island iced tea, I passed out on the couch. I woke up, hours later, to a knock on my door. After a twenty minute conversation with my incredibly creepy Uncle, I realized he was looking at my chest for a long time. That's when I saw it. Beneath my completely lace top, my bathing suit had come undone and slipped off of my boobs. Merry Christmas, creepy Uncle. You win.",TIFU and flashed my creepy uncle.,886
Pokemon0891,203,93,14iehu,674,"At a friends house after a night of drinking and I precede to passout on his couch. He works at 5am and woke me up to move from the couch to the bed. I Quick go to the bathroom before even being cognitive and take a piss like any normal human being. I Quick zip my pants up and continue to get a glass of water before I go back to bed. Once I'm starting become more aware of whats going on I notice a throbbing pain from my man hood region, the tip of my dick is trapped in my zipper. Not only do I panic I start to hyper ventilate, sweat, and all around on the verge of tears from the immense pain. I decided to man up and just unzip it as fast as I could. Bad idea. I got my tip unzipped but at the price of a chunk of dick tip. It didn't end there. Still processing the pain and what the fuck I just did to ""myself"" I begin to feel sick. I proceed to stew in my own sweat to weak to pull my sweatshirt off, scared and in shock I throw up and passout on the toilet. Friend wakes me up thinking I just wasnt feeling good. It hurts to walk. 

tl:dr: Zipped my dick tip, vomit and passout in shock. 

edit: Just got done with work, I'm sorry I ruined so many peoples days...but then again imagine it actually happening to you. SO I feel no remorse. My dick is on a leave of absence for a while. I'm currently going to ease the pain with beer. Lots of it. Today sucked. 

edit 2: I don't know how this edit thing works but I have horrible spelling, grammatical, and punctuation skills. Please don't hate me. I've learned my lesson. 

edit 3: Fuck Up Of The Week? I'll take it. ",Tifu zipping my pants.,767
AShadowCast,106,118,13mljh,674,"So I started work again recently, first job in 12 years.

It's a parcel delivery company, 9-5pm. I deliver the shit you order in a van.

First day, no one shows me what to do and I've never done anything like it before. Guy shows me the stack of parcels I have to deliver and gives me the keys to a van. While I'm sorting paperwork the guy adds about double the amount of parcels to my round because they're a man down. Because of my newbie status and the fact that I didn't know what I was doing I set out about 12 oclock, everyone else left about 9.30am.

I have no Sat-Nav like everyone else because I can't afford one. So I go to the nearest petrol station to buy a local map so I can do the job. Begin delivering.

Half way through my day it becomes apparent that I'm behind, not even half the parcels delivered. Fuck. I work through my break, just concentrating on delivering the parcels.

I work my ass off, delivering parcels up untit 9.30-10pm if I could see they were in. At around this time I decide it's too late to be knocking people up and drive back to base, worrying about the amount of undelivered parcels I am returning with. Get back to depot at 11.30pm.

On return to the depot.. They are screaming ""where have you been?! You were supposed to be back at 5.30!"" 


Turns out I was never expected to deliver all the parcels, just as much as I was able to deliver within the time frame. No one told me that. Why the fuck did no one tell me? By adding twice as many parcels, surely I was expected to deliver some of them which would have taken me beyond 5.30pm?!


Why didn't anyone ring me to tell me to come back? I had set off at 7.30 that morning for the job, so I'd been on my feet 16.5 hours that day without a break. I got home exhausted. I thought I was helping the company with the increased load due to Christmas and pulling my weight, but instead I got greeted with a load of abuse for doing unauthorized overtime.
Sure made a pretty penny that day though. I was told the amount I delivered was not bad at all,, but they told me to report to the agency I work for before showing up again. I think I work for the again on Saturday but unsure.

TLDR- Worked my ass off when I wasn't meant to, might be fucking fired.

**UPDATE**

That job was shit. I'm not working for them any more, never went back. Think I'm going to look for something with less deliveries and more miles between them. I love driving but didn't realise how out of shape I was. Also, I like time to think about stuff, learn a language maybe.






",TIFU  by accidentally doing 14.5 hours on my first day,792
VaginaFlyTrap,137,184,1912zv,666,"My SO has been sick on and off for the last few weeks and I just realized that it is me who is making him sick. 
I am a Strep carrier and I have also been tested for Group B Strep when I had my son a few years back and that came back positive. GBS is a form of Strep throat that is located in your vagina and anus (well that is what the doctor was telling me) and they test women who are pregnant so that they can take necessary precautions during delivery so that the child does not get infected.
Well fast-forward to now when it just dawned on me that my SO has only gotten sick after he has performed oral on me. 

I feel like shit and i feel even worse for not being able to woman-up and tell him that it is me making him sick. 

I have just stopped the cunnilingus and stick to straight penetration. I mean just on my end. I will still go down on him but the thought of him going down on me scares me now. My poor love just wants to make me happy and my toxic snatch is trying to kill him!

Edit: it's actually called Group B Strep and it's a bacterial infection but I put Virus. my bad.


**Edit2:**
I told him. He wasn't mad at all, he actually finds it a bit amusing. We are browsing the thread together right now (Me on my laptop and him on his phone) smoking a trench. He says that there are some awful post in this thread and he says to tell /u/dongface to, ""Get the fuck out of here.""

I want to thank all of you who let me know that this really that bad because my vag could be harboring more hazardous things and you all are right.",TIFU by getting my bf sick with my toxic vagina. ,850
doomtowns,143,164,1jp3c0,669,"So .. I was cleaning the lid of my coffee tumbler with about 3 tablespoons of baking soda and two cups of vinegar. Sealed it up (Contigo vacuum seals and can spray boiling steam out when you first use it), shook it real good for about a minute to loosen up the mold.

[Blew the plastic thread off.](http://imgur.com/a/qgx4K#E9rjoBo)

[The cap exploded into the ceiling. Not sure how, exactly. I was holding it horizontally and shaking it. It flew past my face.](http://imgur.com/a/qgx4K#rk34ted)

[It cracked this glass in the sink after hitting the ceiling.](http://imgur.com/a/qgx4K#EfeuyK2)

[All in all, it did a good job of cleaning the window and ceiling. There used to be a lot of tomato sauce splatters up there.](http://imgur.com/a/qgx4K#vg9c602)

Thinking about Xposting this to /r/Howto. I think almost died today. TIFU.",TIFU exploding a hole into my ceiling with a vacuum-sealed coffee tumbler full of vinegar and baking soda.,833
Deracinated,167,135,19697l,667,"My girlfriend is a yoga instructor, and often invites me to her rigorous classes, including one for Sunday morning. I agreed to go the the early 9 am class, and ended up forgetting to set my alarm, or to do my laundry (she asked quite a few days ahead of time). SO there it was, 8:15, and she was banging on my door. I let her in and scramble to put on clothes. I grabbed my old yoga pants, by accident, which I happened to forget they were ripped out in the ass. I start looking for panties. Nope, none. Fuck it, who will be able to see through my pants. Fast forward to class. I was in the front line. We started slow stretches. I realized nothing, until that wonderful pose, where I held my leg straight up with my hand then bend down, and a draft of wind whiffed into my b-hole. I heard giggles. My face turned beet red. I ran out, my girlfriend scolds the class, and we were all let out early. Lesson of the day: **DON'T GO TO YOGA CLASS COMMANDO WITH RIPPED PANTS.** or they will all see your asshole. Pink or not, it's never cute in class.",TIFU by going commando to yoga class.,802
shittyevening,80,136,16wuhq,660,"First off, sorry for the wall of text.

We were out all afternoon, visiting my inlaws. It was a good day, we raided their basement for party supplies and had pasties for lunch. For the uninformed, a pasty is a bready pocket of deliciousness filled with meat and vegetables. Like I said, delicious, but sort of a gut bomb. It was an hour drive home and by the time we pulled into the driveway I could feel some serious business brewing.

I run in the door and made for the downstairs bathroom. As I enter, I peripherally note a kind of ""gloop-gloop"" coming from somewhere in the wall. In my haste to sink the Bismarck, I ignore this and start doing my thing. Ahhh, sweet relief. I read a few pages of my book, then finish up and flush. As I'm leaving the bathroom, I hear that gloop-gloop again, and then a steady whoosh. Suddenly my toilet is a swirling maelstrom of brown, and it's up and over the rim before I can say, ""Oh, shee-"".

I yell to the wife, ""Fuck, the toilet's overflowing!""

God love her, she springs into action and runs for the plunger. There's shit-water running all over the bathroom floor and out into the hall. I frantically corral the dog, who is barking and pawing at the shit-water like it's his watery foe. I toss him in the kitchen, throw up a baby gate, and run back to start plunging.

Suffice to say, this isn't my first rodeo. I know how to wield the poopwand, and I bust out all my best moves. I form a complete seal over the U-bend and rock that shit back and forth like an Amish girl churning butter.

Normally, within thirty seconds there's a disgusting blurp and then the blockage is gone. I plunged for a solid five minutes, really got in there (note to self: need a longer plunger, need elbow-length gloves), but it's no good.

The wife has gone to Kroger to get a mop and bucket. I finally get tired of plunging, and, constructing a crude suspension bridge out of bathroom rugs, leap over the koi pond-sized puddle in my front hall and to the computer.

I Google: **how to unclog toilet**. 

There are lots of plunging tips, but nothing I haven't already tried.

Next tip: baking soda and vinegar. But I can't get to the pantry, it's on the other side of Lake Shitchigan. Besides, I don't need any more volcanoes going off in my bathroom.

Next tip: dish soap and boiling water. I glance at the toilet, which is currently full to the rim with an unholy brew the color of rancid iced tea. There's no fucking way I'm adding more water to that. But what the hell, I can reach the dish soap, so I grab it and squirt 1/4 of the bottle down the john.

A few minutes later I walk back to the bathroom and, miracle of miracles, the water level is down. Thank you motherfucking Dawn! I start plunging again, and I try a test flush. **Big mistake**.

The shit-water shoots back up over the rim of the toilet and I stand there, gaping in disbelief, as it keeps flowing, and flowing.. and flowing. Water's running way down the hall now, and Lake Shitchigan is now Lake Shitperior. I hear a *""bleccch""* sound as my dog takes a sip of the soapy, shitty water, which is now running into the kitchen. I'm past the point of caring and I splash through the shit to the kitchen, where I do my best crouching tiger impression to scare the dog back into the corner, where I set up a temporary barrier of baby gates and the trash can. Finally, the toilet stops flowing.

Right about this time, the wife comes back with the mop and bucket. I was thinking something large and heavy duty, the kind of thing that comes with its own ""Wet Floor"" standup, but the mop she's holding brings to mind some kind of reusable vegan Q-tip. 

While she starts dabbing at Lake Shitperior with this tiniest of all mops, I try the next internet tip: use a wire coat hanger as a snake. 

**Pro-tip: don't ever use a fucking hanger on your toilet.** Not only was it totally useless on the blockage, but hours later, after the mess finally cleared I found deep scratches in my toilet bowl that I'm sure I'll be charged for.

So finally we give up and the wife calls the emergency maintenance hotline. A recording tells her, ""This line is only for maintenance emergencies, like a blockage in your *only* toilet."" This isn't our only toilet, but we're not waiting for fucking Monday. Nobody picks up, but we leave our number for them to call back and begin assessing the damage.

There's half an inch of filth in the entire hallway, plus some in the kitchen. Thankfully it hasn't spilled over onto the living room carpet. However, this hallway has a closet where we keep decorations we don't have room to put up, which currently includes family pictures and college diplomas. **The whole. goddamn. closet. is full of water.** I can already see it wicking through the bottom of the boxes like some fucked up Bounty commercial.

I take my terrified dog upstairs, run back down, and start flinging boxes out of the closet. They're soaked, and as soon as I lift them they crumble and spill candles and decorative soaps and what-have you everywhere. 

The cleanup is not working. My wife is mopping like a champ but the Vegan Q-tip is barely making a dent. Finally we decide to sacrifice some towels and the broom and dustpan. I build a half-assed cofferdam and start shoveling little panfuls of water into the bucket.

Fifteen minutes later, we're starting to see the end of it when maintenance finally calls my wife back. I hear one end of the conversation:

""Yes, our toilet's overflowing. There's water all over our downstairs.""

[Pause]

""Oh, you say the sewer is blocked for the whole building?""

[Well fuck, at least it's not my fault.]

""So are you coming to fix it?""

[Pause]

""Oh, you're forming a plan of action...""

[Pause]

""But you're coming out tonight to fix this?""

[Pause]

""Oh good."" Click.

Some time later, the water is all mopped up. The bathroom's a wreck and everything needs sanitized, but at least the lake is gone. We're going through boxes, unwrapping and throwing away shit-soaked valuables, when maintenance shows up with a Shop-vac. We tell them there's nothing left to clean up, and they say, ""Oh. Well, can you flush your toilet so we can make sure the blockage is fixed?"" We do, and it apparently is.

The wife asks if we're going to be reimbursed for the sewer backing up, or the cleaning supplies we bought, or for the treasured possessions we're currently tossing into garbage bags. Maintenance guy says, ""Uhh, yeah, you're going to have to ask [Property Manager] about that. But she's going to a conference. So definitely ask her next Friday.""

It's a couple hours later now. Everything has been double-Swiffered and Clorox wiped. I've taken a shower and washed my hands so many times they feel like sandpaper, but I still feel dirty. I'm hungry for another pasty, but I'm not ready for that yet emotionally.

tl;dr Delicious pocket snack inadvertently triggers a tsunami of shit that wrecks up our house, wife and I clean up with comically ineffectual tools.",TIFU by flushing a toilet,796
donutsnbacon,105,179,16g92b,662,"Was at a college basketball game. Had been pre-gaming with beers at friends house before. A little tipsy. Got to game. Bought biggest beer they had.  Sat down in seat.  
Put beer b/w my knees to take off my jacket.  Beer started to slip down.  My instincts took over, squeezed my knees together to hold onto beer.  Entire contents went up and over onto little girls head. SOAKED!! 
I muttered something about going to get napkins while her father who is twice my size is glaring angrily at me.  Ran down the stairs and promptly left the venue.  
I KNOW I KNOW,  I'm a dick!!  Just way too terrified to actually return with buttload of napkins and try and fix the situation.",TIFU by dumping a 24oz. beer over an 8 yr. old girls head.,841
heylookbillsonline,104,221,1k0x2z,661,"My sister recently took a trip to Cape Cod, but could only find a flight out of a nearby city which was about 2 hours away. She needed a ride because she doesn't have a car so I figured no problem, I'll drive her. 

She was set to arrive back yesterday at 6 but I made great time and got to the airport at 5. The parking fees at the airport were determined by how long you had been parked, so I decided to chill out in a Holiday Inn parking lot next to the airport and just fuck around with my phone for 30 minutes. 

After 10 minutes I think ""Why don't I just hang out in the hotel lobby? They'll never know I don't have a room, and if they ask I'll tell them I'm waiting for a friend. It'll be much more comfortable than this hot sweaty car"". 

Things got weird really fast from this point. As soon as I enter the hotel I immediately notice how shitty it is. It's not rundown or dirty, it just looks bare, with no carpeting anywhere and not a person to be seen at the check-in desk. People are walking around but they're all hurried and middle-aged. It was odd but I took a seat in this big ass green chair and started to get comfortable. Not even ten seconds pass before I hear someone yelling ""Excuse me sir! Can I help you?"". 

My heart was racing at this point because this hotel invasion was one of the most bad ass things I've ever done. I stammered over myself and told her I was waiting for a friend, and then she drops this on me:""I don't know if you noticed but this hotel isn't even open for business yet, I suggest you leave before we call the authorities and report you for trespassing"". 

I said ""Y-y-ya caught me haha"" and I scurried out of there with a red face dying of embarrassment. I ended up parking in the airport and it cost me $4.35, damn.",TIFU by trying to save 2$ on airport parking,882
allyallyally,105,81,vh6hl,656,"Said co-worker came to work wearing a green and red dress. What I meant to say was that she looked very festive.. brain fail had me saying she looked fuckable.

Now everyone in the office thinks I'm a crude lesbian.
",TIFU by telling my co-worker she was fuckable..,737
claireashley31,148,90,v557c,642,"We're at my lake house, and I'm sitting on the dock, reading my mom's kindle. A hornet comes up and is buzzing around me, and I'm super allergic to all types of bee stings, so I swat at it hard enough to stun it, effectively smacking the shit out of it. As this happens, the kindle flies out of its case and arcs gracefully over the edge of the dock. I see it about to hit the water, and (thanks lifeguard training) start to dive in. I realize I have my iPhone on me, and throw it over my shoulder mid-dive. I'm able to grab the kindle before it hits the bottom, but the damage is done. And my iPhone glass cracked. Yeahhh. ",TIFU by throwing my mom's kindle in the lake. ,732
obviousthrowawayffs,264,440,1oe82g,645,"So my son is 21 years old, and let's just say he's a bit lazy. He has never held a paying job. His mother and I have paid for his food, clothes, car, and most importantly SCHOOL even after he turned 18. He has never taken an ounce of responsibility for his own well-being, and wastes most of his time drinking and playing in his shitty cover band. Well, last night he informed me that he was going to be dropping out of school. Several weeks too late to be refunded for any of the semester. Needless to say, my wife and I were furious. Throughout all of the things I've put up with from my son, his willingness to obtain an education has always been the saving grace that has kept me from throwing him out on his ass. But I held composure, and he remains in our care. So today, my son decided that he was going to hang out with some of his friends and celebrate his newfound freedom from what responsibility he had. Now, our dog is a Great Dane, and is rather fond of his room. While she has certainly given us less trouble than our useless son, she does from time to time have accidents in the house. I had off from work today, and so while my son was out and my wife was at work I took it upon myself to take a shit in his (unmade) bed. I also made a point to piss on a pile of his clothes, just for good measure. After the deed was done, I relaxed and watched TV while I waited for my son to come home. By the time he found his way back to the house, my wife was already home. When he walked into his room, the results were at first predictable. A slew of expletives alerted me that he had found the surprises I left for him. It was very hard not to laugh, but I managed to keep control of myself. When I got to his room, my wife was already there, with a concerned look on her face. It was then that I noticed the feces I had left on my son's bed was thoroughly streaked with blood. In addition, a modest amount of blood stained the sheets around it. Not being a man who looks at my own shit, I had failed to see that I had been laying blood covered brown eggs on my son's bed. So now the dog has a vet appointment, and my wife is very worried. She absolutely loves that dog. And of course I'm aware that I need to see a doctor, but I'm not entirely sure how to go about it seeing as how my wife and I keep close track of each other's comings and goings. Not only that, but the insurance is through her work, and she handles all of the paperwork for it. I've already looked for urgent care clinics in our area. There are none. Shit.",TIFU by shitting on my son's bed and blaming the dog.,1085
Potatofetish14,50,163,1glf2b,647,"This wasn't actually today but I was thinking about all my fuck ups through out my life and I thought you guys would enjoy this story. I was doing some work for a lady who helped baby animals get back into the wild after they are injured or parents have died and need taken care of. She wanted me to help build a barn/cabin for her deer and other animals. I had been working on this building for a while now and was almost done except for the roof. While up there i lost my grip and began to slide off of the 14 foot roof directly landing on a moose. This moose wasn't a baby or anything so I didn't smash a baby moose into the ground. Although young this moose was still much bigger than me. And could have easily smashed me instead. Luckily it ran off. I felt incredibly bad for possibly injuring an orphan moose but he turned out to be just fine. So I was beginning to forget about this moose incident when I was putting up some fencing  after taking a break from the roof after my fall. I noticed one of the deer had been following me around for a while so I decided to kneel down to pet this animal. I think this deer had seen me hurt his moose friend and was here to back him up. He wet up on two legs and raised his hoof over my head. He then brought down his mighty hoof upon my head. This was a small deer but I feel I had been hit in the head with Thor's hammer. At the end o the day I had a sore back from falling off a roof and a hoof mark on my head. 

TL;DR fell off of a roof onto a moose, was forgiven by moose but Deer friend didn't take to kindly to my clumsiness and took revenge. ",TIFU by falling off a roof onto a moose and attacked by a baby deer in the same day,810
thehornynudist,134,239,1k3txe,640,"It all started when i woke up at noon and saw my little buddy was ready to tackle the day with some good old fashioned fun. I had realized my father, brothers, and mother had all vacated the house for a family trip,in which my brother and i would meet them on after he was to come home from work so i was free to roam around. Being a person who sleeps in the nude i thought it would be a good idea to say ""fuck clothes today, I've got an empty house til 4pm may as well enjoy myself and hook my laptop up to the big screen TV to jack my hammer"". Once I picked my favorite porn and got her going in full 52 inch HD glory I started to get into it. About 10 minutes in i hear the rumble of the garage door and say to myself ""surely my bro cant be home from work this early, what is happening?"" and then i hear it, my moms voice in crystal clear quality like I've never heard before asking if i ""had anything to eat"" from down the hall. Panic sets in and i run to unplug the laptop from the TV, but its to late she comes in to a cheesy 3-way pornography full bast on the big screen and her naked son with a raging boner standing there in the TV room. Her only words were ""Oh?!?"" and quickly scurried out of the room as i unplugged my laptop and ran to my room upstairs in embarrassment and shock, where i have been for the rest of the day only coming down for food when my mom isn't in sight. 

TL;DR: woke up horny to empty house, in which i was walked in on by my mother, jacking off fully naked in front of our big screen TV

EDIT: i did end up finishing in my upstairs washroom with the security of a locked door
",TIFU by getting caught jerking off by my mom... in the nude,879
shopping_cart_whoops,58,100,12w4aa,636,"Was doing some grocery shopping with my 2 kids (both under 4.) They were loaded into a 2-seater race-car-styled shopping cart, little steering wheels, they love it and it makes shopping a bit easier. 

On the way out to the car I thought I'd be the cool dad and pop a wheelie. I set my foot on the axle gave a little push down on the handle. I grossly misestimated the center of gravity. The whole cart-grocery-child system turned into a type 3 lever with their noggins headed for the asphalt.

Still holding the handle I tried to get under them. My elbows and ribs ended up taking the brunt of the impact. The kids were shaken, but okay. I cracked 4 ribs and bloodied my elbows up.

This was actually a week ago, but it still hurts to breathe.

Fucking idiot.","TIFU by crashing a shopping cart, cracking some ribs, and nearly killing my children in the process.",736
Rhynovirus,143,245,1nm8iq,634,Title should be self explanatory. I'm on my feet most of the day with few bathroom breaks. Oh the pain.,"TIFU: I ate leftover Taco Bell for breakfast, chased it with dark roast coffee.",879
f40ph125,101,164,1gec1f,640,"8AM: Watching cute redhead give a BJ. Laptop computer suddenly loses power and dies. Leave it on charger all day.

7:30PM: Go downstairs with laptop, completely forgeting about earlier activities. Press power button, Windows boots up, video starts playing before I even log in. FUCKx10^27

My dad was sitting across from me on the couch. He heard.

I have to go eat breakfast with them now. whoopee.

And since I have a feeling someone will ask (courtesy of /r/shorthairchicks)NSFW: http://xhamster.com/movies/1236838/blowjob_and_facial_outdoor.html",TIFU By letting my parents hear my porn,804
iamarealgrossgal,171,145,16h0q2,635,"Title says it all. Throwaway for obvious reasons.

I was trimming my pubic hair before a date on the offchance that I might get laid. I got a little careless and trimmed off a piece of my labia. Just a snip, and a nice chunk of my labia minora was gone. It began bleeding profusely. I was sitting there in pain, holding some toilet paper to my vag, cringing. I looked at my scissors and sure enough, there was a small bloody bit of skin on there. 

When I got in the shower, I DOUBLE fucked up because I didn't realize that the shampoo rinsing out of my hair would sting. And BOY did it sting.

I am disgusting. Today, I truly fucked up. And ALSO will not be getting laid.",TIFU By trimming off a piece of my labia before a date.,780
plzdontjudge,103,186,1kl27d,629,"This actually happened last night, but it was after midnight so technically it was today. Anyway, last night we had a little get-together to celebrate my last night in town before moving back to college. It was just myself, my best friend, and about six of our friends. There was of course alcohol involved, and my best friend decided to partake...hard. By about midnight he's sufficiently trashed so driving home is clearly not an option. In fact, it had stopped being an option about an hour prior. Rather than mess with having someone to come pick him up, he decides he'll just spend the night at my house. No problem, he's slept over a number of times. My brother had already moved out so I brought his mattress in and put it on my bedroom floor. So by about 4am we're all settled in for the night, I in my bed and he on the mattress. While he sobers up, we chat for a bit about how much we'll miss each other and what not, then we decide to get some sleep. A little bit later, I wake up and have to pee. In my barely-awake state of mind, I forget that the mattress is pretty much right in between my bed and the bedroom door, so I proceed as usual. Suddenly, I encounter the mattress and trip and fall. I take a second to come to and contemplate the mysterious appearance of a goddamn mattress on my floor. I then remember that my best friend had slept over. No problem. But something is amiss. I notice that my right hand seems to have landed in some sort of icky, gooey substance. ""What the fuck?"" I muse out loud. I then hear my friend's voice: ""Um, dude...I'm pretty sure you just landed in jizz."" Turns out my friend had just completed a semi-drunken masturbation session and had not had time to clean himself off. I stood up, turned on the light, and realized that not only had I landed on his bare-ass naked body, my hand had in fact landed directly in a puddle of his manjuice, which was presently dripping in between my fingers. We both shared an awkward bro laugh about the incident, then agreed to never speak of it again.

TL;DR: I woke up in the middle of the night, tripped, and landed on my naked best friend and his jizz.",TIFU by tripping and landing in my best friend's jizz,815
Stellarce,81,104,11yrdx,629,"I just got a new skirt and was really excited to wear it. The fabric was a little thin but it's also dark red so I didn't think I had to worry about anything. Unfortunately, wearing black panties with a bright pink MUST HAVE written across the butt was poor taste. I was completely oblivious that everyone could see my panties while walking around school all day until my roommate burst out laughing when I returned to my dorm.  ",TIFU By not checking my outfit before I left,733
Fioricascastle,75,118,124mgs,630,"I was at a Marriot for a huge conference with all of the bigwigs in my company as well as peer managers. About 300 people in total. At the tail-end of a 10-minute break I realized I should go pee before we are stuck in conference again for 3 hours. I make towards the bathroom and my boss passes me with a comment like ""Don't we start buck up soon?"" What I meant to say was ""Yeah, I just want to force one out real quick."" What I actually said was ""Yeah, I just want to rub one out real quick."" I entered the bathroom and went into shock mid-stream.",TIFU and told my boss I was going to rub one out in the bathroom.,748
noketchup-plzhalp,66,143,18xbdm,631,At 10 this morning I grabbed a red hoodie out of my closet. My clothes hangers also happen to be red. I'm yelling down the hall to my husband that I have to run out and to watch the baby. Then I shove my arms up the sleeves and push my head through the hole as hard as I can. Except I'm blocked. My nose crunched and started to bleed and I furiously begin to fight my way out of the thing. After kicking our computer chair into our bedroom door my husband finally came to save me from the attack. I bleed every where and he laughs like a little girl. I still am in shock that this was real life.,TIFU by putting on a hoodie with the hanger still in it. ,774
DSTFU,101,159,1oqlzi,620,"I was coming home from work on a semi-crowded rush hour Toronto subway. I was standing hanging onto a pole and the seats were all full. In my hand was a book so I was holding on with one hand and two planted feet. Suddenly, the train brakes and somebody behind me smashes into my lower back, catapulting me forward. I throw the book in the air (did not expect this, so I was holding it loosely and holding the pole loosely). The book whips into the air probably a couple metres down the train and my hand that was holding the book but is no longer whips forward all in one steady motion. It's coming at the force of a punch and of course there is a mother and her baby sitting in the seat in front of me. My hand whips into the babys face (although it wasn't a real ""punch"" since my hands were spread open to impact the fall) and I slap him unintentionally. I think I knocked a couple brain cells loose. He's crying and I'm blubbering an apology, everybody on the train is glaring at me even the person who pushed me from behind in the first place. My book is awkwardly sitting 3 metres from me. I walk up to it and get off at the next step. I feel like a bad person now. ",TIFU by punching a baby,779
[deleted],157,90,wf91p,624,"Today a few friends and I drove down to our local Walmart. As we were walking through the store, my friend was about to shit himself, so we cut through the baby/toddler section of the store to get to the bathrooms. I noticed that in the case type thing where they keep the strollers, there was a huge gap in the boxes. After my friend got back from the bathroom, we all walked through again, and I saw the gap again, but noticed the inside was almost empty. I proceed to get everyone in the group to fit inside (there were 5 of us). We built a fort inside of this case, and hung out in there for a while. 


We noticed that people didn't notice us on the inside, so my friend Emily gets a devious idea. She pulls an air horn out of her purse, and dares me to scare the next person that walks by. I accept the dare, and like everyone else, I keep an eye out for unsuspecting people. I see a mom approach, and right as she's right next to me, I don't do it. The others ridiculed me, so I decide to give it another go. I hear foot steps coming close, and I duck down a little so the person couldn't see me (unfortunately, I couldn't see the person either). I get the air horn ready and as the footsteps are right next to me, I pop up, and push down on the button. 


As I've pressed the button, I look up to see a little boy who was no older than 6 years old. He was about one meter away from the horn when it went off. His eyes open up wide, and I see a look of terror on his face. I stop pressing immediately, and the kid stands there silent, and white faced for about three seconds. He then let's out a shriek from the depths of hell itself. Tears stream down his face as he is screaming, and I notice this awful smell, only to realize the poor kid has shit himself, and it's running down his leg. He turns and sprints all the way to the other side of the store, screaming all the way.


My friends turn to me with their mouths wide open, completely shocked. I give them the same look back. We gather our things, get up, and leave the fort without a word. We walk all the way to the exit, get in the car, and leave. After 2 minutes a feeling of horror hits me full force like a punch to the face. I have never felt worse about anything in my entire life. 

Today, I fucked up.

Edited for formatting/spelling error 

Edited for managing to fuck up the formatting 
",Tifu by scaring the shit out of a little kid,714
astonesthrow,119,123,zm7hf,622,"TeslasAirship suggested I submit this to this subreddit.

Background: My husband works nights, we have a daughter, we live in a duplex. The people sharing the duplex had their house broken into, in the morning. I've been paranoid ever since and sleep with a metal bat by the bed. I am on my period and slept naked with a tampon in.

What happened: Dead asleep. Husband calls me to pick him up from work, since I have the car. Phone is under my pillow. Loudest. Ringtone. Ever. Wake up in a panic. Sit straight up. Reach for bat. Tampon torpedoes out of body followed by a freshly-undammed-geyser of blood. Panicking now, trying futilely to keep sheets from being ruined and fumbling for the phone in the dark with bat in hand. Hit face with bat in said panic. Abandon search for phone. Now running to the bathroom with blood all over hands, bloody nose, and blood spewing from nethers. At this point I am wide awake and at the sink turning the knob, trying to rinse one hand to grab tampon while nose is flooding into the water. Being tilted this way makes my nose itch with the blood trickling out. Sneeze all over mirror. This makes more blood come from the ladybits.

I hope I am never murdered. Because if they search my house with a blacklight, my God.",TIFU my sheets (x-post two-x),745
Anal_Floodgates,176,254,1j51xy,614,"I sit here, my bare ass on my computer because my shorts are covered in shit.  Of course I could watch them, but my priorities are straight and I want to share my story.  Like all great stories, this one starts with a trip to Burger King.  I was hanging out with some friends and we were waiting for another friend for a lift.  We were hungry,and the only place nearby was a Burger King.  I'm not a big fan of Burger King, but I don't hate it, so I go and have a meal with my buds.  But little did I know that this tiny Whopper Jr. would lead to such chaos and anal destruction.

Immediately I felt something wrong, my stomach shouldn't rumble this much after a small meal, but I thought it was just gas.  We just walk around and chat for about an hour, all this time the pressure is building in my bladder.  It felt like I had to release the hounds of hell, my stomach could barely hold it, but I my friend was here and I could shit when I got to his house.  

At first I didn't feel safe getting on a moped, especially with my condition.  I felt like my stomach couldn't handle the rumble, but I summoned my inner man and decided to muscle my way through it.  His house was about 30 minutes away, and for 10 minutes I thought I was going to die.  I was holding on to my friend, but my arms felt like spaghetti, as all my strength was concentrated on my asshole.  We still had quite a way to go, I knew I couldn't hold it.  I came up with the idea that the rumbling of the moped would drown out the fart, so after some thinking, I decided to let it rip...

Only it wasn't a fart...  I immediately felt the strangest sense of relief and agony as I released pounds of molten diarrhea on my friends moped.  I thought it was a fart, but this was definitely liquid running down my leg.  I didn't even want to look back, because I was sure that I would see a path of ass-vomit streaming behind the moped like the smoke that follows a jet.  I kept shitting for about 30 seconds, because it felt so good. He asked what that smell was, and I told him it was just my breath, as I leaned in and breathed in his nose.  That only made the situation more awkward and slightly homoerotic, but he stopped questioning it at least.  I summoned up all my strength to close my buttcheeks, but my tank was only half empty.  I managed to keep my ass closed until we got to his house. 

My friend said he had to go and pick up another friend.  Luckily for me, this would give me a chance to go inside and finish the deed, inspecting the damage and cleaning up without him noticing.  He leaves me and goes off to the other friend, and I run into the house, rushing towards the toilet like a murderer stalking his prey.  But the forces of destiny still wanted to fuck with me, my friend's mother was walking towards the restroom.  I pushed her aside and screamed that it was an emergency as I locked myself in, she just waited outside.  I didn't care, I was going to release this shit.  I unbuckled my shorts as quickly as if they were on fire, and sat my ass down.  My buttocks released the loudest rumbles, enough to make the earth shake, and my molten shit smelled like a rotting corpse.  I clogged the toilet, but I didn't care.  Point was, the shit was out of my bladder.  I decided to inspect the damage, and luckily it was just a puddle of shit in my shorts and underwear.  I wipe the shit, call my mother, put my shorts back on, and head home.  

His mother went into the bathroom right before I left, but I didn't turn back to see her reaction of incredible disgust.  I left my friend's house without telling him, and now I'm at home feeling like a disgusting freak of nature.  Who just goes to their friend's house, shits, clogs the toilet, and leaves without saying a word?  

This guy.",TIFU by eating Burger King.,868
the-derpinator,54,152,1qdjsz,615,"Well as the title suggests, we were on a road trip.
We had stopped at a petrol station about 10 kms back, but I chose not to go because of the appalling state of all of the rest rooms. What I had done at this particular stop was buy a whole bunch of snacks for the road, and subsequently eaten them all. So at this point we (my parents, sister and I) are driving down a corrugated gravel road in a crappy Honda CRV when it happened. The car hit a particularly large bump and it surprised me enough to make me poop a little.

 Now, you may be thinking that this is the TIFU, but no, it gets much worse.

This small piece of poop was apparently acting as a plug to stop what I can only describe as a torrential downpour of diarrhea from flowing out of my butt. With its removal, I released said diarrhea that had been churning and groaning inside of me like a particularly upset fetus all over my seat, floor, blankets, baggage and sister. I would have laughed had I not just emptied my own digestive track all over my belongings sitting at my feet. We hurriedly pulled over to the side of the road and I am sitting 10m down the road from my disgusted family to shield myself from their harsh words.

TLDR; Shaken, not stirred.",TIFU by holding it in on a road trip.,767
tetrix_,83,196,1oz5t6,614,"Last weekend my family rented this fancy holiday home to celebrate my brothers birthday. My brother (who is very christian and is waiting till he gets married to have sex) turned 26 so my parents put a little shindig together. Not far from town we got this awesome place with a sweet layout, enough beds for 10 and it had a pool. 

Anyway, the night of the birthday bash a bunch of his friends are there, my parents as well as myself and my girlfriend. The party goes late and my girlfriend and I retire for a bit of alone time. The next morning she reminds me theres a condom under the bed and I should take care of that. So I shove it in the pocket of my shorts and move on to breakfast. A little later, I'm enticed to go swimming as a serious game of pool baseball is breaking out. Pretty much everyone is in or around the pool. I jump in to bat  and two seconds later I see the blue condom wrapper float to the top. It takes a second to register what it is but with ninja reflexes I scoop it up before anyone gets a good eye on it. My brother who saw something coloured loudly asks ""What's that blue thing?"" conveniently drawing everyones attention on me. With the wrapper secure I quickly fumble around seeing if the actual condom is there. My heart stops, my pocket is empty. Looking around it the water it hasn't surfaced yet, so I scoop my hands hoping to catch it before the bitch surfaces. My sweeping hands push the water around drifting the condom further away and it surfaces well out of my reach, perfectly on display. My brother freaks the fuck out and the whole pool just clears out like the home team is losing with a few minutes to go. Making it 1000 times worse for my girlfriend who was sitting by the pool tanning and probably throwing up in her mouth. My favourite part - my mom gets fucking furious when we get home and life is nice and awkward for a bit.",TIFU by going swimming,810
Valcani,79,126,1imq6d,617,"A little back story, I've been in a few long distance relationships so stuff like Skype / phone sex has been a big turn on for me.  A while back I found GWA and it's been great.  Well, last night I pulled out my headphones and listened to another great submission on my phone and then promptly passed out.  The next morning I get to work and check my inbox on reddit on my phone before setting it down and starting my morning routine.  After about 10 minutes, at full volume the girl bringing herself to orgasm from last night echoed in the shop for everyone to hear.  I had to drop everything I was doing and panicked because my phone wasn't responding as fast as I was needing so I just pulled the battery out and explained to the people around me that I have an asshole friend who likes to play pranks on me like that.  Hardly believable but I was so embarrassed I didn't know what else I could come up with!  Nobody has said anything about it yet.

TL:DR Don't trust your reddit app / Soundcloud.",TIFU by blasting /r/gonewildaudio at work,743
lidekstoker,121,170,1cpk0n,614,"Today I hung out with some friends, one of which was a newly acquainted (fairly attractive) fellow. The others were two good friends and a best friend. Everything was cool, we were having fun. Me being the socially awkward of the group, sat and played video games rather than talk and be a normal human.

All was well and good... then it hit me, the two large cups of Bojangles sweet tea that is. And of course, being the classiest of ladies, I got up to take a massive shit. Went and found the bathroom and got down to business. Turns out, it was more massive than I thought. My thoughts? ""Shit, that's a lot of shit"". Disregarding the copious amount of fecal matter, I flushed anyway. Worst decision i have made in my life. And unsurprisingly, I clogged that bitch. Frantically searching for a plunger and to no avail did I find one. Not wanting to tell my friends what I had done and having them ridicule me, I improvised. The next best thing I could find was an empty toilet paper roll. Next thing I new was that I was wrist deep in my own waste, hurriedly digging with my new found tool. 

Good news? Got the toilet unclogged without anyone knowing what happened. Bad news? My hand to my forearm was coated in feces and urine. 

TL;DR I clogged a guys toilet, and rather than embarrassing myself and asking for a plunger, i took matters into my own hands... literally.",TIFU by using my own shit as a glove,784
Blemish,164,197,1bqjng,612,"So I've been hanging out with a university friend for months. 

One night he says he's going out so I ask where. He says to a gay club and invites me along. And that's how he ""came out""

I respond saying its not my kind of thing, being a straight guy.

Fast forward a few days and he reveals that he is attracted to me. I respond that although i'm flattered, that's not my cup of tea.

One night before we went out, he says his phone needs charging. So I invite him to my apartment to charge his phone for five minutes. Then he wont leave and asks if I want to have sex. I say no. He then persists ""even though its being done to you?""...NO. 

For the next few weeks this guy keeps inviting me for sleepovers. And to bring a bottle and come over to his apartment. Each time i say no. 

He even says he has computer problems and wants me to come over to help fix it.

Then one day I sent a text to a lady friend saying how a gay guy keeps trying to get me to his apt under the guise of pc problems. 

Well he gets it and feels insulted. We haven't hang out since.

Typing this now, I really don't feel sorry.
",TIFU By sending a text message to the wrong phone number,809
heathencoyote,57,115,1a3a03,612,"Both of my parents are out of town and I'm watching my little brother while they're away. So today I woke up and started to get him ready for school. We were running a little late so I asked him if he would make himself a lunch while I took a shower. After I got out of the shower, we rushed out the door so could both get to school. On the drive to school I asked him, ""So what'd you make for lunch?"" He simply responded, ""peanut butter and jelly."" I then dropped him off and went to school myself. Later, when we both got home from school, I walked into the kitchen and saw bread, peanut butter, and K-Y jelly on the counter. At first I wondered why it was there and then with a sinking feeling in my stomach it hit me. My little brother made a peanut butter and K-Y jelly sandwich. I brought the bottle to him and said, ""Did you use this to make your sandwich today?"" He answered, ""Yeah, I found it in mom's room yesterday, but don't eat it because it tastes all funny.""

TLDR; brother made a peanut butter and K-Y jelly sandwich and ate it at school. Found the jelly in our parent's room. ",TIFU by letting my 6 year old brother eat K-Y jelly.,727
RyCohSuave,128,208,17kitn,608,"The lights were off in my room after playing a game of League of Legends with my friends, last night. After losing (it was close), I told my pals that I'd be calling it for the night. Some agreed, some stayed online - yet, I knew that my schedule for the rest of the night included two things.

I found myself masturbating at roughly 2:00 AM. Knowing that I'd be getting up at 7:00 AM, I rushed off to sleep, shortly after brushing my teeth and washing my face until it was as smooth as a baby's bottom. Fast forward to this morning. I pahked my cah in my normal spot in the garage. Coincidentally, one of my employer's co-council parked right next to me as I was walking to the elevator. We talked about guitar and Dave Matthews in the elevator, and then he split to grab a coffee before heading into the office. I headed towards the office, so I could get my workspace set up. I walked through the automatic sliding doors, bid hello to my girl, the down to earth security lady at the front desk, and then made my way to the second floor via the stairs, making a b-line to the bathroom for a quick number one before work.

After thoroughly washing my hands, I left the bathroom, punched the code into my office's keypad, and walked inside. I said hello to a few lawyers that work in my office, and headed to my area - a big conference room where I am working temporarily. I plugged in both my power supply and ethernet cord to the wall, and then placed my laptop on the table. I attached said cords, and popped the lid of my Lenovo laptop open.

What I had forgotten, was the haste in which I headed to bed last night. When I opened up my laptop, Kagney Linn Carter was on the verge of bursting her vocal cords while getting ""missionarily"" pummeled by some random, large-dicked male. He was really handing it to her, I mean, really, giving her the business. My speakers were about 75%, and it was very loud and clear. I think she was moaning about how big his dick was, and how much she liked big dicks. She also may have been proclaiming how she was near orgasm. I quickly went for the mute hotkey on my keyboard, and then started rustling around in some papers while I popped on a soft Pandora channel.

Luckily, not too many of my coworkers are here yet. One paralegal came into my ""office"" and asked me when The Hobbit was coming out, with a relatively straight face. I informed him it was a few weeks ago, and we shared a high five. He didn't even mention the porn. Phew.

TL;DR: I opened my laptop at work with porno blasting on the speakers.",TIFU by blasting porn in my office.,816
Zecin,100,257,1mbut6,609,"**TL;DR** *When I was five I ran around a church screaming, ""PUT DOWN YOUR HANDS, YOU'RE NEVER GOING TO REACH GOD"" because I wanted to help.*

I've lurked around TIFU for a while and it only dawned on me now that this might be a good story to share.  My family gets a good laugh out of it nowadays, so here you guys go:

When I was about five my parents (both far from religious) thought it'd be good to bring my younger sister and me to church just to see if we liked it. It was one of those churches where they do a fair bit of singing and put their hands up in the air. I'm getting a bit confused as to why people are putting their hands up, so I ask my dad. He doesn't know why, but he tells me that they're trying to get closer to God. Now at this point I had always thought that God was some magical ruler that lived up in the clouds, so hearing about these people trying to physically reach him seemed ridiculous. They were obviously never going to be able to reach him when they couldn't even reach the ceiling.  I needed to help these people. So, that's about when I started running around the church screaming ""PUT DOWN YOUR HANDS, YOU'RE NEVER GOING TO REACH GOD!"" over and over and over again.  My parents were pretty embarrassed, a few people looked at me like I was the antichrist, my dad broke out into uncontrollable laughter, and we never went to church again.  I might have been a bit of a handful when I was a kid.

I'll add that neither I nor anyone else in my immediate family have anything against religious folk, this was just me being an idiot child that wanted to help out.",TIFU 16 years ago and accidentally denounced God in a church,866
SparkyDogPants,133,204,1j6idk,613,"This happened a few years ago, but it's probably my biggest TIFU.

 So I woke up one morning with an intense urge to vomit.

I start running towards the bathroom and make it four steps before I start projectile vomiting everywhere. I apparently also had diarrhea and the force of of me throwing up also caused me to shit my pants. 

I'm not done so I continue trying to get to the bathroom and am now dripping in feces and last night's dinner. I make it to the stairs and throw up/shit myself again, but as I am running down steep stairs I slip on my own filth and hit my head on the steps knocking myself out.

I wake up now bleeding slightly, covered in shit and puke and see my dad looking over me and tell him ""I don't think I can go to school today"" 

He looks over me and says ""No, I don't think you can."" 

I spent the rest of the day with my head in a bucket and my ass on the shitter. I have no idea what made me sick but it was the grossest thing that has ever happened to me.

Tl;dr: Had explosive diarrhea and projectile vomiting and as I was running down the stairs I slipped in my vomit/shit and knocked myself out. Didn't have to go to school. 

Edit: I did not knock myself up. My sex ed is apparently a little off ","TIFU and woke up in a pile of my own vomit, feces, and blood.",817
[deleted],354,214,1emtjn,603,,TIFU: Let my 8yr old niece use my new $1200 laptop and she dumped an entire bottle of water on it. It's toast,817
nitacla,193,201,1dwyxz,597,"So, second date with a guy I really like. We meet for lunch, which is entirely liquid, and I get quite tipsy. He suggests we go back to his. We sit in the garden, drink some more and smoke a spliff. I haven't smoked weed for around three years, since my uni days and even then I was a pretty light user.


It's around 5 in the afternoon, I'm drunk, stoned and have been sitting in the hot sun for a long time. He suggests we go inside to 'fool around'. Yes please. 


As soon as I stand up, I feel terrible. Sweaty, head spinning, deaf in one ear (which for some reason is always a warning sign that I'm going to vomit.)


Thank god I make it to the bathroom. Empty stomach, apart from alcohol so not much doing, but then I get a rumbling in my tummy parts. I've never known the like. Hot watery shit exploding from my poor bum-holey. It goes on for a long time. I was pretty spaced out so I kept sort of floating into consciousness and realising this big wet poop is STILL. COMING. OUT.


Don't know how long it was before I staggered from the bathroom, white as a sheet, giant pupils, barely coherent and sweating like a virgin on a honeymoon. Attractive. I don't think he'll call. 


*(Side note/inquiry: clearly, not very experienced with weed, but is it normal that it completely removed my gag reflex? I've always had a pretty sensitive gag reflex, but for some reason I was able to deep throat like a high class hooker. Possibly an unexpected bonus?)*


**TL;DR: Drunk, stoned, pale, sweaty, vomit, shits from Hades, bonus awesome blowjob.**",TIFU by smoking weed for the first time in 3 years.,798
UncouthBastard,219,257,1lsj2d,598,"My sister and I are about the same age. She lives in georia with her husband; I live in new york with my wife. Before that my sister and I had moved around and hadn't seen much of each other for awhile; and we had never really been close. 
She always wanted us to be close I guess, but she has this just, weird kind of personality. Every now and again she or I will give each other an awkward phone call, but we have way different values, and it's kind of like talking to a stranger that you're obligated to know.
Her husband works at a church, and they're actively christian people. My wife and I haven't been to church in quite some time, and we aren't really bothered by that. Though we do maintain our friendships with people we knew from church, it just isn't a priority to us any more, and I'm now agnostic.

I woke up this morning to a message from my sister, we'll call her Dana. It was the obligatory, quarterly ""hey, how are you, and things?"" call, and now I had to call her back. Hoping this wouldn't take too long I grabbed my hookah and began to set it up to smoke some weed; while I called her on speaker phone. 
She picked up and we started off with the usual dance of trite bullshit. How were things? How's the new place? What are you doing now? Have you talked to mom or dad? You get the gist. In the course of this conversation I've got the coal going and am toking away, the conversation is winding down. Just as I think we're about to hang up she drops this bomb: ""Did you hear that dad hasn't paid his taxes for several years, and they might lose the house?"" 

Holy fucking shit! I had not heard that! And I was way too high to suppress much gossip-killing indifference. My solution? Finish this bowl, this is gonna be good! This conversation lead into a general critique of my dad, as he was a pastor, and my sister wanted him to stop doing that since it's an hour away both ways. Then we went into churches and she asked me why I hadn't been going. ""Unless you're agnostic now,"" she said half-jokingly. ""Oh, well, uhhh...yeah, kinda,"" I half-joked back; too high to realize the consequences of that terrible phrase.

""What? Well, you know god is real. So, what's the problem?""
*Oh, shit.*
""Well, uh, I just don't really care any more. I mean, he might be real, but I don't think he interacts with humanity anymore. I'm, like a deist.""
""But, he's either real or he isn't.""
""Look, I just don't think it's important any more.""
""But, UncouthBastard, you went to bible school, you were a missionary.""
......

We went around in this circle for what felt like hours. I stumbled through the second half of our conversation, trailing off, forgetting what was being said, sounding high as fuck; while trying to explain why I just didn't care about god any more.

Finally I just said, ""look I don't want to talk about this anymore."" 
""Okay...""
We sat in silence on the phone still, for at least a minute.
""So, so, is there anything else you wanted to ask about?"" I was trying to end it.
""Well, you just said you don't want to talk about it.""
*Sigh* ""Anything else?""
""No, not really.""
Another minute of silence.
""Okay, so, I guess, have a good afternoon.""
""Okay you too.""

We hung up in a super awkward way.
This is going to be a huge family scandal when it gets back to my parents. They are going to make me hate my life, badgering me about why I've left the church.

EDIT: in reading over many of the comments here, and re-reading my initial post, I've come to realize that this story was really less about me and my family not having cohesive religious beliefs and them rejecting me; and more about how I (guess I fucked up?) realized that I'm getting older, and I don't have many very close friends, and it's weird and a little scary that my relationships are changing with old friends and family. 

TL;DR: I told my awkward sister I'm not a christian anymore and she's going to tell my fundie parents and we're going to have phone time intervention. Then I got hit with a nostalgia wave. ","TIFU by getting high and telling my very religious sister that I am no longer a ""born-again christian.""",855
KGlitz,173,120,12h7dt,601,"So early this morning I (a male) decided to shave my nether regions in anticipation of sexual activity tomorrow. I debated over whether to trim with my electric manscaper or use an actual bladed razor. I figured shaved clean would look too weird so I went for the trim. 

I set the guard on the shaver to be pretty short and turned it on. At this point I noticed the batteries were pretty weak and the oscillation of the blade was abnormally slow. 

""Whatever!"" I think to myself. It'll do the job. I merrily shave the area above my dick and things are going great. I realize the whole dome of my balls is really scruffy with some occasional super long hairs sticking out. I decide to lightly run the shaver over my balls so that I can not look like franken-nuts. I didn't realize it at first for whatever reason, but the slow oscillation of the blades was actually mauling the shit out of my skin.

I kept going until a REAL snag ripped a medium sized patch off of my sack. I yelled, and saw my entire balls and some of thighs covered in blood. This wasn't a normal shaving cut. I was actively hemorrhagic. I saw the patch spilling blood and got woozy. I took a shower but I am still a little ""bleedy"" at this point, and what I actually got around to inspecting my package, I noticed about 8 or 9 small cuts in addition to large one. 

My nuts are super sensitive now. Sitting hurts them. They are tender and I only have two pairs of black underwear to conceal my misfortune. And I am certain that if I score, and she grabs my balls, things won't be ending well. Goddamn it, today I fucked up.",TIFU by shaving my balls. Poorly.,721
pukeydaydreamer,172,545,1i0c2c,597,"Early this morning I got out of bed and went to brush my teeth. My mind was still wandering from the lingering dream I had, and I began daydreaming about foreplay, and suddenly I couldn't *wait* to see my SO so I could give him a well-deserved, deep-throated blowjob... all hard and hot, getting everything all wet and sticky, and... and...

And then some toothpaste foam traveled down my throat as I was scraping my tongue (prevents bad breath okay). I started gagging, then dry heaving, and next thing I know I am making the mistake of puking in my sink because the toilet was too far away.",TIFU by daydreaming about giving a blowjob.,1142
Skankin_it_easy,119,160,16r8sk,601,"Tifu, but this story needs a little bit of background... I was raised with a lot of animals (rescues) and my mom LOVED candles.  She still does actually, but she converted the majority of her candle use to wax warmers (I wonder why...).  Well, she had given me candles on occasion...nice ones!  But I never got around to using them until now.  I had a friend over and decided it was an excellent time for something new and exciting.  Being a relative newbie to the pleasures (and dangers) of candle burning,  I impulsively slapped that sucker right on my coffee table and proceeded to schmuck around on the internet (thanks reddit...).  What could go wrong?  I had no candle related childhood traumas on which to base any apprehension about such a placement.  

Now, I have this cat named Kiki who truly has a slight mental handicap, its no joke.  Well, she comes sauntering into the room and my friend calls her over  -  and I'll be damned if she didn't hop right up on the coffee table and proceed to walk directly over the open flame.  I'm sputtering a half-english half-animalistic version of ""nOoOoOO"" while I watch in helpless terror as Kiki's belly and side go up in flames.  I'm talking 4-5 inches of fire on a seven pound creature!!  She never even knew what hit her.  My desperate shrieks only exacerbated the problem too.  Her eyes grew to the size of saucers and she spun around, knocking melted wax everywhere, and tore out of the living room, flames feeding on the new found oxygen source, claws scratching in futility seeking a grip on the vinyl flooring....visions of a flaming ball of anger and knives setting my apartment on fire suddenly came to prominence in my mind.

My friend, the heartless bastard, was already in hysterics as I scrambled to catch up with her and assess the damage.  Kiki, miraculously, was unharmed although bereft of a patch of long coat hairs.  She still doesn't understand why her mommy yelled at her today.  &lt;3  I blame my mother - she knew dammit....she knew.",TIFU by setting my cat on fire... ,761
BicycleRacked,141,181,1q5gj0,599,"This morning, during a field trip, my class was disembarking the bus at a rest stop when I spotted my crush. I wanted to hang out with him during the stop since I didn't get to sit next to him.

I snatched his hat off his head and put it on. ""Ha ha! Got your hat!"" I squealed as cutely as I could muster. I tried to run off, but was stopped dead in my tracks.

CLANG!

In my attempts to watch his reaction, I ran right into a bicycle rack. Crotch first. It hurt. A lot.

I dropped like a rock and tried to act casual as I rolled around in the gravel, eyes watering. His hat fell off my head and into the dirt.

Never, even on my worst periods, have I felt such pain down there. A corner nailed me right in the pubic bone. My toes are curling just remembering it.

""Are you okay?""

""YEAH I WAS JUST JOKING!""

I quickly gave the hat back and scampered away, embarrassed, hands over vag. I sat down behind the bathrooms and just sort of curled up until the pain went away. The pain in my cooch, at least. The painful embarrassment, I'm going to remember whenever this incident comes to mind. Oh god, I'm remembering it now. Criiiiiinge. ;___;

Ugh. It still hurts when I put pressure on the area.",TIFU by trying to be flirty,780
redette1117,71,146,16j9f4,593,"This morning, my fiance and I woke up still drunk and really late for a wedding planning meeting we had waited about two months to get and which would be a huge pain in the ass to miss. 

We left in a huge hurry to try and make the meeting, and as he's driving, my mildly pleasant ""still drunk"" state is rapidly spiraling into cripplingly hungover. I chug my massive bottle of water and try not to ralph.

When we we're finally finished at the meeting I'm feeling even more horrible, but we still had about an hour drive back, so I chugged the most of my second bottle of water and tried to sleep.

We made it off the expressway, and were about a mile and a half from home, when suddenly, the contents of my stomach are no longer cooperating. I sat up right, and said ""fuck, I'm going to throw up!""

I took off my seat belt and rolled down my window. My fiance said ""hold on!"" and pulled into the turn lane. In my foggy pre-vomit brain, I somehow thought he was pulling into the turn lane to stop there while I threw up. And, naturally, not wanting to throw up all over the side of the vehicle, I thought I could crack my door just far enough to throw up directly onto the ground, so I opened it...

But the thing was, he wasn't pulling into the turn lane to stop. He was pulling into the turn lane to prepare to turn. It all happened in a matter of seconds, and with perfect timing that couldn't be replicated, I cracked my door at the exact moment he took a sharp turn at about 15 mph, and I was flung out of the car head first and sent rolling across 4 heavy lanes of traffic. Also at this exact moment, all of the water and whatever else from the night before and possibly some vital organs decided to vacate my body through my mouth, so as I'm rolling I'm projectile vomiting all over myself. I was came close to being immediately run over by two cars but somehow managed to get up right after the roll and run blindly in the direction I thought the car was and out of the road. I have some nasty road rash on my back and feet, so bleeding all over the place, my clothes are completely torn up, and I'm covered in vomit, gravel, and shame. I proceeded to throw up several more times on the side of the road and scream ""I'M FINE I'M FINE I'M FINE"" while a stranger that had seen the accident and stopped held my hair and two more strangers and my fiance called 911.

They ended up sending a firetruck, two cops, and an ambulance. It was incredibly embarrassing. One of the genius cops was also absolutely convinced that my fiance had pushed my out of the car because he found out I was pregnant, and that that must be the real reason for me throwing up, so I had to disappoint them by explaining I was just really hungover and still kind of drunk on a Sunday afternoon. It was a gloriously white trash Sunday.

**EDIT** I feel like there's some confusion, I am definitely NOT pregnant, and wasn't drinking while pregnant. When the cops showed up they jumped to that incorrect conclusion very quickly because they were convinced I was pushed, and that that must have been the reason for it. They were incorrect. Sorry for the confusion!

**EDIT** Okay, a lot of people are pointing out that I said we were ""still drunk"" when we woke up and yet my fiance drove. Let me be clear, we both woke up feeling HORRIBLE, but I was WAY worse off that he was. Was he feeling the effects of the night before? Yeah, he felt shitty. But he was most definitely not hammered or inebriated to the point where we were putting people in danger to have him drive. Had that been the case, we would've just stayed home. Obviously I was a lot worse off, I vomited and fell out of a car... Sorry, I should have been more clear!",TIFU by falling out of a moving vehicle. While vomiting.,739
beaten-by-supergirl,86,380,1oowhh,599,"I went to the mall today with my friend, her parents, and her three-year-old sister. After a while, the parents asked me if I could watch little sister in the children's play area while they took my friend clothes-shopping.

So I sat for a bit, watching her run around in her little Supergirl shirt. She jumped up on the bench with me and yelled ""Whoosh!"" giving a little flying gesture.

""Supergirl!"" I said, and picked her up. She squealed with joy, kicked her feet for a bit... and then her shoe came down... hard... right on my left testicle.

I almost dropped her right on the floor. I put her down and told her to run along back to the play area. I don't think she knew that she kicked me, so she just looked a bit incredulous and then left.

I sat there with my hands in my lap for a while, left nut aching. Somehow it felt even worse than hitting both of them, because the pain wasn't even balanced. I tried to put on a brave face for the public, but I really just wanted to curl up for a while. I'm glad she didn't get kidnapped over the next ten minutes, because I would have been too nauseous to notice.

Eventually my friend and her parents came back. They asked how the sister had been. ""No trouble at all"" I lied. Before we left, I excused myself to the restroom for a quick look at lefty. Kinda bruised, but not too bad. We walked back to the parking lot, my ball aching, and left.

A few hours ago, I was Skyping with my friend and told her about my injury. She tried not to laugh, then told me that her sister once gave her a really painful kick in the girl-parts while she was holding her down at the dentist. She said it hurt so bad the dentist told her to sit in the recovery room, and we bonded over the shared experience.

This led me to wonder, was today's attack an accident, or do we have a serial crotch-kicker on our hands?",TIFU by picking up my friend's little sister,979
The_Karma_Farma,134,106,145xrb,596,"Last night I went out for a few drinks with my mates at the pub, nothing that amazing to report besides we got pretty drunk and laughed at stupid shit. The real event happened this morning.

I woke up hungover as fuck and decided to get myself a nice fry-up for breakfast. When I came downstairs I realised that I was out of bacon. No big deal since there is a corner shop literally 50 yards from my house. As I was walking I must have loosened up my bowels because the moment I walked into the shop  the urge to shit hit me like a brick wall. I could feel it flowing down through me as a rate my asshole would never stop. 

Now, is probably a good time to mention that last night I had 6 pints of Guinness (which gives you the shits as it is) followed by a HUGE chicken curry that my local Chinese serves. Quite frankly I had mixed up within me the worst shit imaginable. As soon as I got through the door I blurted to the clerk ""Can I use the toilets?"". She was a bit surprised by my urgency but pointed me towards them. I frantically rushed in and took my pants down. As soon as my ass hit the seat my body seemed to take it as the sign to fire at will.

A massive load of shit immediately spurted out to the sound of cannon fire, followed by a steady stream going to the tune of a series of loud cracks and creeks. This is a small shop so you can be guaranteed  that both the clerk and the other customers in there heard everything. The uncontrollable farting was interrupted by 3 more eruptions to rival the initial blast. The sound was echoing around the toilet bowel, making it even louder. All through this ordeal I was sweating profusely and gripping the side of the tiny cubical for dear life.

When it was over I was physically drained. I sat there in pain and exhaustion for a few seconds before gingerly bringing myself to my feet. I looked into the bowl to survey the damage and the brown mess that met my eyes combined with the smell that hit my nostrils at the same moment summoned another beast from within me. I began to spew vomit into the already destroyed toilet. Well, not *only* into the toilet, the spread was so wide that it was splattering against both walls of the cubical.

It was basically the same stuff that came out of my ass, with the same rancid Guinness/Curry stench. At it's peak it came out with enough power to bring me to my knees which put me now face to face with the horror show in the toilet. As a reflex action I twisted my head to the side and puked directly onto the floor before eventually collapsing against the side of the cubical, drained and panting, my pants still around my ankles.

I must have sat there for 5 minutes before I heard the shout ""Are you okay in there?!"" from the shop floor. ""I'm fine"" I spluttered. I was not fine, I was soaked in vomit and so was the cubical. I began the messy process of cleaning up myself and the cubical. At first I was afraid this would cause me to vomit again but at this point I was numb, my body had given all it had. After 3 flushes worth of vomit and shit soaked toilet paper I walked out of the cubical and back home, not daring to meet anyone's eye.

**TL;DR: After a night of beer and curry I shit in a shop bathroom and proceeded to vomit on it.**",TIFU by vomiting because my shit was so disgusting.,702
soulruler,108,162,1clrug,592,"In November we finally moved into our new house that has a man made koi pond in the back. Fast forward to the ""spring"" (I put that in quotes given how crazy the weather has been in the Northeast) and we decided to clean it out and fix it up, as it hadn't been well maintained in the last year before we moved in. We drained the water from the pond and took out all the fish and put them in a bucket. We kept the water from the pond in the bucket and all the fish were fine (about a dozen or so fish.) I realized that we needed to keep this water in there and that if we switched it with say, tap water, the fish could die. However, I forgot to tell my wife this, who would then convey this information to my mother in law who is staying with us to watch our daughter. Mother in law doesn't speak any English so the only way to communicate is through my wife.

Fast forward to today (well technically yesterday but I didn't get a chance to post this then) and I come home from work and my dad comes over to measure the pond. He then yells out to me, ""Hey! All the fish are dead!"" I declare ""Bullshit!"" but then I went over and sure enough, the bucket had become a fish graveyard. A dozen or so fish of various sizes all floating on the top. I also noticed that the water was much cleaner than it was beforehand. Turns out my MIL decided to change the water and apparently the fish couldn't handle it and thus it killed them all. I felt bad because A: My older daughter had started to like to the fish and would watch them and feed them, and B: They survived all fall and winter in the pond only to later die what was probably a rather painful death. Now we have to buy all new fish once we get this pond up and running:

TL;DR: Drained pond and stored fish in bucket. Mother in law changed water because I forgot to tell her not to and ended up killing all our fish.",TIFU by not talking to my wife,754
The_Uber_Dude,107,169,1lm6zf,592,"Today, my girlfriend and I were participating in sexual acts. During these sexual acts, I felt the need to fart, but held it in. When we were done, we layed in bed for a bit, and she went under the blanket to give me some head, as she was still horny. That's when it happened. Her head was inches from my butthole, and the excitement of the oral pleasure let it slip. It was the most fowl smelling fart ever. She didn't finish the blowjob.",TIFU by Farting.,761
throwaway_for_tifu,173,214,1gxogx,595,"So my best friend likes my 2nd cousin. I've been trying to get them together for a few weeks now but she just isn't warming up to him so I meet up with her in person. (We live quite closeby in the countryside.) We decided to rendez-vous at the graveyard. We sit down on the edge of a grave because there's nowhere else to sit. I'm trying to persuade her into getting with my friend when she tells me to close my eyes. I comply and badda bing baddo boom we're making out. On somebody's grave. So the grave is covered by one large flag-stone. She pushes me back onto it in the middle of our passionate kissing and the fucking flag cracks down the middle and breaks in two. It's in a V-shape. We both proceeded to run out of there.

Gladly we got away with it. 

TL;DR: A sudden incest appeared.

EDIT: Against my libido's better judgement, i've decided not to pursue this relationship. We would eventually end up getting feelings for each other which could get messy. Also I kind of kind of made out with a different girl who i'm not related to. (I hope.)",TIFU by making out with my cousin in a graveyard.,809
szekeres81,104,105,18ny25,591,"I used to go to the gym lots in high school. I was on the football team, and it was a basic requirement. Fast forward five years, and while I'm not fat, I'm definitely not in shape. So, I found a gym by my house, got a three month pass and went for my first workout today.

I figured I'd warm up on the treadmill for about ten minutes, so I jump on and boost the speed up to 5.0, my usual speed in high school. It's a little difficult to keep up, but I manage and hop off. Then, it hits me like a ton of bricks. I feel like I'm gliding through the gym as I make my way to the water fountain. I can't control it; I throw up in the water fountain with three people behind me in the lineup. All I can hear is people shouting profanities and gagging. I finished hurling, grabbed my bag and walked for the door. I THREW UP AGAIN IN THE DOORWAY. At this point people are just silent, watching me with the fire of a thousand suns.

I think I have to find a new gym.

UPDATE: I thank all of you for your comments. I've decided to give it another shot on Monday, as many of you are advising me to man the fuck up. ",TIFU by going to the gym,696
Zacharias3690,100,137,18xzc7,589,"Today, my girlfriend and I were walking up to my house, and I see a screwdriver lying in the grass. I decided to pick it up and try to throw it down in our garden with the sharp end in the dirt so I could go back for it later. The only problem is we have bricks all along the edge of our garden. When I threw down the screwdriver, I missed the dirt, the handle hit the brick flew back up and hit me in the eye (the handle, not the sharp part). I ended up getting a black eye from it and had to live down the shame of telling the story to my family and friends.",TIFU by trying to look cool in front of my girlfriend,726
2Fab4You,99,113,1d2qol,587,"Okay, it wasn't today, it was a while ago now. I was having fun in the shower (ladies, you know what I'm talking about. Dat shower head.). Because I was home alone I decided to take my time, so I was in there, water spraying at full blast, for quite a while.

I was, as you can probably understand, mildly distracted so I didn't quite notice that the water didn't go away as quickly as it should. After I finished though, I realised I was sitting in a pool of water a few centimeters high - and I don't have a bathtub. My entire bathroom was filled with water and it was running out the door, making a nice little pool on the carpet outside.

I handled the situation with towels and went back to doing whatever useless stuff I had been doing before my watery adventure.

Fast forward a few hours and my mom comes home. She comes to my room and ask me why there's water running from the roof downstairs.

We had to take out the floor in both the bathroom and the room outside and part of the wall downstairs to fix the damage.",TIFU by masturbating until my house broke,700
WellShit123,156,264,1hx76p,586,"I bought new panties today and was a little excited so I decided to send some photos to my boyfriend. Then I decided to make a video. As soon as I ""finished""... I heard a car door slam and realized I was laying butt naked on my bed with the blinds open, the lights on, and my new elderly next door neighbors just drove up in their driveway right next to my window. 

I don't know what the chances are that they looked over but if they did... They got an eyeful of my ass. 

Cool. ",Today I fucked up by taking naked photos and making a video of me touching myself without realizing the blinds were wide open.,850
GodBroken,101,129,1fcg0v,591,"Did not happen today, but I feel if I post the story I may be able to let this one go for good.

It was the morning after a rousing night of drinking and sleeping on a friend's couch with several other drunk hooligans. I chugged some water and headed out to my old soft-top Jeep Wrangler. I had taken the top off for the summer, but the driver and passenger front side window halfs of the doors were still on it.

I went to open the driver's side door and it just wouldn't budge. I pulled, I jiggled, and finally crawled through the passenger side. The door wouldn't open from the inside either. At this point, Hungover Friend #1 stumbles out and asks what's up. I explain the situation and he proceeds to try to get it open for himself, and of course, can't do it.

I could have said ""Fuck it"" and gone about my day, but no, you see, I am a Mechanical Engineering student. It's a simple mechanical malfunction, and I should just go ahead and fix it to prevent crawling through my passenger side / window for the next week. HF#1 (Chemical Engineering) and I proceed to start taking things apart, trying to get to the jammed mechanism.

After a good half hour, Hungover Friend #2 comes out, another Mechanical Engineering major, and gets in on the action. We finally get the window top-half off, and can now access the door easier. Hungover Friend #3 (Materials Engineering) comes out and also helps. As it turns out, this is no simple task. It's almost impossible to take a Jeep door off while it is closed.

Four hours go by with us removing bolts and parts - frustrated and determined. But it is no matter, for we are engineers! We crawled all over the inside and outside of that thing.

It's in the middle of summer, so not only are we hungover but also getting pretty sunburned out there. The door finally comes off and we go about inspecting it. ""It appears there's some kind of latch that's stuck closed over here... hmmm.... peculiar... well we should probably take it apart."" HF #2 starts messing with the handle and door lock, when: Pop! The mysterious latch disappears and is no longer in the way.

It was then that we realized that the door had been locked. That was why it would not open.

I had let my dad borrow that Jeep the day prior and he had locked the door. Who locks a Jeep Wrangler with no top!?

We spent the afternoon reassembling my car. At this point a good portion of the windshield and roll-cage were taken apart, and we had stripped a few screws... so... it took until sunset. We then began drinking once more.

**TL;DR: Door won't open on topless Jeep. Four engineering majors spend half a day taking the car apart only to discover the door had simply been locked. Who locks a topless Jeep?**

Edit: Thanks guys, I know I can always count on you to make me feel better about my fuck-ups.
","TIFU when my car door wouldn't open, so me and three other engineering students disassembled it.",720
laststandman,86,137,1brnsy,584,"I'm in a Sophomore history course, intended for History majors. Today we were discussing a book about Dr. Livingstone, Henry Stanley, and Africa. So we get to the subject of Livingstone' s African servants, particularly a few of them who after he died accompanied his body back to England.

So we're discussing this and ny professor asks us what cultural imperialist implications the author puts forward to explain why they went to England with his body. So I raise my hand and say, ""essentially they feel they owe him a Wookiee life debt.""

Professor: ""A Wookeie life debt?""

Me: ""Yeah, like from Star Wars.""

So now I'm trying to explain the connection, all while sounding way racist by implying Africans were Wookiees. I turn as red as my Devils hoodie and slink into my chair while the class tries to recover any part of the colossal idiocy of what I said. I was just trying to be that guy who makes a sweet reference in class.

Tl; dr: I tried to reference Star Wars and ended up calling Africans Wookies.

edit: spelling",TIFU by referencing Star Wars in history class,721
SawNakedRussian,161,229,1oy46o,577,"So some of you may have read my TIFU earlier about walking into the bathroom while the very same boyfriend's dad, named Stanislav or Stan, was in the bathtub.

Oops, I fucked up again. Poor, poor Stan.

My boyfriend Josh and I went to Russia for his aunt's wedding. Until the wedding we are staying at his father's dacha, which is basically like a house I guess. Also, I keep a bottle of lube in my suitcase. That's just the kind of person I am. Please contain your boners.

Anyway, I was searching through my suitcase for a nice shirt to wear and pulled out the tub of lube in the process. As I'm cleaning, Josh opens the door and by reflex I cover the lube with a shirt. He doesn't comment, grabs his wallet and goes away.

I flop onto the bed, facing away from the door and play games on my phone with my headphones in (holy crap there's internet in Russia guise) and leave my lube-hiding t-shirt laying innocently on my bed. About half an hour of this and there's a knock on my door.

It is Stan, come to tell me lunch is ready. However I can't hear or see him. So he throws a bean-bag at me. He has learned to keep one on hand because occasionally I'll zone out. The bean-bag hits me on the head, so I turn around and take out the headphones, and throw the beanbag back. He catches my measly throw with vodka-fueled ease and tells me food is ready.

Not one to be defeated, I pick up my shirt and throw it at him. But alas, it is the one with the lube in it! I should have realized by the weight of the little tub, but I didn't. So I hit poor, poor Stan square in the chest with the lube-hiding shirt.

BUT WAIT THERE'S MORE.

Somehow the tub opened, getting lube all over Stan's shirt. The look on his face was one of violated horror as the offending tub tumbles innocently on top of my shirt on the floor at his feet.

Poor, poor Stan mutters what sounds to me as 'Zah chem' with a ch sound in (Don't know Russian) as I scramble over to pick up the tub and shirt. He turns around and leaves. 

I think I'm just going to stop talking to or interacting with Stan at all.
On the plus-side, he smells like strawberries.

EDIT: Thanks to /u/kolove I know now that 'zachem' means 'why?!'

EDIT AGAIN: If you have any questions for Stan, the victim of my fuckup saga (I'm here for a week and I'm sure there'll be more) I've posted a comment thread specifically for asking questions for me to parrot to him. I'll type and post his answer.",TIFU by throwing lube at my boyfriend's dad.,806
thedoctorg20,295,800,19vso2,582,"Preface: A bit of a read, but well worth it if you have the time. I pray that this fate never befalls any of you.

TL;DR- I eight-pumped a horny co-ed to shut her up, she bursts into tears and then apologizes for it. The ass was fat.

Edit: ""eight-pumped"" is a term I made up to describe a sexual act consisting of a mere eight strokes. Sorry about any potential confusion.

The Horrible Misadventures of Thedoctorg20 and Gatsby: Part One

So everything was pretty normal today, just hanging out after attending my first class and waiting for my next to start at 4. As I sat there in my Siberian husky boxers (every man should own a pair) and contemplated life while watching Nicholas snooze the day away (he is an adorable sleeper, you're not the police of me) my phone vibrates and I peer over my shoulder to see who it was. [name withheld] had texted me! We had been talking for a couple of days and the night previous I had convinced her to send me some racy pictures so she obviously found it troublesome to contain the sexual beast that I had unleashed inside of her. She wanted to visit me and I could naught but oblige....

I'll take this moment to explain my genitalia. I named it Gatsby for the purpose of this story because it likes to party and have fun but goes for the wrong woman and inevitably gets into a lot of trouble. It likes any and all attention and has the amazing ability to blind myself from obvious emotional and mental issues regarding the owner* of the vagina it so desperately seeks out. The old adage states: ""Don't stick your dick in crazy."" However, it appears that my penis misinterpreted it to read, ""Find every crazy girl you can and put me inside so I can get cozy and introduce myself to her crazy attachment gland and we can become BGF's (best glands forever)""

*see ""[previous crazy girl]"" 

Back to our story. After a small conversation the time was determined and I began to contemplate my next move. I decided a shower was more than necessary so after cleansing my body of its natural oils I began to dress and prepare for her arrival. Applying my cologne (smell like a god erryday) and putting on my typical hipster-esk clothing. 

She finally graces the floor with her presence. I am actually kind of glad to see her at first: sweet smile, nice eyes, etc. We talk with some guys on the floor as Nick rolls out of bed and showers (1:00pm) to prepare for his day. We head back into my room and sit on my bed while I display my usefulness and my uncanny ability to find adorable pictures of baby seals (it's an art form). Nick returns from his shower, we joke around and chat as he gets dressed and gathers his things. But wait, he doesn't have class until 2:30? Why is he getting all of his stuff together if it is only 1:15? Because he is a damn fine wing-man that's why. He eases his way out of the room and shuts the door. 

Let the games begin....


The Horrible Misadventures of Thedoctorg20 and Gatsby: Part Two

Finally alone, she makes no effort to control herself as she jumps my bones, hitting my head on the bed in the process. I combat her merciless advances and pry her off, stumbling towards the door. After locking the door (don't need any more jockeys for this rodeo) I walk back to the bed where she has already taken off her shirt and is beginning to unbutton her pants. I, being the gentlemen I am, slow her down as I am normally more one who enjoys the pregame as much as the Super Bowl. 

I think this is an appropriate time to mention a crucial detail or two that I may have neglected to share in the first installment.... This girl's legs are harder to close then the JonBenét Ramsey case. She continuously complained to me about guys only wanting her for her body and ditching her as soon as she had sex with them, so naturally I told her that we shouldn't do anything too crazy sexual on our third time seeing each other. She agreed and seemed entirely fine with our MUTUAL DECISION BROUGHT INTO QUESTION BY HER IN THE FIRST PLACE, that is until we were actually in the bedroom with nothing between us but her jeans, my sweet sweet corduroys, and the aforementioned husky boxers (once again, cannot stress how important these are). 

Flash to the present and we see a passionate session of tender romance unfolding. She has a reasonable pair of supple breasts, not as big as I would like but nothing that would drive me away by any means. She also had semi-disproportionate nipples, but I wasn't about ready to complain and risk spoiling the moment. The first real sentence out of her mouth since this all started was something along the lines of ""Let's get naked, but not totally naked because then we might accidentally have sex teehee."" 

Whatever.

I strip her pants off as gracefully as I can (she does that little hip arch that all girls do when their clothes suddenly become toxic and they must be removed immediately for fear of contamination). So the scenario is this: I in my boxers, and her in her lacy panties and bra (she wore lacy panties, she knew shit was about to go down) lay together embraced in an affection make out session. This is about as far as I thought the day would go, maybe some hands in some places or something along that same vein. I pictured us getting hot and heavy then maybe a little finger bang here and a little head there, typical collegiate stuff after only recently meeting someone.

Nope.

""Fuck me."" I pulled back from her and stared into her eyes, albeit very confused. Did she really just say that? What happened to our agreement? ""I thought we decided that we weren't going to do any of that stuff today? You said you were tired of guys leaving you after they sleep with you and that sounds oddly reminiscent of this situation right now."" She half scoffed half chuckled and nodded her head. I don't get it... is it now cool to do this even though we had just decided against it a mere forty-five minutes prior?! I played it off as if she didn't say it and just continued along the same path I was going until about a minute later the topic arises again.

This is where things get interesting…

The Horrible Misadventures of Thedoctorg20 and Gatsby: Finale

After continually holding off her advances for sexual gratification for a solid 10 minutes, she gets even more desperate. Commence compliments such as the following: ""But you're so big it would just feel amazing and be really fun.""(Edit: I'm actually wonderfully average, she was being quite flattering) ""I want you inside of me, your fingers aren't doing it for me anymore."" (And my personal favorite) ""I'm starting to lose interest, you'd better fuck me cause I'm bored.""

At this point I'm annoyed. I just wanted some harmless make-out time with a handful of some ass and a mouthful of titty. Is that too much to ask?! Apparently not, apparently it wasn't enough to ask at all. 

After shutting her down for what appears to be the last time, I literally breathe a small sigh of relief. Mistake. She seems to take this small action not as a sign that I'm glad the worst has passed, but instead as a relinquishment of my true desires and a sign of potential boredom. ""Daddy likes it rough and freaky, eh?"" she pondered. ""I can manage that.""

She turns her head back bites me on the nipple. Not a nibble, or even a tease. Bitch goes straight up Mike Tyson v. Holyfield on poor little lefty. ""What the hell?"" I gingerly pull her head back and look at her with what I thought portrayed a look of utter shock and befuddlement. Wrong again self. The face I gave apparently said 'lick my face and then laugh and bite my shoulder to the point that a small trickle of blood emerges.' She obliged. 

Now I am legitimately a little scared of this sexual demon. I push her back and scramble for something to say to get her away from my upper body to save myself from the horrors that were sure to unfold if this went unchecked. Recalling that she 'really likes to give head', as she puts it, I blurt out ""Maybe you should just suck my dick so all of this tension goes away?"" Yes... let the girl that just bit your shoulder wrap her lips around Gatsby... perfect. 

Luckily she seemed pretty enthused by this and went down gladly. With the care of a baby seal wrapped in feathers and clouds she went to work. I desperately tried to think of anything that would make me finish quicker: Holly Peers (hothothothothot), past sexual encounters, anything. I could care less if I get labeled as a premature by this girl I just want this over. But suddenly, as if she could read my thoughts, she stops and says ""Actually i shouldn't do this, it's just going to make me want to fuck you more.""

ARE YOU KIDDING ME?! THIS WAS MY WAY OUT. I WAS HOME FREE. I weakly murmur something along the lines of ""okay, that's fine"" and prepare to just cuddle the remaining thirty minutes of time away, tears welling up at the potential for the epic blue balls sure to befall me within the hour. Then, the biting starts again. And the compliments. 

Screw this, I'm gonna fuck this girl and pray to god she shuts up and stops bothering me. ""Alright fine, let’s do this."" She spreads her legs open like a giddy schoolchild opening her lunch box to see what mommy packed for lunch today. Luckily she was still as wet as can be so I slipped inside and started the ritual mating dance of my family. Start out slowly, build momentum, and breathe at regular intervals. After the first 20 seconds or so she tells me to just fuck her hard and get it on. 

Per her request, I pull out to the extent of my reach and lay into her. 

8 pumps. My tattoo (An 8 on my ankle, it’s a family thing) has never been more relevant than it was now. Now I'm not saying that I finished in 8 pumps... No that would be too easy of an ending to this story. On the eighth stroke she bursts into tears and begs me to stop. WUT. I wasn't even at full throttle and she taps? What gives? Turns out that she wanted to have sex with me more than she worried it would affect our chances at dating, but on commencement of the act changed her mind immediately and started crying at the thought of what she had done. She profusely apologizes to me and claims it was all her fault for letting this happen. 

I hugged her out of sheer terror that she would begin wailing and cry rape or something crazy along those lines, and she finally calmed down. After a couple minutes she insisted on finishing me off so I wouldn't suffer blue balls, but I wasn't about to let anything near Gatsby but her hands. After what seemed like an eternity I alerted her of my current orgasmic state at which she plonked Gatsby into her mouth in anticipation of the coming tides. Bad call. Turns out I hadn't emptied the tank in a couple days (five to be precise) and the sexual build up and relaxation had only caused more production. It sounded like she had just swigged back a gatorade after running a 5K. Whatever, no mess for me to clean.

Seeing that it is about 3 o'clock, we both begin to dress and prepare to head to our respective classes (me a little faster than her) and I put on some drum &amp; bass music to calm my nerves and distract me from the misery I endured. We walk till our paths split at which point I begrudgingly engage in a hug goodbye. She tries to kiss me on the lips in the crowded area. Dodge. Agility +5. She kisses me on the back cheek instead, seems pleased, and heads off to class. 

I hurried to class and began to pen this upon arrival, as I knew that this tale needed to be shared. This is the bane of my existence. Gatsby gets me in more trouble than he is worth, but god dammit it gives me crazy ass stories to tell and as long as I don't get stabbed I chalk it up as a win in the end. I've loved writing this story for you gents, and have plans to have it published in the near future (i'll probably just copy all this into MS Word). 

If this story has a moral, I can't find it. Shit was weird, and I didn't learn a thing.

Edit: due to questions about the following statement ""The ass was fat"", I would like to clarify that it was the saving grace in this tale and the only thing that kept me from passing into the realm of insanity.

Edit #2: For those doubting a little bit of my story, here is a sample of our text conversation this morning; the calm before the storm http://i.imgur.com/II9AYpb.png

Edit #3: Wow, I am really enjoying reading all the critiques and feedback! May your Gatsby (or for the ladies, Daisy) serve you well.","TIFU and stuck my dick in crazy and immediately regretted it. However, the ass was fat. (Disclaimer, bit of a read. TL;DR at the top)",1382
sorepheet,83,119,um8pr,577,"http://www.reddit.com/r/Maine/comments/ulfm5/gave_incorrect_change_at_toll_accidentallthave_an/

The part that really frosts my ass is that my car in under my lady's EZ-Pass. If I had just rolled through that it would have been oh silly me I don't have the pass in the car.
Nope I try to do the right thing, ACCIDENTALLY give incorrect change and get berated by the state trooper. He asks me in the most condescending tone, ""You know how to count, right? How old are you? You went to elementary school?"" I answer, ""Yup.""
""Middle school?"" He asks.
""Yup."" I answer.
Tone gets even more sarcastic.
He asks me, ""High school?""
I say, ""Yes. Sir."" Being sure to enunciate each word loud and clear.
He goes on with, ""Some college?!""
""That's correct officer, finished even."" I answer more quickly and coldly.
He then let's me know he has no reason to believe that I made a mistake and was actively trying to rip the state off. I show him the multiple quarters, dimes and nickels at my disposal that can make this situation go away. He huffs and goes back to his car. For 15 MINUTES!
I knew there was no more discussion to be had with this man. He handed me my summons for ""theft by deception"" had me sign and asked if I had any questions. I asked what class crime this was and he told me it was a misdemeanor. He then told me I should be careful since toll took a pic of my license plate they could suspend my registration.


TL;DR I made a mistake. My question I guess is do I call and file a complaint? He was super sarcastic, condescending and rude. Officer was not interested in a dialogue and had mind made up before reaching my car. What would you do reddit?


EDIT: Woah! Guess I pissed someone off in law enforcement with this post. Someone went on a downvote spree on my comment history. 300 less karma this morning. Interesting.


EDIT 2: Looked up Violation 17-A Sec. 3571A Class E http://www.mainelegislature.org/legis/statutes/17-a/title17-Asec357.html Feeling a lot better about my case. I DID try to make the situation right and it was $.40!!!

EDIT 3: Just heard back from lawyer. Sending him the summons. He's calling BS on the charges. GO TEAM! I'll be sure to post a TIFUpdate when I know more",TIFU accidentally gave toll booth 2 nickels sandwiched between 2 quarters. Now I have a court summons over $.40! [X-Post from /r/Maine] ,696
Flatline334,89,106,1cmsur,581,"So here I am minding my own business at work when a feel the need to let out a little squeaker.  Didn't feel abnormal and I had no rumblings of the tummy, but when I pushed it felt, different, not sure what was going on I ventured further into the unknown and bam...my ass let loose a torrent of liquid shit that would rival the mightiest of rivers.  Needless to say one of my best suites is pretty much ruined, half the office smells like shit and I hung up on what could have been a really good client.  Luckily, nobody knows I was the culprit and being an independent insurance agent I immediately left the office so I could keep it that way.  I drove home naked from the waist down.  I just couldn't sit in it.

**TL;DR** Shit out the Amazon at work and drove home half naked.",TIFU by having my ass explode at work...at my desk.,687
asswater_everywhere,140,188,15oty2,579,"So I'm casually having a bath, scrub-a-dub-dubbing everywhere, and I mean everywhere. I was doing a little ""keyhole surgery"", just making sure I'm all in clean functioning order - you never know when someone will want to inspect your anus.

I got out of the bath a few minutes later and immediately had a nosebleed, which had me awfully distracted for the next few minutes. Distracted enough to not notice an odd pressure feeling inside my gut.

Nosebleed under control, I sat down on the floor in front of my mothers large bedroom mirror, in order to gain a better view of my hair as I was about to blow dry it.

All of a sudden, there was a very... Odd sensation at my rear. In involuntary fart so swift that it was over before I even realised it was happening. This however, was no ordinary fart. This fart, was packing heat. This, was a hydraulic fart. It seems during my rigorous cleaning activity I had sucked up quite an amount of water, ready to unwillingly and powerfully deposit nearby.

Frantically feeling around to assess the damage, I was delighted to see that the carpet nor my pants were brown. They weren't brown, but they were wet.

This high velocity JET of warm asswater had pierced my tough underwear and had heavily soaked a small area of the carpet, concentrating all of its efforts onto a circle about 2 inches wide.

Eyes bulging, I ran to the toilet and unleashed a second powerful jet of asswater, finally rinsing out the rest of what had been previously sucked inside.

TL;DR: Sucked up bathwater into ass without knowing, sprayed it out 5 minutes later onto my parents bedroom carpet.",TIFU by spraying warm water out of my ass onto my parent's bedroom carpet.,767
usernamesabitch,74,176,1ja60j,581,"Okay, so I just got off work today and I had to tell this story somewhere. I work in a call center for a cable company for their tech support. Today I got a specific call about something along the lines of ""When I open internet explorer all that comes up is a giant white screen and I can never close out of the pages""

At first I thought, maybe he hit f11 and it cause the browser to go full screen. In the end I figured out he was actually using the new windows 8 operating system and just didn't know how to navigate it whatsoever. I'm not an expert on windows 8 by any means, but I thought I would at least give him a brief tutorial just to help him out even though it was out of my support boundaries. This guy was bounced from line to line and no one was willing to help him, so why wouldn't I make his day just a bit better by doing him this one favor?

Well, for one, this guy was a bit strange. He was an older man, and 5 minutes into the call he let me know ""how beautiful of a voice"" I have. Asked me my age and where I'm located (basically any information I was allowed to give out.) He repeated my name multiple times and just kept talking about how pretty my voice apparently is on the phone. I didn't think much of it, until we got to me showing him how to use his OS. 

Over the phone I talked him through typing in an address in the actual address bar at the bottom of the page on windows 8 and prompted him to type in a code which would allow me to remotely access his computer and navigate it/type stuff on it/use a highlighter/etc in order to show him how to use the computer. First things first, let's delete all those open tabs..

Lucky me I guess, half those tabs were porn. Straight up porn. My favorite had to have been the ""daddy daughter massage play"". Definitely had me rethinking those questions I answered earlier in the call. Anyways, when The tabs opened I heard him on the other line say ""Oh, hello there!"" and I about died laughing. 

The rest of the call was super awkward, and now I'm pretty sure I have a phobia of old men calling me for technical support. But at least it's over. 

tl;dr tried helping someone with a problem even though it was out of my realm of support and ended up looking at multiple pages of an elderly man's porn, then had to close it out for him because he didn't know how. TIFU.",TIFU by trying to help an elderly man use IE on windows 8,757
cbjaycee,77,124,1gb4p7,572,"I sometimes work from home, and today was one of them.  

Needless to say, I am on Reddit and Facebook, while making calls.  In our work chat room (only for employees, no customers), a question was asked, which I knew the answer was in one of our blog posts, which are listed in a google doc.

I do my command C, Command V and enter.

But the google docs and copy/paste Gods hate me.  Because...

Earlier in that day, my friend was going through a divorce, and her STB ex-husband was making her life difficult.  I told her to send pics of some of her more intimate parts, and tell him that he used to own them, but now they belonged to someone else, her.  Somehow it got to cow parts, so I googled a subreddit for cow udders to post, but just came up with a subreddit of women with huge tits that they were calling udders.   Worked well enough for a haha.

Except... Instead of the support document link I wanted posted in my company chat room... it posted the dirty subreddit. 

Yep.  Lesson here kids:  Look before you hit enter when copying and pasting.

TL;DR I meant to send a support document to a chat room at work, but I sent boobies instead.
",TIFU At Work - Multitasking and Reddit do not work well together. I'm probably fired.,696
Moosemaster21,95,153,1dkh7j,571,"To set the background, I dated a girl for a year and a half and we very recently broke up. She at one point bought pink spandex for running, but they were too big for her, and since I wear compression shorts for underwear, I told her I'd take them as a joke. She gave them to me.

Today, before work I realized I had no clean underwear and no time to do laundry. I tore apart my room until I came across the pink shorts, and decided ""hey, these are as good as any."" So I put them on and went to work. I was smoking a cigarette on my break, and went to McDonald's for a quick bite. The server handed me my food through the drive thru window, but she sort of pushed it at me, and knocked my cigarette out of my hand onto my seat. I picked it up quickly, and brushed off a little piece of ash that had landed on my thigh. 

Suddenly, I smelled something burning, and an instant later, searing pain shot up the back of my leg right by my ass. I pretty much had to stand up in my car and put out that ash, that I apparently had been sitting on. When I got back to work (I work in retail) a customer told me on his way out that he liked my fashion sense. I was like... What the hell haha we're all in uniform? But I quickly realized that the ash from the cigarette had burned a decent size hole right through the ass of my pants, and my hot pink spandex could be seen clear as day.

Later on, apparently a couple people mentioned it, because I got pulled aside by my manager, who told me ""We support individuality, but we are in uniform here. You need to make sure you adhere to the dress code."" I was given my final warning (I have been late a few times) all because I didn't do my laundry.

TL;DR TIFU by taking pink spandex from an old gf, not doing my laundry, wearing the spandex, going to McDonald's, and smoking cigarettes. Hopefully this will be incentive to quit...",TIFU for a number of reasons... All because I didn't do my laundry.,724
rainbowdiarrhea,127,120,16dm9j,574,"So... I pissed in my friend's bed today... with him in it.

Yep. I'm staying at his house for a couple of days while I try to move into town. I'm 23 years old and I wish I had a valid excuse. Nope. I peed the bed. He was snuggled up right next to me. ...As in like less than a foot away. He may or may not have been in the [Splash Zone](http://en.wikipedia.org/wiki/Supralittoral_zone). I'm not entirely sure. 

So, I'm in a partial coma and I'm having like the best sleep of my life with the most amazing dream when all the sudden I feel some odd relief. Felt fuckin' great. Felt fuckin' amazing. Two minutes later my eyes pop open and something didn't feel right. Dude, did I sweat *that much*? I sat up and felt the bed and thought 'No. *Nooo.*' and I just blurted ""**OH MY GOD**!"" There was no way of getting out of this, I peed the bed like a 3-year-old girl. No discreetly pulling off the sheets and putting them in the wash under the guise of period blood. This was a nice big puddle of yellow glory. So he wakes up and he's staring at me like I'm crazy, I have my hands over my face and I just sit there, suspense is rising and it smells like pee. I'm wondering how I'm going to tell this poor man I peed the bed. 

""I just pissed myself."" ^Like ^a ^bandaid.

He stares at me for a second like it didn't exactly compute for a second gives me this I-hope-you're-kidding look then gets up and says ""Well I guess the sheets have to be washed."" 

So we start stripping the sheets and this amazing man, like any respectable bachelor should, has a fucking piss-guard sheet over his mattress. At least I didn't fuck that up. We pull off the sheets and they're in the wash and I'm sitting here while he tries to sleep next to the bed-peer. I'm a sexy beast.

This just takes the ~~cake~~ the whole bakery. I'm going to go kill myself.",TIFU pissing in my friends bed... with him in it.,694
StevilCanevil,129,195,1bol63,570,"So it was another sunny day in Southern California, had just went on a nice run on the beach, took a shower, shopped the farmers market, and decided to go get an Acai Bowl from one of the shops near the farmers market. Keep in mind that I hadn't done laundry in a few days so I was officially out of boxers, which is usually No Big Deal. I also happened to be out of the majority of my shorts so the only ones I had left were some all white cargo shorts, so I put them on along with a green hoodie.

Anyway, so I go up and order an Acai bowl from my favorite spot. While I am waiting for it to be made I take a seat outside and play around with my phone....Here is where shit got a little weird.

So I feel a slight rumble in my belly, most likely some casual ass gas, decide that since there is no ladies around I am going to release a small gas bubble from my belly, via my asshole.

As soon as it was escaping my sphincter I realized that this was not the gaseous exhaust I had expected, but more of a liquid explosion that soaked my shorts like I had sat on a dozen water balloons. 

I ran inside to get a bathroom key, only pointing my body toward people face first, since I was trying to hide my shit stained short mess. I then began to wait in line for the bathroom while dancing nervously .

Finally I get in to the bathroom and rip my shorts off, begin rinsing them in the sink and scrubbing with water, eventually realize that there is no way I am getting out of the bathroom without being stuck in muddy white shorts. I start to feel trapped inside the bathroom realizing that there is no way out. Time continues to pass by as I am standing there ass naked in the bathroom with my shorts in the sink. My acai bowl had to have been done for at least 15 minutes but I was trapped in the bathroom with wet shorts that are still  ridiculously stained with shit. 

I sat there using toilet paper and sink water to hide my shitty mistake for what felt like weeks.

After what was probably realistically 45 minutes I eventually make the decision to put my wet shit stained shorts on, take my hoody off and tie it around my waist, covering the entire backside of my shorts. Go grab my acai bowl, which he hid in the freezer to prevent from melting. Walk back through the farmers market they had going on with my hoodie around my waist, shorts still soaked with water and shit. Walk back home and throw my shorts in to the dumpster.

Never again will I freeball in white shorts.",TIFU by trusting a fart while wearing white shorts,765
nashgasm,199,127,15wlgs,571,"so over the past few days i have had a building stomach ache which i thought was just gas etc. it was mild discomfort really, nothing to worry about. or so i thought. 

i had a date last night, it went swimmingly, even though my stomach hurt. i had another date scheduled for tonight, and as my stomach hurt more and more i chose to warn her that plans may change. 

i went out to lunch with the girl i had been with last night, indian food, which is pretty ballin, and tasty as shit. things went well, aside from some gurglings in my midsection. 'Gas' i thought, nbd. unfortunately after lunch on my way back to work, and thankfully after saying goodbye to my lunchdate, i try to relieve some of the pressure by taking a much needed fart. instead of relief i realized in horror that a solid glop of liquid shit had come out. i immediately half stand up in my truck, as i am wearing my overcoat, i pull it up, sit back down thinking i had saved it, then remembered my truck seats are fabric. in desperation i pull over a gift bag i have in my truck from transporting christmas presents, pull the gift out (it really was nicely wrapped) and shove the bag under my ass praying the cause of the putrid smell in my truck hadnt yet seeped through. 

i immediately begin gunning my truck back to my apartment, about five minutes away from where i work (lucky), swing into the lot, ever feeling the shit keep dripping from my ass, for some reason i couldnt stop the flow, and god my intestines were about to make me scream. as i hurredly park my truck, get out, and remove my overcoat, i can feel gritty feel of the shit particles in my pants chafing, and in horror i look at the bag which had been under me and there is no sign of the liquid. i run upstairs, barge in on my roomate, run into the bathroom, and promptly step in dog piss as he hadnt let his dog out recently. 

i sit down on the toilet, without even closing the door, and begin spraying a disgusting, green stream of shite, groaning and bemoaning my fate. i shrug out of the pants as fast and best i could, and figure out where the liquid had gone. almost the entire back of my pants was tinged brown green.

so, here i am, desperately pissing a stream of shit from my ass, looking at my favorite pair of now ruined jeans, and what used to be my lucky boxers, groaning as my intestines try to tear themselves out of my body, and my boss texts me to ask where the fuck i am and inquire why i am not at work. 'sorry, shoe broke, be back in a jiff' is the only response i could think of. 

 i stand up eventually, nearly puking at the smell, my roommate having booked it when he heard the first splatter, flush the toilet four times, hop in the shower, nearly crying in desperation as i try to rinse myself off from the evil i just experienced. as i wimper and hurriedly find new clothes to rush back to the office, i once again drag my foot through dog piss on the floor. 

i get back to my truck, throw the bag (which smells of the vile, green shit) into a dumpster and make it back to work just in time for my manager to stop at my desk and ask if i had 'fun clowning around during lunch, and please get back to your damn work'.


**TL;DR** Descended into the depths of hell, resurfaced a shaken man.",TIFU Ignoring a Stomach Ache,698
My_mau5_died,95,229,1nk079,565,"So i was sitting under my back porch doing my usual ritual of ripping the bong.  The bong is made from a glass downstem and bowl and an ""Ice"" drink bottle, because my glass piece had recently broken near the base and I haven't bothered buying a new one yet.  So I had the bong in one hand and a bottle of black raspberry ""Ice"" in my other.  I was on my 3rd or 4th bowl and I was pretty baked at this point.  I thought: ""Damn, I'm thirsty as fuck."" 'Cause you know, cotton-mouth.  Without thinking, I put the bong to my lips and knocked back a nice gulp of 3-day old bong water.  I mean this shit was dirty, it was brown and full of ash and little herb chunks, and the second it hit my mouth I spit it the fuck out all over myself.  To make it worse, there was stinky ass bong water all over one of my favorite jackets, my pants, and even my shoes.  To make it even *fucking worse,* the red-hot fucking ember landed smack under my nose and burned the shit out of it.  To make it even fucking *worse* the water got in my phone speaker, which now sounds like complete shit, and even soaked a pack of my favorite cigarettes, ""lucky strike reds,"" that were in my other pocket.  Now at this point, it can't get any worse, right?  Well guess fucking what, when I dropped the bong, the glass bowl and downstem fucking shattered.  Thank god I have a backup piece.  

Oh, and it's not even over yet.  I was picking up the glass and it cut my fucking hand.  Oh boy, I thought.  This is not a good day.  Walking back inside, I then *stubbed my fucking toe on the door,* tripped and knocked over a lit fucking candle sending gross candle wax and broken glass all over the floor.  Today was just not my day.  I clean the shit up, and decide, ""Okay, I need some fucking food,"" because I was just pissy and had really bad munchies.  ""At least I have leftover shepherds pie from last night.""  Wrong.  I left it out on accident and that shit was *fucking gross looking.*

Fine!  Obviously God hates me at this point, and I just thank him that I live so close to taco bell.

I walk to taco bell and guess what?  The fucking place is closed and under construction.  

Now I'm just sitting on my couch in the basement at a [4] quietly sobbing and telling my lovely story to the internet.

TL;DR The stoner gods have cursed me.

Edit: Thank god for back-up bongs  http://i.imgur.com/gAIGjvW.jpg",TIFU by accidentally drinking bong water,794
Dalmazz,166,198,1i9zfk,571,"Today, I thought I submitted a marine biology assignment on a thumb drive to my teacher (bear in mind I have to thumb drives that are the same, will post pics if interested), after getting home, I realized that I had given her the wrong one, the one I gave her only had one file on it, the movie 'A Serbian Film' I downloaded it as a joke, and was going to give it to a friend.",TIFU by giving my teacher the wrong thumb drive.,769
zhongfu,307,120,1560zy,567,"I was at said airport and found a cool app that could deny access to people on WiFi networks. Wanted to try it but accidentally redirected everybody to my phone and then to Google. 

People currently surfing were brought to www.google.com (for example, http://acme.com/blah.php?derp=herp became http://google.com/blah.php?derp=herp) and as a result, people couldn't log into the network and those already logged in could only use Google. 

I shut it off and half a minute later, the connection dropped suddenly. *shit.*",TIFU by shutting down an airport's wireless hotspot,687
Captainhowarth,97,209,1ji1xr,566," Not today but last year.
So I'm a part timer working for the British army voluntarily. Occasionally I work with cadets but mostly do paperwork. Anyway now and again I get the chance to apply for more exciting work which can include having to visit quite senior officers. 
So I was sitting at a desk filing in forms about how many piles of mud needed to be cleaned and which maniac should be let loose with a shovel when I was summoned to the company commanders office. 
Now I had been sat for about 3 hours and drinking a lot of water so naturally I decided to head to the toilet first. A tricky thing deep ding on what uniform your wearing because there can be a lot of zips, be,to, buttons and things called baffles where it's like a double pocket that requires a lock pick, crowbar and spoon to get into. So I go so my business then do up what i think is my fly and walk to the office of the officer.
I knock, get told to enter and walk in and salute.
Inside is the officer, the sergeant major and the adjutant who is in fact a woman.
The adjutant looks at me, giggles and leaves the room as I stand to attention.
The Major coughs looks a the CSM and then coughs again before saying. ""Perhaps you should...ummm... Do your zip""
At attention I cannot move until told to do so, so I look down to see my cock dangling from my trousers. But it's worse.
Because of the way my trousers are my penis is not hanging out, it's sticking horizontally towards the desk. Hurriedly I try to zip it up but the zip gets stuck as I'm furiously trying to do up the zip. As I struggle I inadvertently let go of the zip and my hand flies out to knock a photo off of the desk.
I stop. Calmly pick up the picture, with dick still free and acting like its saluting the officer pointing at the Major as it slowly becomes more frightened and tries to retreat into my trousers. I place the photo on the desk, salute and leave the office. Managing finally to zip up the fuckin' trousers.
Next day I get transferred to another company. 
Tl;dr.  Saluted a Major with my cock.",TIFU by having another dick adventure,775
throwaway_wight1,132,184,1nv994,564,"
I was due this morning to give an important presentation to a society I help run and I made the mistake of drinking heavily last night. 

  I was massively hungover but still managed to get through the majority of the presentation without problem. Then as I was reaching my concluding section, I felt the need to fart. Or at least I assumed it was a fart. The room was fairly loud due to the equipment and the music I had running, so I decided to risk it and let rip.

  It was only about a second after that I realised it wasn't a fart, it was shit. Only the fact I was in a skirt rescued me from humiliation, as it meant the lump in my pants was hidden. After the presentation finished I ran to the toilets and flushed it. ",TIFU and crapped myself in front of an audience.,748
taylordesoto,189,166,16pfle,564,"I just recently got a tattoo on my thigh, and I was wearing jeans at work.  My two buddies that I work with told me to show them my tattoo in the bathroom.  One of my friends is recording the scene because he thinks it's funny, and says, ""drop your pants"".  I pull my pants down, show them my tattoo, and seconds after, my boss comes in and sees three guys in the bathroom, one recording with a cell phone, and me with my pants down.  He turned around and immediately left the bathroom.  

Edit: I am a guy, so are my friends, and so is my boss.

Edit: tattoo proof http://imgur.com/4oqTN

Edit: the video was taken using snap chat, so I can't provide that :(",TIFU by showing my two friends and coworkers my thigh tattoo in the bathroom at work. ,730
thatcantbegoodforyou,145,108,1hi2z0,559,"I'm a web app developer, so most of my time involves sitting in one spot and typing all day. I also occasionally like to go commando, which, combined with the whole sitting in one spot thing, can lead to a gnarly case of monkey butt.

Enter Goldbond.

For those who don't know, Goldbond is a body powder that chills the skin it's applied to. Gentlemen, if you haven't tried Goldbond, go and buy some. It feels like little elves blowing on your junk. I apply it liberally each morning, and it gives me a nice cool feeling for the first hour of the day, and keeps me from chafing or getting too sweaty for the rest of it.

See, Goldbond's magic ingredient is menthol. This is important later.

I hop out of the shower, towel off, deodorize/apply cologne, and put a couple of puffs of Goldbond over my crotchal region. I feel the pleasantly icy wave wash over my balls. I decide to make an offering to the porcelain gods before I go get dressed. I do my business, and I'm wiping.

It should be noted hear that I am a hyper-zealous wiper - I haven't graduated to baby wipes yet, but I attack my rear like I'm doing a forensic cleaning.

So I finish, flush, and go get dressed. That's when I notice an odd feeling in my butt. *I had wiped copious amounts of Goldbond into my ass. The mentholated, icy goodness was now stabbing in my asshole.*

I was running late for the bus so I didn't have time to go and try to wipe it off, so here I am in the bus with my comfortable, cool junk taunting me as my asshole burns/freezes oh-so-painfully. I'm not looking forward to seeing how long this lasts. &gt;.&lt;

**TL;DR: I wipe mentholated Goldbond up my asshole; the normal cool-breeze elves become angry, icicle-stabby elves.**",TIFU by getting menthol in my ass,667
Porso9,82,130,1hcicf,556,"So I'm a regular highschool kid who has trouble figuring out when he needs to go to bed.  I usually end up going to bed at around 2:30, so I don't stay awake easily in class.  English class is particularly boring.  We were watching a movie because it was the beginning of the school year, so I decide to try to take a nap instead.  I'm going in and out of sleepiness, which is suddenly interrupted by my own fart, causing me to jump, kind of like when someone scares you by coming up behind you and yelling.  Instantly, everyone is staring at me.  My brain quickly enters panic mode, and determines the best response is to say ""sorry,"" as if that would fix anything.  Late puberty kicks in and my voice cracks, so it comes out with a high pitch at the ""sor"" part, then the entire ""ry"" part is cut out.  Now I'm sure everyone thinks I have some sort of issue.  I didn't talk to people in my English class for the rest of the year.


Replaying from the beginning, I fart, jump, then let out a high pitched ""sor,"" and everyone stares at me.  After telling my friends this story, they have made a habit of saying ""sor"" in the same voice whenever someone farts.",TIFU by falling asleep in English class and farting myself awake.,686
pissing_angels,321,292,12iq2u,558,"hey everyone. i tried posting this in /r/relationships but it seems to have gotten lost in the sea of tears over there.  

i went home with an older woman at the bar last friday. i'm 25, she's at least 15 years older than me, and the entire time during the course of our sexual intercourse, she told me to finish inside of her. now, no girl has ever asked me to do that, plus she was my first cougar so it was really exciting.  

we talked about the consequences of me splooge-ing inside her, while i was still inside of her, and the excitement of that conversation catapulted the fluid directly into her vagina, so i pretty much said ""fuck it"" and did it a few more times after that.  

anyway, now she's acting super clingy. i gave her my phone number and email address and she keeps calling, texting, emailing me all times of the day.  

am i going to be on Maury? my mom watches that show.  

tl;dr i splooged inside an older lady and now she's being really clingy even though it was her idea  
  
**EDIT:** she wants to make me lobster bisque this weekend and probably take more of my load and i dont think i can resist  
  
**EDIT2:** i cant go back to wearing jonnies  
  
**EDIT3:** I'm definitely going to fuck her butthole  
  
**EDIT4:** almost as many tears here as /r/relationships   
  
**EDIT5:** the bisque was great, but I only got a few spoonfuls before she was in my pants  
  
**EDIT6:** i should probably go was my dick now  
  
**EDIT7:** i wish i got to eat more bisque",TIFU a cougar stole my splooge,850
throwawayfwearf,351,326,1ne4qt,560,"Hi, before we get things started I'd like you guys to know that I'm a sixteen year old male. A few months ago my girlfriend of over a year ago attempted to kill herself by taking every pill (over 100) she had. After she OD'd, she sent out a mass goodbye text and called me. I called an ambulance and she ended up in the hospital for two weeks. I visited her everyday and at first it was really horrid because she couldn't talk and she spent 90% of the time crying, trying to say something, or sleeping. It sucked. Anyways the whole suicide thing taught me that life is short and ends unexpectedly, and this, of course, inspired me to do dumbass stuff just because. After her two weeks in the hospital she was sent to a mental hospital for two more weeks. I personally think that she should have been there for longer but there really wasn't anything I could do about that situation. She came back and on her birthday I borrowed my parents car in the middle of the night and visited her. I don't have my drivers license. That was my first time driving on a road. I had to drive twenty minutes to get to her house. She was sleeping outside in a tent because the cabin her family was renting was horribly tiny. I entered the tent and woke her up. We talked, kissed, cuddled, and had sex. It was the first time both of us had had sex. It was okay. After that I drove back to my house and went to sleep. Then the next night I did it again, and I did it the night after that. On the last night of my adventure I got arrested. I didn't tell her I got arrested. I got pulled over for not stopping entirely before turning on a steady red. It was horrible. I was put in the back of a police car and my parents were called. thankfully I wasn't put in jail but I had to court in a month ish. Flash forward a month ish and I just got out of court. Me and my girlfriend broke up because she wanted an open relationship and I didn't. She was about to move to another state for the winter so I met up with her right after I got out of court. We talk and stuff. Then she tells me she missed her period. Her period was missed. By eight days. We talk about it and stuff. She's getting a pregnancy test today. I hate myself. I never used to be like this. I might of just ruined her and mine's life. I hate myself for everything. I'm the worst child my parents know. I'm 16 and I might be having a child. I'm really afraid that people in her other state are going to call her a whore and a slut. I wish this never happened. I'm really sorry. I'm so sorry. I'm crying now. Bye.

ttyl; Stole a car; got arrested. Fucked my girlfriend; got pregnant. ",TIFU by ruining my life,886
lookAtMeHard,122,168,1d9qvu,559,"**I meant ""HAIR CLIPPERS""**... my bad :/

I occasionally give my nether regions a well-deserved trim (usually coinciding on the guarantee of sex). My chosen style is no.4 around the pubic area and no.1 off a bit of the shaft hair-growth. , including a quick no.1 lightly over the odd long hairs of the ball sack.

Everything is going just dandy. I complete the pubic area, change guards, and trim a bit off the shaft. , then proceeded to the sack.

All of a sudden I watch (and feel) the machine take an aggressive bite out of my balls. Immediately there is blood welling over into the basin I am positioned over.

There is enough blood that I started to envision being found dead in my room, cock out, covered in blood while clutching a razor.

For a while I just did not know what to do. I just continued to watch the blood dripping quickly into the basin. I then snapped out of the trance I was under, splashed water over the wound, wrapped a towel around me and ran to the shower. Gave everything a proper rinse and could notice 3 V-shaped cuts, skin-flap still intact. The bleeding took a while to slow down, probably not help by the constant wetting from the shower heads.

I was determined to still go out and was prepared to just explain what had happened if I had to so I got all dressed up. Feeling a bit weak from my endeavours I slumped onto my bed. It felt so comfortable. The more I lay there, the more I dreaded the thought of exerting the amount of energy required for a night out so I just threw off my clothes and went straight to sleep (at 10pm).

The next morning I had texts on my phone from the girl I was planning to see, asking where I was. The following night we made plans and I was forced to explain the battle scars!

*Editted spelling errors

Edit2: **[Here are the photos OF MY BALLS[NSFW] you requested. Bear in mind they are probably an anti-climax](http://imgur.com/a/1Lm4J)**","TIFU and learned that a hair razor, even with a guard (no. 1) can take a gouge out of your ballsack!",727
thisisathrowawayomg,108,169,1lv5oz,560,"I was hopping in the shower and decided I'd send some nice x-rated pictures to my long distance boyfriend. After the photo shoot, I sent the 5 best, most revealing, sexy images to the last person I texted, which I thought was my boyfriend. I forgot that I had texted my mom about going home this weekend and wound up sending them to her during her work day as a teacher. 

Though I'm thoroughly embarrassed, I'm hoping we can both treat the situation like adults.

TLDR: Always check who you're sending pics to.",TIFU by sending my mom nude pics of myself.,729
KittenPurrs,119,83,zo9r4,559,"I was driving merrily along when the mother of all spiders spun down from my sun visor, mere inches from my face.  I completely lost my shit, flailed at it, knocked it somewhere, and then went into full panic mode trying to figure out where that bastard went.  Then I hear the warning ""boop boop"" of the police car behind me.


Cop:  I saw you were having some trouble maintaining your lane back there.  Have you had anything to drink today?

Me:  No, I'm sorry...  There was this giant spider that dropped in front of my face, and I- OH MY GOD THERE IT IS!  Kill it!  Taze it or something!  STOP LAUGHING AND PROTECT AND SERVE, YOU ASS!


Still laughing at me, he reached in and smooshed the monster spider on my dashboard.  After asking some clarifying questions about exactly how a spider resulted in my swerving all over the place, he told me if this ever happened again, I need to pull over immediately, rather than risking ""endangering yourself and others again.""

Thankfully, I was not ticketed for driving while arachnophobic, and went on my way with a verbal warning.


Edit:  I don't understand how pronouns work.  ","TIFU by ""endangering [myself] and others"" while responding irrationally to a spider.",642
IamSeth,181,126,1apavd,556,"Being poor and unemployed, I found myself with only two items of non-ramen food left: a pack of cornbread mix and just enough eggs and milk to use it, and a frozen chicken breast. I decided to put the chicken in the cornbread and let it cook like that.

I set the oven, set the timer, put everything in to cook. Only now, ten minutes later, do I realize I completely forgot to defrost the chicken first.

My raw chicken cornbread smells delicious. I could cry.

EDIT: I do have ramen. I'm not gonna starve...

EDIT EDIT: People on Reddit are so *nice*! Thanks for the kind words, guys.

EDIT EDIT EDIT: Since people have asked, I wound up taking the whole dealie out of the oven and just microwaving the chicken for ten minutes, putting it back, and restarting the oven. Ugly, but effective. It made the chicken really incredibly dry, though; I do not recommend the microwave method.

People are asking about ramen/poorfood recipes a lot in this thread, it made me wonder. Is there a subreddit for college dorm style poverty cooking? Could be fun.

EDIT EDIT EDIT EDIT: Some people actually sent me food/grocery money! You guys are awesome! Thank you so much!",TIFU by skipping an important step when cooking...,682
StyleRaptor,100,91,1iokhe,556,"I was on a date with wife and we stopped in to the chain restaurant Ruby Tuesday for a meal. The server came to the table to make suggestions and take our order. The restaurant was running a special on boneless buffalo wings, and I wanted to try them.

Knowing that chains like Ruby Tuesday and Applebee's describe bland foods as ""spicy"" and mild as ""hot,"" and I asked for ""very hot"" wings. The waitress asked if I was sure, saying mild was the most she had ever tried and assured me that was too much for her taste.

""**Tell the cook to make them like he hates me**,"" I said confidently, looking her directly in the eyes. The waitress actually stepped back a step as she reacted. Her eyes widened, and she choked out ""OK.""

My wife looked at me and asked what I was doing. Overconfidently I said I told her I knew what I was doing and explained my reasoning.

Our waitress returned and informed us that the wings would be a few minutes longer as the cook was whipping up a special batch just for me. Alarm bells should have been ringing in my head, but instead I was thinking how good fresh wings would taste.

A few minutes later a plate with six wings was set before me. They appeared normal, perhaps a little heavy on the sauce. I leaned forward to take my first bite. Again, alarm bells should have been ringing at this stage as my nostrils inhaled the first scent of my meal. The only thing I ever experienced similar to that smell was residue from pepper spray. Like an animal walking into a slaughterhouse, I picked up the first wing and bit down.

The wing dropped to the plate as what felt like an oil refinery fire erupted inside my mouth. The waitress looked at me, her face locked in an odd combination of concern for her tip and satisfaction that the wings were indeed hot. 

At this point I knew I had walked into a trap. I inhaled deeply, trying to get fresh air that wasn't tainted by this horrible fiery torment. Relief was slow in arriving. It was becoming clear that my wife and the waitress were waiting for me to take another bite. I steeled my resolve, determined that I wasn't going to be beaten by something as simple as chicken and bad judgement. 

The second bite was not as bad as the first. ""I can do this,"" I thought to myself. A third bite, and then a fourth finished the first wing. Only five were left to go. Five incendiary chicken grenades for my mouth. I lifted the second wing to my lips. As I bit into the orange colored chicken, it was if a flashover happened in my mouth. Somehow this wing was even hotter than the first. 

I swallowed the wing, chewing only enough to prevent death from choking and lunged towards my drink. Watching me fight these wings of death had become a spectator sport, with people at tables in all directions looking in my direction. 

""I'll need a refill,"" I wheezed. That's when the deathblow came. My eyes were watering uncontrollably. A dabbed at them with my napkin, unintentionally touching my eyes with remnants of the hot sauce. I was almost totally blind. The room dissolved into rough shapes. It was if I were looking at a room through both sides of a round fishbowl. There was no recovery. I covered the wings with my napkin and told my wife I was through.

The cook came out to see me at this point. I was a beaten, broken man. Through eyes nearly swollen shut with pain, I managed to congratulate him on a job well done. He was a good sport, leaving for the kitchen after that and returning with a couple glasses of milk to ease the pain.

Summary: Ordered hot wings, got sarcastic in order, cook tried to burn my stomach away with evil hot sauce",TIFU When Ordering Buffalo Wings At Ruby Tuesday,647
l3aca,190,192,1gsrkq,553,"Yesterday, I bought a gallon jug of Arizona Fruit Punch. I cracked it open this morning at about 2. I drank the entire thing, then went to bed. To my horror I pissed all over myself.

UPDATE: I don't have diabeetus",TIFU by drinking AZ Fruit Punch,745
AdventureClub450,166,90,vzuk5,556,"Created an account just because I just saw this subreddit and thought, ""oh how perfect."" Parents are in Palm Springs and I had my dad's car. I met these 2 guys at a grad party on Sat. night and they were pretty chill when I met them.

Wake up the next day and tell them to come over and bring some beers and we'll kick it at the pool. So there is 4 of us total, 2 guys 1 girl and myself. Guy and girl were leaving my place and couldn't find the other guy(We'll call him fuckface) so they just left, when fuckface called them and they said they had already left, fuckface decided to take the keys to my dads car while I was passed out. He then takes car and goes home and then takes it to work with him on Monday.

I call him and he ANSWERS! He tells me he doesn't have the car and didn't take it. I go find our building surveillance footage and find him walking around the garage trying to find the car. Then I see the car leave at 7:48pm on Sunday. I call him again, tell him, ""Hey man, I know you have the car, I have it on video and I just want it back. We don't have to get the cops involved but I will if I have to. He repeats the fact that he doesn't have the car. This is where I report the car stolen.

I'm a fucking mess trying to file a report with the officer at my house and tells me that hopefully I get it back sooner than later. I text the other guy and he tells me he's going to drive by fuckface's house after work and check. He goes and finds the car there parked on the street still fine. Call the cops and tell them the address. 30 minutes later I get a call telling me they have the car, the key and they're arresting fuckface.  
  

  So I tell the cops that it's my dads car and that I'm happy to have it back because I don't want to tell him about what a huge fuck-up I am letting some randoms into my parents house and stealing my dads car because I was passed out drunk. They say "" Bad idea."" Since the car was reported stolen, now the title will be Salvaged instead of clean . Parents get home tomorrow and I already know it's going to me fucking MISERABLE to tell them this.

TL;DR

Had 3 people over at my parents house I met at a party the night before.
I passed out, one took my dads benz back to his house.
Called the cops, gave them his address.
I got the car back, unharmed.",TIFU and invited some people I just met to my parent's house while they were out of town and one of them stole my dad's Benz while I was passed out.,646
throwaway-7913,122,113,13e9ad,549,"Greetings, Reddit. Sadly, I fucked up today, like, a lot.

I was searching for some old videocasettes from when I was a kid, because my younger sister wanted to watch them. These are usually placed in a box in our living room, but because we have been moving around on the furnitures my parents had put the box of old videocasettes inside their individual clothes cabinet in their bedroom. 

Now, the thing is, I found two boxes with videocasettes, one being unlabelled videocasettes in the box from my mothers clothes cabinet, and the other being numeric labelled videocasettes in the box  from my fathers clothes cabinet. I didn't know which was which, so I just took a pair from each, took them with me and my little sister into the living room and let her watch it on the TV.

About 30 minutes later I hear moaning and some rather weird/disturbing noices coming from the living room. I walk in there to see what's going on.

That's when I notice that the unlabeled videocasette that my younger sister had put in the VCR after the first one I put on was over, was a tape of my parents having vigorously wild sex in positions that even I didn't know of, and the worst part is that my younger sister asked me why our parents had filmed themself wrestling in their bed, I seriously didn't know what to tell her. I quickly turned off the TV, removed the videocasettes and put them back to the clothes cabinets in my parents bedroom.

What worse is, my parents didn't find out because my sister told them, but because I, in the middle of panicking, had switched around on the boxes and placed them in the wrong clothes cabinets. 

Reddit.. Today I fucked up..",TIFU - Found a box full of old videocasettes of my parents that I shouldn't have found,662
creepycreepercreepin,77,148,1kybpo,552,"Earlier today, I hopped in the shower in preparation for an awesome double date night with my girlfriend, my best friend, and her boyfriend. In anticipation of some possible sexytimes, I began the process of achieving silky smooth legs. Now, my shower isn't the roomiest. I can't go a day without causing mass destruction of shampoo bottles while trying to reach for the body wash. Shaving is usually a bit of a challenge in there. This is further complicated when you factor in back problems. So here I am, my leg hiked up on the shower wall, looking like some russian gymnast, shaving my leg. I finish with the right, after some careful balancing and maneuvering, and begin to move on to the left. I shift around, testing different positions for best access. Finally, after a good two minutes of moving around, I find the prime stance. And it just so happened to be the stance where the water was being launched straight at my crotch. All of you ladies will understand the glories of showerheads. They're wonderful, wonderful things. Unless you can't move them or, in my strange case, need to shave your legs. And so the battle began. It became a race between my shaving abilities and my orgasm control. Much to the amusement of my girlfriend, I lack willpower when it comes to the second. I get halfway through shaving the lower half of my leg when I know exactly what's about to go down: Me. I lost my balance, began to slip, and in my pathetic throws of showerhead violation-induced passion, ended up smacking my head into the wall. So now, here I sit, a bag of frozen veggies soothing the lump on my head, and half of a fuzzy leg.",TIFU by having an accidental orgasm while shaving my legs.,700
OJisGuilty,134,177,1boutv,551,"First things first, I am straight and currently have a girlfriend. I work at a store in downtown San Francisco which consists of about 90% gay/lesbian. I personally never minded it. But today I fucked up by asking a coworker to smoke with me after work. It not once came across my mind that he could possibly be taking this the wrong way. Well we get to my car, talking, everything's completely normal and I start to roll a blunt. Throughout this whole time, he's just sitting on his phone, talking to me about his country (El Salvador). 

Okay, so the blunt is rolled and we decide to change locations. And as you know, a good ""smoke spot"" is typically a real isolated place. We get to smoking, and half way through he can't hang any longer. So I try and finish the blunt but then ended up putting it out. So i open my door, leave over to put the blunt out and i feel a hand on my thigh. I think to myself, as I'm leaning out the car door, ""Hmmm is this guy really trying make a move...?"" 

So, long story short, HE WAS. I slowly came back inside, somewhat scared. He starts trying to actually RUB my leg now. (I'm not the type of person who's going bash out and get mad at him for doing this, cause then it'd be super awkward at work.) So I just sat there and tried to make the most horrid face i can make. Guessing he didn't see it, cause this guy literally jumps across the car and starts trying to really get busy. I just back up and say ""No dude"". 

From there, it was so awkward in the car. I drove him home and he just said sorry. And now It will DEFINITELY be awkward at work. So today I SO fucked up by asking a gay coworker to smoke weed with me. :(",TIFU by asking my gay coworker to smoke with me after work.,728
IphoneIPadLinked,50,119,1putpt,551,"Throwaway account just to be on the safe side...

It was just a casual lazy day of watching football until my long-distance girlfriend sent me a dirty snapchat picture or her in just her underwear. Naturally, I respond in kind, and things escalate from snapchat pictures to snapchat videos. Eventually, I conclude that the exchange would be better suited for face time, so I send her a facetime request. She couldn't answer because she was having internet problems, but being ridiculously horny, I kept sending her invites to facetime. 

After about the 5th attempt, facetime shows that its beginning to connect with her, and I have my camera facing my hand holding my dick, because I'm sure that is what she wants to see. After about 3 seconds of it connecting me to her, I see her dad looking thoroughly disgusted. 

I nearly shit my pants and text her frantically asking what the fuck just happened. She then texts me and notes that her IPhone and IPad (which happens to be at her parents' house) are linked.

I have no idea what to do. I don't think he saw my face, but I'm not positive, so we are debating between playing the ""my roommates stole my phone and tried to be funny"" story and the ""deny deny deny"" strategy. I'm not sure when the next time I see her parents will be, but it will definitely be interesting to see if he was impressed by what he saw.

If there is a lesson to learn from my story, always have the camera on your face when you are trying to facetime someone, so that your girlfriend's dad doesn't see your dong.",TIFU by masturbating on skype with my girlfriend's dad,670
mlg131,191,136,11gikx,551,"Just two weeks after first watching the parody video of the same topic I suffered the same fate myself, but with very different consequences.

Im in Asia at the moment, travelling alone. I went to a bar last night and after a few beers ended up talking to an american girl. We went back to my hotel and had sex. However, I was very drunk at this time and didnt even notice when she slipped it in her back door while riding on top of me.

I didnt realise until after I finished, I went to the bathroom to dispose of the condom. When I looked down I was shocked; it was covered with 'brown'.

The girl left shortly after and I immediately checked my bed. The sheets, the doona cover and one of the pillows even, where all also tainted with 'brown'. 

It was actually 9ish in the morning at this point so after a thorough scrubbing in the shower I stopped off to request new bedding at reception. I even left the forever unclean bedding in a pile on the floor for the cleaners. 

However upon returning to my hotel in the afternoon my room had not been cleaned. I didnt worry about it too much at the time. Until the cleaners came in. I was still in the room when they were changing the bedding. It was so embarrassing. I could not look at them at all. And the worst part, as i was condidering jumping from the balcony just to get away from there I saw it, the empty condom wrapper. FML",TIFU by sticking it in the wrong hole,687
PandEyez,124,140,1j15vl,551,"Happened a couple weeks ago during a family vacation we all took together. It was a beautiful day and a portion of the family was outside enjoying some white wine while we all sat and stood around. 

My two sisters and I all live in different countries so we don't get to see each other as often as we would like to. 

I walk over to my oldest sister, feeling all emotional, and begin to kind of pat/squish/caress her upper arm. She has lost a lot of weight but still has some cellulite-esque consistency. As I'm doing this I get a bit lost in the conversation and my hand slowly creeps closer to her fun bags.

All of a sudden everything just kind of stops and she lets out an awkward/shocked noise. I look down and my hand is grasping part of her boob mid-squeeze before I realize what's happening. I was tenderly massaging her bewb.

Awkward sensations all around my body. Family members around start to laugh, I try to play it cool and blurt out some remark about her arms and breasts and consistency.

Luckily we're all very close *wink wink* *incest joke* and everyone, including myself and sister, laughed about it and never talked about it again.

tl;dr

Got to first base with my sister",TIFU by fondling my sisters boob,691
Iieutenant_dan,129,139,1ctlhf,548,"So today I was playing golf with some friends, having a great time and all until I come across a baby turtle that had somehow flipped over in the middle of the fairway. It was pretty hot outside (75-80) so I thought, ""Fuck it, I'm saving this little guy."" So I pick up this baby turtle, and walk with it for the rest of the hole until I show my friends and share ideas of what we will do with it. All my friends suggestions were shit so I just went with my own idea which was to put him in the nearby pond so maybe he can find some other turtles and start a new life. I drop him 2-3 feet off of a small bridge into the water, small tears coming from my eyes, and wish the little guy the best of luck in his new life. Walking away, I turn around to see him still in his shell, not moving about 1 foot underwater. I wait for him to come out of his shell and swim off, but he  won't come out and still stays in the same place. After a couple of minutes, his shell turns upside down, and sinks to the bottom. I still to this hour have no idea if he was fucking with me or I had just drowned a baby turtle.

TL;DR Tried to save a baby turtle by putting him in a pond, drowned the son of a bitch
",TIFU by trying to save an animals life,687
AnandaUK,115,75,x4y17,551,"I was babysitting this 12 y.o. girl whose mother owns a gas station/store. Their house was attached at the back of the store, really just a few bedrooms and a bathroom as the store itself had a very large kitchen for them to use when needed. 

Anyway, we were able to go and pull anything we wanted to eat off the shelves. K decides she wants some macaroni and cheese to eat, so she pulls it off the shelf and starts making it. Meanwhile, I'm still looking around for  something good to eat. I come back from roaming the shelves to see smoke *pouring* out of the microwave, while K is on the other side of the wall it's against, stirring the pot of boiling pasta on the stove. I scream and run to the microwave and open the door, to find a pile of money on fire in the microwave. K had been using the (so she thought) empty microwave to time the pasta cooking on the stove. She didn't know that you're not supposed to run a microwave when it's empty, and she never looked in the microwave before she turned it on (since she thought it was empty!)

 It turned out that because her mother was away for the evening, they weren't able to put the money in the safe when the store closed so she had told them to hide the money in the microwave. K managed to burn up the entire day's takings which amounted to several thousand dollars. 

Thank goodness I happened to know about the U.S. Treasury replacing money as long as they can still read a serial number! ",TIFU by letting the kid I was babysitting make her own macaroni and cheese.,626
vomitassault,129,165,1fvk2a,546,"One of which being a local artist whom I really admire and have been working with to try and secure a solo show for myself in the upcoming months. We made small talk until I revealed my true purpose for being there. ""Uh...I need Plan B, please."" ""Oh,"" he replied, ""The ultimate party drug.""","TIFU by going to the local pharmacy for Plan B, only to discover that I know every single pharmacist who works there.",711
burnt_taco,135,137,1ny109,545,"The house was empty, I was horny and it seemed like the perfect time to break out my favorite powerful (but loud) vibrator for some much needed self lovin'. So I opened my toybox, took out my beloved vibe, plugged him in and moaned in bliss as he hummed away on my aching nether regions.

My body began to tense, I groaned as I felt my orgasm build and then suddenly... ""POP!!!""

A puff of smoke rose from between my legs as I unceremoniously threw the dead beast to the floor and scrambled to yank his still hot cord from the wall as it bit my tender flesh mercilessly and left a drop of molten plastic firmly latched to my flesh. As the cord flew across the room the smoke detector mockingly screamed at me, when suddenly I smelled the smoldering carpet beside my bed.

Momentarily forgetting about my charred lady bits, I jumped from the bed and dumped a glass of water on my floor and the carcass of the vengeful plastic monstrosity that I once cherished so deeply. And no sooner did the water hit the floor than my mom charged in to ""save"" me after hearing the smoke alarm and my aggressive verbal attack against the vile, flame throwing vibrator. She looked at me with an odd mix of horror, concern, and bemusement as I stood naked over a large vibrator sitting in the middle of a puddle on the floor and my once pink taco now covered in black soot. After muttering something about stopping by for lunch she slowly backed out and closed my door. I think it's time to take her key away, but first I need to ice my crotch.

**TL;DR** I burned my taco and tried to burn down the house with a vibrator. Pretty sure my mom thinks I have a strange fetish for pissing on sex toys now too.",TIFU by burning my taco with a vibrator (x-post r/offmychest),682
listen_louder,61,100,1kh72t,548,"Relevant info: I'm a senior in college whose hobby is online gaming. My *very* Christian extended family has a yearly Christmas get-together.

At one such get together my 5 year old cousin, who happens to be holding the holy grail of drunken college house parties: The Wii, comes over to say hi. His dad (my uncle) tells me that Isaac wants to play Wii Sports with Big Cousin ListenLouder, to which Big Cousin ListenLouder immediately gets up from the 25 piece Dora the Exploerer puzzle he'd been feverishly working on for the past hour with his 4 year old cousin and proceeds to set the Wii up. 

Now I'm smart enough to know that I'm supposed to lose. Nothing ruins a family gathering like a pissed of child and I'm going to do my job as the older cousin and be his bitch who constantly loses to his 5 year old cousin at Wii Basketball and takes the subsequent verbal abuse up the ass and says thank you can I have some more please.

Game 1 is me figuring out the game. Isaac 10, ListenLouder 8. 

Ok I got this next one. I'll get up and let him come back so that he can think he's reason the sun rises in the morning to reveal the shit on his ass so others can wipe it for him. Game 2. I score about 8 points in a row, thinking I'm doing well since it isn't even half time yet. Check to scoreboard to see that I'm down 12-8. *The fuck??* I step up my game to try and close the gap. Lo and behold Isaac holds on to win 15-13. 

&gt;Ok ListenLouder you got this. Just don't get too into it. You can still salvage some dignity from this.

Game 3 begins. Isaac calls upon the spirit of Magic Fucking Johnson and somehow jumps out to a quick 10-5 lead. I'm starting to get incredibly frustrated at this little shits ability to destroy me and laugh in my face about it. 

&gt;Supress the competitive urge ListenLouder. He's only 5.

By this time my cries of frustration and disbelief are drawing a crowd. By the end of Game 4, I've now got no fewer than 3 generations of family laughing at my misfortune. The gloves come off. It's personal now. There's no possibility of salvaging any dignity from this situation. There's only the sweet nectar of revenge to dull the pain.

Game 5 begins. Isaac jumps out to an early 4-0 lead, but by half I close it to 7-5. Second half begins. I hit a clutch 3 to take the lead (my first of the day) and Isaac complains. Uncle tells Isaac that he can't win everything and does the whole fatherly thing, but I'm in the zone now. There's no mercy for this little fucker. Over the next several minutes I discover that my 5 year old cousin is a future MLG pro, as he manages to hit *every. single. fucking. shot.* The kid is a god damn machine. I'm down 16-12, and getting desperate. I'm seriously beginning to reevaluate my life at this point. 

&gt;It's ok ListenLouder. You've played countless hours of CoD. Months worth of WoW. Spent days at a time gorging yourself on LoL. All that time. All the blood sweat and tears. That has all been training to prepare you for this moment. You can overcome. You will defeat the beast.

My ball. I hit a clutch mid-range jumper to pull within one. Isaac's ball. I pull off the defensive stand of the millennium and steal the ball away. I hit a layup to take the lead with just seconds left. Isaac has one final chance to redeem himself.

At this point I think I recall my dad giving me a not-so-subtle look to let him win, but it didn't even register at the time. Shit was on. The room was dead quiet. The tension had never been higher. Isaac has 4 seconds to get a shot off, and with less than one second left he throws up a hasty shot. I watch hopelessly as my entire life flashes before my eyes. The ball arcs slowly towards the rim, and bounces off the side. I'd done it. The raid boss known as Isaac the 5 year old MLG Wii Basketball Hacker has been slain. I jump up in pure ecstasy and with the fiery rage of the humiliated gamer scream out ""GET FUCKED!!!"" 

The room goes dead quiet and I realize that I just fucked up in the worst way possible. Everyone is staring at me in a mix of shock and horror. Not knowing what to do, I do the only logical thing one can do in a situation like this one, pull out my phone and pretend like I just got a call and excuse myself awkwardly.

Roll credits.",TIFU by beating a 5 year old at Wii Basketball,648
wooker,97,225,1abeo5,546,"My shift at work was coming to an end and I headed over to the work restroom to wash up and empty the ol' bladder before leaving. I proceed to wash my hands first(were sticky from eating an apple), but then I sniff something horrid. I loudly exclaim, ""What is that fucking smell!"" I then bent down to look under the stalls and notice at the end my boss's shiny black shoes. Needless to say I left quickly and drove home with a full bladder. I am not looking forward to tomorrow.",TIFU by opening my mouth in the restroom.,771
Myanex,233,264,1qk6fq,546,"School ends at 2:08; Bus leaves at 2:15
It is currently 2:13, my friend and I need to get home and his bus (at the front) was already leaving so we hopped on my bus. In my district you NEED a pass if you are not on that bus regularly, but of course we didnt have one so I told bus driver that my friend was my German exchange student. On the fucking spot my friend says in a heavy accent ""Gutentagen me Ovil *hesitates* Kook"" My bus driver believes him than further calls the bus company to question protocol, they have to ask the school of Ovil so they call the school and they have no idea who he is, so 10 minutes pass, me and my friend are to deep to go back so we play along. MY FUCKING PRINCIPLE comes out, sees us, than just shakes his head in disbilef, laughs a little bit and pulls us from the bus.
&gt; TL;DR: Lied to bus driver, banned from school bus, recently divorced Dad has to drive me to school and be late for work the rest of the trimester FML",TIFU and got banned from riding my bus.,810
Filthybiped,98,145,1hs6v4,543,"So I bought a new smartphone and had been enjoying it for a few weeks.  Doing the normal things like taking pictures of dumb shit, sharing inappropriate media and exchanges between the woman and I, watching porn, etc.  The normal stuff perverts like myself spend most their time doing on the phone/interwebs.

Anyway, I was visiting my sister and nieces and my mom even flew in from Colorado.  My family and I are spread across half the country so it's always a treat for us to get together.   

This afternoon, my mom and sister were sitting at the kitchen table next to each other and I pulled out my phone to check my messages.  My sister began asking about it and how I liked it.  I leaned between the two of them and began showing them some of the new motion features, some apps I thought they'd be interested in etc.  After that I opened up my browser to show them the speediness of surfing on 4g lte (relative to the 3G the sis was still on).  With the phone a mere 8 inches from their attentive and discerning gazes, it opens up to an order page...filled with big rubber pussies!  Doh!  I was looking at ordering a fleshlight a couple days ago and didn't end the browser session!  They got a face full of giant rubber fuck toys that I was obviously intent on purchasing!

After such a surprise, all my stunned brain spit out on the fly was that it must have been some kind of pop up ad or malware.  I highly doubt they bought that excuse though haha!",TIFU by showing my Mom and sister my new phone.,688
DrSillyBitchez,176,212,1lp1h3,538,"Some back story first, My girlfriend and I have been dating for 6 months and we met about a year ago through my room mate. She and my roommate went to high school together and she came over one day last year just to hang out. Half way through the evening he falls asleep leaving me to talk to her for a few hours alone. We said our good byes and i totally forgot i met her until she added me as a friend on facebook a few days later and messaged me. 

Today, however, i chose a bad choice of words. We were talking and she brought up how crazy she thought it was that we met and in her words ""it was meant to be"". I jokingly said ""yeah you had to stalk me to get my phone number."" to which she said ""yeah i just kept thinking 'i bet he was mad for not getting my number' so i fb you""....this is where i fucked myself. i said ""well, i dont think about getting girls phone numbers so"". To me that meant ""when im talking to a girl i forget or dont realize to ask them for their phone numbers because im lazy when it comes to girls and dating"" she took it as i didnt want her number and that she forced it on me. She then went into total rage mode and yelled at me for 30 minutes while i tried but failed to state my case. Looks like im cuddling up with the cat on the couch tonight boys!

Edit- Didn't have to sleep on the couch. The cat slept with us. She got over it rather quickly. ","TIFU by telling my girlfriend that, I originally didn't want her number when we first met.",750
[deleted],198,177,13qrob,540,"Alright, this is a EPIC update from [this] (http://www.reddit.com/r/tifu/comments/13p9op/tifu_by_sending_my_mom_a_sex_tape/) post. 

So, after the initial explosion from my mom, she refused to speak to me. After going through all the witty and funny comments and words of congratulations on my epic achievement though, i felt way better but still somewhat bad about the situation. Around 8 o'clock tonight, I hear a knock on my door. Lo and behold, it's my dad. He actually drove 2 1/2 hours to my dorm to come see me and put my mind at ease (and of course, visit me). 

Turns out my mom, is the totally opposite of mad. She is freaking thrilled. She apparently thought I was homosexual (due to lack of girlfriends and the like) and when she saw this she was actually **HAPPY**. I'll admit, my mom's a religious nut and I can see where the thought of me being homosexual is appalling to her. So when she see's her only son banging a more than attractive female on camera, oh yea, she was ecstatic. My dad quoted her on saying 'About damn time he got it in, i thought he was a fucking flamer.' 

She's still extremely mad at the fact I had sex outside of wedlock, but nonetheless her mind is at ease at the thought of having a gay son. My dad isn't upset at all. As many a redditors pointed out, he is proud of his son. The man even bought me some alcohol for my 'future drunken adventures'. The situation has taken almost a complete 180 degree spin and I'm so relieved. Thanks to everyone and their encouraging advice/witty comments/ and the like!

EDIT: For future references, i'm not posting the video. Or pictures. Or anything for that matter. I hate to feed the skeptics but I don't care. I just thought my story was meant for reddit and I'd get a good laugh out of it all. But all this 'need confirmation' is really annoying. Not happening. Deal with it. I didn't come to reddit to post those kinds of things. So I say to [you] (http://i.imgur.com/9WbAL.gif)",TIFUpdate: sending my mom a sex tape,717
Virginiamudbrick,146,472,1b6pnu,545,"So last night i stayed with my girlfriend, she lives with her mom. (Were both 25 but she commutes to school) She and her mom were preparing for a trip to new york to do some sight seeing so i helped her pack, around 1 am sexy times began to commence. Usually bumping uglies is careful and quiet so as not to wake her mom. Not last night... We had been up and down the stairs all evening and her mom sleeping like a log. We did it door open, lights on and i was beating that thing like it owed me money. Well at about 5 am her mom yells down the stairs at her to get her ass up and on the road. She yelled back ""give me a second i didn't get to sleep till 2!"" Her mom's exact response "" yeah i know, i was up at 1!"" 

So fucking embarrassed!  ",Tifu by making sexy times too loud,1017
Eliii5,115,103,1j8cmx,539,"Today I woke up and went to get the morning paper in my front yard. I live in a small house with just one roommate, and our door is set up so that the handle can lock on the outside. You can probably see where I'm going with this. Not thinking, I closed the door behind me.

I was home alone. It was early in the morning. My roommate had left the day before to visit her boyfriend and was nowhere near the area. My phone was inside. And I was in a nightgown.

It took me a while to think of what to do, but finally I spied the dog door that had been installed before we moved in. It was pretty small, but I'm a pretty slender girl and thought I might be able to squeeze through it. I called the one neighbor I'm friendly with (and who has the spare key for situations like this!) but she didnt answer.

So, I tried to crawl through the dog door. I got my shoulders and my boobs through pretty easily and thought it would be a breeze. Then, I got to my hips and butt, which I guess are bigger than I thought.

My hips just kinda pressed against the sides of the door and wouldn't squeeze through. I tried to back out but my boobs wouldn't fit through the other way. I started to freak out and tried to get back through, but my butt wouldn't let me in. 

I had no choice but to wait. Luckily, the neighbor that I called returned home and apparently saw my butt and legs sitting out there. She gave me a few shoves but it just wasn't happening. She finally managed to pull me out and got the key to let me in. All in all, I was probably stuck there for at least an hour. Seemed much longer though!",TIFU by getting my butt stuck in a dog door,642
turdphone,103,190,1gej1a,541,"Throw away due to odd hobby. So the only thing I use the recorder feature on my phones for is to catalouge my farts. Today while lying in bed, naked I could feel a big one coming. So to get maximum recording quality I hit record on the phone arched my back to lift cheeks off bed, slid phone under and then squeezed. It was a pretty decent fog horn... until the follow through came. In horror I slid the phone back out with a nugget gracefully resting on th screen and home button. Screen protector was a waste of money. Fuck. 



Edit: I can confirm I am of the female persuasion.   

Edit 2: I've showed my SO the library. It went ok.",TIFU. By crapping on my new Samsung Galaxy S4,731
Feeding_Squirrels,354,196,1aurj4,534,"First I would like to say that I live with my parents, I am 16 years old and spend most of my time on the internet.So I am on Pornhub, (don't judge me). I have Youtube in another tab, as I am scrolling down on the Pornhub main page. I have my pants around my knees, as I hear my door open. The lights are on in my room so I can't just turn off my monitor. I rush to pull up my pants half way around my ass and manage to cover my genitals with my shirt. I try to close out of the window as fast as possible, but due to the other tabs, It freezes for a second and the window pops up asking to accept. So basically my dad walks in, sees me struggling with my clothes half off, with the Pornhub main window frozen on my screen. A huge feeling of regret mixed with a little embarrassment overwhelms me as I simultaneously close the window and pull my pants all the way up. Not only am I up way past an acceptable time. (It's 4:30 AM) but I am also half naked in front of my monitor with a huge ass black dick plastered on the side. My dad attempts to say something about how I shouldn't be up this late, but stumbles with his words while attempting to take in the scene. He walks out seconds later. I am still sitting here, contemplating what my next move should be, I think I completely ruined my reputation with my dad, as he will never look at me the same way again. Tomorrow is going to be very awkward, I think I will stay in my room all day.


**TL;DR**: Dad caught me jerkin it at 4:30 in the morning, awkwardness and regret ensues. ",TIFU by deciding to watch porn at 4:30 in the morning.,730
ihasthegame,115,143,16fpa9,537,"So I'm at work. And I'm strolling through my department like I always am. Greeting customers, offering to help, showing them where that one thing they are looking for is. When I see her. Talking on the phone. Smiling that gorgeous smile. And I think to myself...""where have I seen her before? O.o"" I continue my rounds, when she walks up to me with her boyfriend and says ""Hi, we're looking for (thing). Can you show us where we can find it?"" ""Certainly,"" I say. ""Right this way."" After some small talk between the three of us, I hear the boyfriend say ""(Insert nickname here), let's just get this one."" When it clicks. It all comes flooding back. It's the girl I had a crush on in 6th grade, back when I was a 4 foot tall, 160 pound, bumbling...idiot. And, when it does click...I freeze. In my mind, that is. ""Keep it together, man. Just...be yourself. She's with her boyfriend, you'll be fine."" And I keep talking about the thing they're looking at. When, after about five minutes, I finally muster up the courage to say ""I know this is a complete one in a million shot here, but did you by any chance go to (insert school name here) during middle school?"" ""Yes I did,"" she quickly responds, ""why?"" ""Well, I believe we had a class together in 6th grade."" I'll spare you the rest of the details, because... well, it's a damn long conversation. Long story short, it's her, we laugh about how small a world it is, and I keep showing her and her boyfriend what they are looking for. After about five or ten minutes, I'm done. I've shown them everything they were looking for, made a few recommendations, and everyone is happy. But I couldn't leave well enough alone. Scumbag brain kicked in, and did something I have never, I repeat NEVER done before. I walk back up to them and say ""One last thing: do you by any chance have a facebook?"" ""Yes, but I'm never on it."" Still could have just walked away. But scumbag brain insisted. ""Well,"" my tongue continued, independently chattering away as my eyes, ears, and brain watched in terror, ""I'm a little hesitant about asking this since your boyfriend is right here, but can I have your number?"" Reddit, my brain reached for those words back. Boy, did he reach. But it was too late. I. Had. Fucked. Up. The look in her eyes was enough to kill. But that was nothing compared to the look in her boyfriend's eyes. I...I thought he was going to jump over the cart and tackle me. Hell, I wanted him to. But my brain, in a desperate bid to prevent him from doing so, directed me to look at him and say ""I'm not hitting on your girlfriend or anything, I just wanted to catch up and whatnot."" Good job, dude. All he heard was ""hit on your girlfriend"". I could feel my sphincter tighten from the awkwardness I was drowning in. I finally said, ""If you don't want to give it, that's cool. I totally understand."" She fumbled for an excuse, finally settling with ""yeah, I'm not big on giving out my number."" We quickly parted ways soon after. But the fuck up was there. The atrocious mark of my fuckup stained the floor, the aisle...Hell, the entire store. I rushed out of there, and didn't make my rounds for another 2 hours. Reddit...Kill me. Just kill me now.",TIFU after seeing my middle school crush for the first time in six years. (reposted due to incorrect title),680
[deleted],53,121,1gjq5y,537,"Today I wanted to avoid traffic and took the back roads home. Admiring this scenic route I rarely take, I catch glimpse of a lewd heifer, all peeing out in the open. Udderly shocked by it's lack of prudishness, and mesmerized by such a continuous stream...  I nose dived into a ditch. :`/  ",TIFU and wrecked my car because I watched a cow pee,658
yellowjelly,74,144,1a12zt,529,"I've recently been going to the gym at my university and lately I've started feeling more confident. Well today I wiped that confidence away. Seeing the rugby was being shown on a television, I decided to swap treadmills to get a better view. Without thinking, I stepped behind my friend to get to another machine, not realising he had started running. I hit the deck like a 70kg fish after flopping in the air, much to the amusement of the girls using the cross-trainers behind me. I've just hobbled back from the gym after nearly dying from embarrassment. I am proud however to say I finished my workout if a little distracted. TIFU.",TIFU at the gym,673
imablanket,129,100,17gfic,534,"(This actually happened yesterday.)

I've been dating this guy for about six months, and things are going great so he finally asks me to have dinner with his family.  I agree, and here I am at Sunday dinner with this guy and his entire family at his grandmothers house. 

Now before dinner begins, my boyfriend tells me that once dinner starts, there's no leaving the table until everyone is finished, just a rule of the household.  Kind of odd, but whatever I'm cool with that.  Now, I imagined their dinner was like my family's dinner, one course and in 20 minutes everyone is done.  Nope.  This family had a full on four-course dinner.  We started out with salads, moved on to soup, then the main course, then dessert.  Half way through soup I realize I have to take a piss.  But I can't excuse myself to the bathroom until everyone is done with *every course.*

By the time the main course got there, I was acting like a straight up 5 year old pulling the hand-in-crotch position to prevent from pissing myself.  I play it off saying my hands are cold.  Now, I mentioned earlier that his grandma and grandpa were there.  They are *the slowest eaters ever.*  I'm breaking out in a cold sweat, practically bouncing out of my chair trying to prevent the piss from coming out.  And they are just quietly enjoying their delicious dinner, asking me questions about my classes, what I'm studying, etc. But only thing I could focus on was my need to keep my pants dry.

FINALLY.  Dinner is over.  I quietly excuse myself, and as soon as I'm out of everyone's sight I start waddling like a penguin holding onto my crotch so I don't piss myself.  I reach the bathroom, I slam the door shut and stumble across the bathroom while simultaneously pulling down my pants.  I reach the toilet, turn around, and sit my ass down. Except something didn't feel right.  As I crossed the bathroom, I knocked down a bunch of shit. Well, the toilet lid was down and I accidentally knocked some hand towels on top of the toilet lid.  When I plopped my ass down on the toilet, I neglected to put the toilet lid up.  I was sitting on top of the toilet lid in a puddle of my piss, on top of hand towels drenched in my piss, and my piss is dripping down the sides of the toilet and pooling up at the base of the toilet.

I'm in full on panic mode, and I decide to just admit to my boyfriend what I did, so he could help me fix this fuck up.  I text him telling him I'm in a situation in the bathroom.  He comes in and I'm standing there with my pants around my ankles standing next to his grandma's toilet that's covered in my piss.  We both kind of laugh, but I do end up crying a little.  He helps me clean it up before anyone else see's what happened.  When he sees that I pissed all over the hand towels, he decides to make me feel even worse by telling me that those hand towels were hand stitched and embroidered by his grandma.  She had spent months on them apparently.  After he laughed at the situation a bit more, he slipped the hand towels into his grandma's hamper in her bedroom (I'm so sorry!) and then we went back downstairs and joined his family in a card game.  It's like it never happened.

I'm sure one day my boyfriend and I can look back on what happened in his grandma's bathroom and laugh about it, but we still haven't talked about it.  I'm still trying to find my dignity.

TL;DR:  I'm wearing an adult diaper the next time I eat Sunday dinner with my boyfriend's family.",TIFU by pissing all over my boyfriend's grandma's bathroom and on her hand-embroidered hand towels.,634
TheTerribleCat,180,120,1iygyb,532,"I had no idea that the asshole laying on his horn and screaming at me was a cop. I was on my bike and had signaled to take a left when this guy in a Mercedes roared up behind me. As I was turning he pulled right up next to me to continue yelling. I lost it a little bit, told him to get out of the car and bring it. Then I spit through his window. Then he jumped out of the car and ripped open his civilian shirt to reveal his police outfit. Yes, today I fucked up.",TIFU by spitting on a cop.,652
[deleted],175,145,1105va,534,I'm rolling my ass off and my pupils are enormous. I forgot I picked up a shift for a coworker and I'll be serving a party of 30 people in just a few hours.... Shit. Too bad I can't wear shades at work.,TIFU by taking a hefty dose of pure molly (MDMA) and I forgot I have to go to work in 2 hours... As a server.,679
anxietea,73,108,17cyc6,530,"At the end of one of my connecting flights, in a rush to make it to my next connection, I pulled my suitcase from the overhead bin without looking behind me. Not only did I underestimate the weight of my obnoxiously large carry-on, but I dropped that carry-on right onto a toddler's little head. I don't even remember how many apologies I stuttered to the family, but that mom was pissed. I mean, death glares galore. Poor baby didn't even cry, he was so startled. I bet there's a special place in hell for suitcase-swinging-toddler-hitters like me. Seriously, kid, I'm sorry.",TIFU by hitting a baby in the face with my suitcase.,638
[deleted],156,113,13p9op,529,"It was more like a few days ago but anyway! So, here about a week ago i went to my first college party. I don't know really anyone around here so I was really hoping to just meet people and get to know them. 

Turned out really well actually, wound up meeting some great people, got some numbers and overall had a blast. End of the night, i'm mildly buzzed and being paranoid about cops pulling me over, i asked some of my new-found friends for a lift back to my dorm. One of the girls i met offers, so i walk to her car, and after what seemed like forever we arrive back at my place. 

Anyway, we both ended up getting even more drunk in my dorm room. I mean like, 'drunker than a sailor' drunk. And she was just looking around my room and found my contour camcorder ( which i use it when i go rock climbing and airsofting) and turned it on and started drunkenly dancing in front of it. Well, one thing led to another and we ended up sleeping together. Woke up the next morning, talked to the her, and after some talking we agreed to have a sort of open-sexual friends with benefits thing between us. Not bad for my first college party, eh?

Well I finally remember the my camcorder had been left on all night. Got the whole thing on it before it died sometime later. I told her about it and she said it would be kind of kinky to burn it to a DVD and watch it together one night. So I did, put it into a un-marked case, and set it on top of my stereo for later the week when she was coming back. 

Coincidentally, I was planning on sending my mom a data disc with a bunch of my sisters wedding photos and videos i took. Did it the same day i burnt the sex video to the other disc. Anyway I had set her disc on the stereo as well, and totally forgot to send it to her. Sadly, I also left it un-marked too. She calls me up later the next day, badgers me for hours on end about it. Don't forget to send it! Do it now! Are you getting ready to send it? Blah blah blah BLAH! So I, in my irritated state, grab the wrong disc and rush to the post office and send it out promptly just so she will shut up about it. Two days later, she calls me and just loses it. I won't go into details, but my mom thinks i'm a sex-addicted college student now. It is going to be so awkward the next time i go home.

Yea, I done fucked up Reddit. 

TL;DR  -   Had sex with a girl, recorded the whole thing. burned it to a dvd and accidentally sent it to my mom 

[UPDATE!] (http://www.reddit.com/r/tifu/comments/13qrob/tifupdate_sending_my_mom_a_sex_tape/)",TIFU by sending my mom a sex tape,642
VeteranBore,26,166,1i2oj3,530,"Right off the bat, too. [I'll let the image speak for itself.](http://i.imgur.com/a6gpQ5H.png) ",TIFU by putting a very important item in the worst possible place.,696
raptorscallion,96,127,1c9p0c,529,"So there were two classes, both taught by the same prof. The exam was pretty big too, as it was worth 50% of the final grade. Anyway, the class codes were exactly the same, with the exception of one letter being switched with another. Me, being the dumbfuck that I am, went to the class that I wasn't in. I looked at the exam and realized I was in the wrong class. I asked the TA if I was indeed, in the wrong one. She said I was. My class exam was yesterday. Fuck. My. Life.

UPDATE: So my prof e'mailed me back and said I can still do the exam!",TIFU by missing my final exam,656
jdh423,56,75,178to2,534,"My 7 year old son and his older brother had been playing outside in the back yard sprinklers on and off all day, no harm in that right? so when they finally come back inside they are completely exhausted and my 7 year old brushes his teeth and goes straight to bed, It seemed perfectly OK to me.. until at about 1 am when he walks into my room trailing diarrhea behind him, turns out he had felt like he had to fart and let it out in bed, but it was a wet one. he got out of his bunk bed to walk to the bathroom but when he stepped down onto the lower bunk the flood gates broke, since the swimsuit had no liner, he crapped all over my older sons bed with him still fast asleep in it. He then decided the best course of action was to come wake me up to help clean it, which is good and bad because he trailed the diarrhea all the way across the house to my room. so i immediately picked him up and put him in the shower. what a mess it was. and clearly my eldest is a heavy sleeper.",TIFU by letting my son sleep in his swimsuit,609
Cheezit_fucker,68,104,14vvhp,531,"Normally, I pee on a pretty consistent basis: before I have to leave, when I know there is not going to be a bathroom, or if I just feel that my bladder is semi full. With finals this week, I have forgotten to eat, bathe and yes, even pee regularly. Today, during my final, I realized I had forgotten to pee beforehand. By the time I finished, I felt like I could replenish Niagara Falls if it were ever empty. 

I raced to the bathroom down the hall and, in addition to a crippling need to relieve myself I also had only got 3 hours of sleep, immediately sat down on the seat without looking. There was never a better feeling until I felt something tickle me down there. I figured it was strange and shrugged it off until I felt more tingly sensations. I immediately got up and saw hundreds and hundreds of ants climbing around,inside and on top of the toilet. Horrified, I quickly wiped my front making sure I got all the ants out, washed my hands and booked it out of there. 

I started walking home, absolutely grossed out that this happened when I felt more things crawling down there. I awkwardly waddled to a secluded alleyway and proceeded to repeatedly hit my genitals to kill the ants and after, scoop them out when they were killed. Unbeknownst to me, there was a hobo sifting through garbage witnessing the whole thing. Without saying a word, I left.

**TLDR: Literally had ants in my pants** ",TIFU by not looking when I sat down on a toilet,635
Anotherfuckwit,54,89,14ag17,532,"Wall of text: apologies but this story from last night goes back a long long way.

When I met my ex wife she was in a job she hated. She was envious of the fact that I worked with children and that I was, in her words, 'making a difference.'
Whilst she didn't have any particular academic qualifications she had the most amazing, calming voice and so, I suggested she look into joining the Samaritans in her spare time.

She was really good at it, she became a trainer, and loved it so much that she stuck with counselling jobs for the rest of her career to date. The most recent being a regional co-ordinator for victims of domestic violence.

That was/is great. The only slight discomfort arising when anyone asks, ""what does your ex wife do?"" ""She's a domestic violence counsellor... Erm... Let me explain...""

Skip forward to last night.

My current wife and I are in the mood for sexy times but our six month old baby is in the crib next to our bed and doesn't want to sleep. We rock him, we cuddle him, we sing to him and eventually he appears to be settle down.

""Shhh,"" whispers my wife. ""Don't make a sound.""

""Ok... Ouch!"" as she pinches my nipple.

""Shhh!"" She giggles

So I pinch her back.

""That didn't hurt"" she whispers and pinches my bum.

""That didn't hurt."" I reply through gritted teeth.

You can see where this is going... Before long we are pinching and biting and giggling then laughing all over the bed and a hot steamy session ensued.

Roll on this morning and my wife, who works in the same place as me is plodding along, doing her stuff when, in the staff room she takes off her cardigan to reveal an arm full of bruises.

A senior member of staff takes her to one side and asks if there is anything she wants to talk about. My wife laughs it off but her red faced embarrassment and reluctance to explain how she really got the bruises is mistaken for reticence to turn me in.

Cue a visit from the police to my office a few hours later. Someone had called them to report me and had even told them about how my ex wife is involved with the local domestic violence support scheme. 

After a long, embarrassing explanation, including the story of ex wife, I eventually pulled my pants down to show the officers my own bruises on my arse. They shared a look and stuttered their red faced way out of the building shortly afterwards.

My staff still think I'm a wife beater. My wife thinks its funny and will, no doubt, reveal all the next time she gets drunk on a staff night out.

TL;DR played ""that didn't hurt"" with my horny wife. Ended up being accused of domestic violence and shoved my bare arse in the face of a policeman to prove my innocence.","TIFU by playing ""That didn't hurt."" ",621
anounceofpervention,57,143,15j8se,528,"I'm at my sister's house for the holidays and have been pretty bored so I've been masturbating around the place. My sister's roommate and her three year old are out of town so of course I masturbated in the roommate's room. Then I masturbated in the kids room because why not? The baby monitor is why not. Fucking technology man, the thing even has video. Of course I only remembered immediately after finishing. I know there's a receiver in the roommate's room (empty) but there's probably one in my sister's room (occupied by her during the event) as well because her kid sleeps in there sometimes. I haven't confirmed but she probably thinks I'm a child predator now when in fact I'm just a perv who likes to masturbate in different places.

UPDATE: I think I'm good. (I mean I'm terrible but no one knows it for now.) My sister hasn't had me arrested and when she went to work I searched her room and no baby monitor was found. I got lucky this time and I've learned a valuable lesson about masturbating in a child's bedroom.

And I've since masturbated in the living room.",TIFU by masturbating in front of a baby monitor,671
RecursiveDelete,109,120,1m9afa,526,"I've been writing a PowerShell script to find and delete redundant $RECYCLE.BIN files in our thousands of user personal folders.  

The script is going well. It works perfectly fine. It takes a matter of minutes and gives beautiful log and error output info.  

Then I notice that I'm not using the same standardised variable name for the folder I'm trying to clear out, so I edit one of my functions to bring it into line. Great, now the function should use the right variable name.  

I run the script and check my error logs. Instead of the 78 KB file I'm expecting (from previous runs it was that size), I get a 4.9 MB file. Shit.  

I check the file and see that it's got errors like ""Unable to delete C:\WINDOWS. Folder not empty"". Fuck.  

I check other folders on the server and notice they're also empty. Hardly any files to be found. It's like a digital ghost town.
I check my code again and see that I forgot to change the variable on the line that does the actual deleting:  

    ...
    Remove-Item $Folder\* -Recurse -Force -ErrorAction SilentlyContinue
    ...

The function accepted param([string] $Path), not $Folder.
Instead of PowerShell going ""Hey, I see a bug here. Something's wrong, so I'll stop"", it goes straight ahead and does a recursive delete from the root of the C: drive. Anything my script was able to delete, it did.  

I immediately owned up to the problem and got our servers and storage manager to see what he could do.  

There was no server image to restore from. The backup software on the server wasn't working because.. I'd deleted it. He first had to install the backup software before attempting to do a restore. The restore is still running. The server will be rebooted tomorrow, and if it's fine it'll be left as-is. If not it'll need to be re-done from scratch.  

No biggie, the server wasn't doing much apart from being required for governmental security compliance..  

tl;dr All it took was a sphinctosecond to recursively delete everything I could on the C: drive of a local government security logging server.

**UPDATE: It's all fine.** The restore on C:\\* worked. The server's license had to be re-entered. I guess I removed *some* files that made it think it wasn't the genuine article. It's been rebooted and seems healthy again. I've read all and replied to some comments. Thankyou to those of you saying that you've fucked up on mega scales before. It makes mine seem like it's [just a flesh wound](http://i1.kym-cdn.com/entries/icons/original/000/012/877/3qafhk.jpg). :)",TIFU by doing a recursive delete,646
Supert0d,72,116,18n3wm,525,"Earlier today I went on a walk to make the most of a lovely day. I'm walking along, minding my own business, when I come across this colourful fluffy mass on the ground. I look a bit closer and I see the most adorable, yet tragic, thing I've ever seen. Two little blue tits are curled up together in the shape of a heart, and they appear to be dead. Here's a picture of those [cute little fuckers](http://i.imgur.com/3VKjipo.jpg).

My phone had no signal so trust old google couldn't help me here, I was on my own now. I picked them up, they were almost certainly dead. No movement or heartbeat what so ever. Still, I held them in my hands and warmed them up a bit.. A heart beat! I start walking back home and the heart beats get more and more noticeable. They even let out the occasional little tweet.

So I get them back home and put them in a bowl of cotton wool, still in heart formation. I leave them for 10 minutes or so then check on them. Now here's where the fuck-uppery begins. I get a bit curious and try to pry them apart, gently of course. I feel its foot move a little then suddenly it FLIPS ITS SHIT. Full flight mode activates and it starts ramming into the window. This wakes the other one up which also decides to bombard the window. So there's me just standing there in shock with two birds trying to kill them selves, and also shitting everywhere in the process, when all of a sudden a [MOTHERFUCKING PEREGRINE FALCON](http://www.bbc.co.uk/nature/life/Peregrine_Falcon) decides to join the party and smash its face off the other side of the window, trying to grab the poor little tits. I eventually manage to grab the bastards and set them free outside. 

This all happened to occur days after I watched the film 'The birds'. 

Fuck birds, man.

EDIT: Now with added [voice narration](https://soundcloud.com/rac91790/fuck-birds) thanks to /u/Shadekitty.",TIFU by trying to rescue some tits. [with pictures],641
ImurderREALITY,142,184,1koloi,528,"I know this sub has a lot of poop stories, but fuck it, here's one more. Also, fuck throwaways.

So I haven't been eating properly for the past few days. You know, lots of fast food, lots of meat and potatoes, not much green vegetables. I usually poop very day, and recently, it's been getting increasingly difficult to get it out. I knew it was because of my eating habits, but for some reason, I didn't change them. I just kept saying ""At least I'm not constipated,"" and continuing on eating junk.

Then yesterday happened. I felt the familiar lump in my nethers that means it's time to drop one. I drop trow and get on the turlet. From there, it went something like this:

Ok. Here it comes... Oh, you're a big one, aren't you? That's okay, I'll just give it a little push. Hnngg.... Hmm. HNNGGG! ***HHNNNNGGG***
Shit.

That's when I realized the folly of my ways. Why, oh why didn't I prevent this extreme discomfort? I could have! Okay, okay... no use dwelling on it. I need to get through this. I pushed more and harder. There were times when I swear it was moving, but as soon as I would let up on the pressure, this giant basturd would nestle right back in my colon! It was way too late to change my mind about going; the brick was not going back up AT ALL. It was now or never. So I did something I have never done before and will never do again.

I looked around my bathroom. I was in my less used second bathroom, so all that was in there was turlet paper, a hand towel, and a bottle of antibacterial soap. I looked at the soap. Desperate times call for desperate measures.

I pumped a bit of soap on my fingers. I worked it around between my fingers and thumb just a little. I reached behind me and felt around a little. I touched my butthole, but I didn't feel any poop. That was weird, because it felt like I had a giant rock hard turd hanging out. So I took a deep breath... and stuck a finger in. My butt was tight, but the soap helped lube it up so I could get in there. Almost instantly, I felt the basturd. It felt like a die from a board game, except twice as big. I couldn't believe I was doing this. I was feeling around inside my own butthole for shit.

I tried to wiggle the basturd loose, but it was stuck. So I went a little deeper, past the basturd, and felt even more shit! This shit was more than ready to come out, but the basturd was blocking the way! I had to get it out, but it still wasn't moving, so I stuck my thumb in there too. As of now, I had my index finger and my thumb inside my butt. It was terrible. I worked my thumb around one side of the basturd, and my finger around the other, and tried to wiggle it. It still refused to budge! So I braced myself and pulled. Remember how I said it felt like a die? Well, as it finally came out, I felt the corners of it popping past my circular rectum, and it dropped into the turlet. It was out! Hallelujah! 

As soon as it came out, the rest of the shit train came barreling out behind it. I have never felt so good in my entire life. After I wiped, I tried to look for the basturd to see exactly what it looked like, and maybe take a picture, but it was gone. From that day forth, I have swore to never allow that to happen to me ever again! I will eat green vegetables every day, and even take colace capsules! My fingers still smell like poop, no matter how much I wash them.

**TL;DR** Allowed myself to become terribly constipated. Ended up lubing my fingers up with soap, sticking them up my butt, and pulling the shit out. Never again.",TIFU by letting myself get constipated,712
brbdead,191,106,1cyq7l,520,"For the past six months I've been plagued by a terrible case of Scabies. I have tried EVERYTHING to get rid of them.. Washing everything I own multiple times, the medicine the doctors give you, tea tree oil, neem oil, borax powder on my clothes.. etc, etc. You get it.

SO TODAY. THe next magic trick to get rid of the little buggers was to very carefully, and very stupidly, pour half a bottle of Cayenne Pepper into a hot bath. No big deal, right? WRONG.

Within 45 seconds of lowering my itching body into the red vat of pepperous lava that awaited my delicate skin, my body EXPLODED into the hottest and most painful thing I have ever experienced. Not to mention the fact that my vagina just turned into a Ghost pepper's worst nightmare.

I don't know what I was expecting.. but the words ""most people who use it place large amounts of cayenne into a hot bath, remaining there until the water is cold."" WERE A LITTLE MISLEADING.

I need to go pour 5 gallons of milk into my bath tub and hope that it can stop the burning before I eat some ghost peppers to cool down.

TL;DR: Tried every remedy for Scabies, Thought a Cayenne Pepper bath would kill them off, basically lit my entire body on fire trying to ""soak"" in the bath. ",TIFU by taking a bath,626
[deleted],105,228,1890h1,517,"This was actually a few years ago, but I didn't know reddit back then. I was just thinking about this and I'm still embarrassed.

So I was 14, with my first boyfriend, and we'd been fooling around a lot by then. I wanted to know about what your first time having sex is like, so I posted a question on a forum. It went something like, ""I'm thinking about having sex with my boyfriend for the first time. Need some advice.""

I'd forgotten that that site is connected to my Facebook. Every time I would post on that forum, it would announce it on my wall.

I went to bed, and I didn't wake up until noon the next day. I looked at a text from my girl friend that was asking me if ""I needed to tell her anything"" and she explained what was on my Facebook wall. I flipped out and went to the living room to get on the computer and delete the post. My mom cornered me and demanded to know what it was about.

I lied and said that I didn't know anything. I played it off like, ""I don't use the account anymore. It has a whole lot of cool stuff on it so I gave the account away. Somebody else must have posted it and I forgot it was connected to Facebook updates.""

I deleted the post and made a status that ""explained"" what happened. I don't know how many people saw it, but I know that my friend believed me. I'm not sure if my mom did.

**TL;DR** -- Facebook posted my sex plans without my knowledge. Lied to whoever saw it and said it was somebody else who had my old account.

Edit: I did, in fact, have sex. The act itself wasn't worth it, but the lesson that came from it was.",TIFU by announcing on Facebook my plans to have sex with my boyfriend.,745
savrow,104,146,1759zv,521,"This actually happened a few years ago, but I still feel bad.
I got locked out of my house and had to shit extremely bad, so I climbed over the fence and dropped a huge log right on my backyard with my dog staring at me the whole time. Then I carefully pulled my pants up and calmly waited-  hips thrusted forward so the back of my pants hung as far from my anus as possible - at the backdoor for about forty-five minutes until my parents got home. I was in a guilty frame of mind so I figured it would look pretty suspicious if I instantly volunteered for shit patrol the second I got inside. So I left it there. Just fucking left that solitary log to fester in my own backyard. Where my little sisters play. 
I ended up forgetting about it until I came home and my 8 year old sister was throwing bags of 'dog' poop in the garbage. It could have been her or my 6 year old sister that picked it up. 
All I know is I put my 100 pound German shepherd to shame.
",Tifu by making my little sister clean up my giant turd  ,667
Mandyque,74,124,1ahn0m,511,"I've been single a long time now, and we all have needs, right?  So, during a quiet moment, I decide to have a bit of 'me time' with the computer.  I go to my favourite porn site, and, as I enjoy watching some gay porn (being a woman, there's more good looking men y'see), I found a nice link of some young men performing what is known as a 'circle jerk'.  I settle back to see what these young men do, obviously involving, well, jerking in a circle over another young man.  I was just getting really *ahem* interested, when my son, who was about 14 at time time, and not to be fooled, wandered in to my room to chat to me about something.  

Oh joy of joys, the computer decides to choose that particular moment to refuse to close the window down, and my frantic clicking would not stop the excited grunting emanating from the speakers...  

He didn't believe me when I said that someone had mentioned circle jerks and I was just seeing what it meant...

","TIFU (well, a few years ago) by getting caught watching porn by my son",635
LadyofDecay,319,173,19p31x,511,"[I was wrong.](http://i.imgur.com/Gz8AuW7.jpg)

I look like Lion-o and I have to rock this color for 3 weeks until I can correct it.

A small fuck up, but I can't look into a mirror without laughing and then crying.",Today I bleached my black hair thinking it would turn blonde..,684
snicklefritz81,161,307,1ggnhs,514,"Technically not me but seeing as my mom does not reddit I decided I'd share one of my favorite stories that I've heard from her.

Back when she was still in school to become a nurse practitioner she was seeing a patient; however, this man was special because he claimed to have had sex with over thousands of women. Obviously my mom did not believe this until she saw what he considered to be his dick. It was described as a disease-ridden crispy piece of skin that slightly resembled what should have been a penis. 

At this point, she was inclined to believe that he was actually telling the truth. It was now time for her to insert his catheter. Unfortunately, this act failed because before she could react three inches of this man's junk fell off into her hand. Obviously shocked, she put it on a paper towel and took it to the doctor who had never seen a manless penis on a paper towel and was shocked to say the least. The doctor then went in to talk to the man whose cock just fell off and all the guy could say was ""oh well okay then."" He seemed quite unphased for what just happened. That's how my mom broke off some dude's dong. ",TIFU by breaking off 3/4 of a someone's manhood.,821
ThePotatoGods12,114,209,1jo269,515,"Ladies and gentlemen, we have a bundle of fuck-ups for your viewing pleasure tonight!

Today was my sisters birthday. For weeks could not, for the life of her, figure out what she wanted for her birthday and finally, she decided to head up to Ruidoso for the day. The drive is about 2 hours, and on the way we stopped at a Wendy's. Lets cut this short and say I should not have had a soda. For whatever reason, sodas make me have liquid shits. So we are still on the road and everything is fine but as soon as we get out in the middle of the mountains, I have to shit, bad. As per usual, I can hold it like an adult.

However, time passes and I decide to climb a hill with my little brother. I get to the top and my stomache isgiving off the pre-shit rumblies.I scramble down the hill and find my mom and tell her I gotta go! However, they are having a good time and she says to go down to the ranger station and see if they have any restrooms. So, I make it there, however, my rectum gives and I yank down my pants and shit. Right in plain sight of the station AND the street! With no other option available, I gather clumps of grass and wipe...as best as I can, hike up my shorts and hightail it outta there hoping to high hell no one saw me.

I return and tell my mom I hadnt found  one so she hands me the keys, and I take off in search of a toilet in order to wipe my ass properly and clean my hands. I arrive and having already shit, shit again and find my undies soiled, so I toss them out. This is when I realize my shorts have a rip from balls to butt. FUCK, gotta free ball it, whatevs. 

So, for dinner my sister selected IHOP and no problem or rumbles. We start passing through a military reservation aaaaaand the pangs hit, hard. Im trying to hold it and obviously, we can not stop and I get mouthy with my dad (you are not you when you have to shit). As we pull up to the only portapotty in miles, my rectum gives out once more and I barely make it to the toilet. 

I am sure I would have had a better time if I did not have to shit the whole time.

Afterthought?: WOW! classic reddit upvoting my poop story, this is awesome. Have a nice day, morning, night, afternoon!",TIFU by going to the shittiest birthday party ever.,724
doodie_in_shower,174,214,1fimkf,513,"This is a timeline of what happened to me today..  
  
1 AM: Decide to go to bed, say everyone good night and try to sleep.  
2 AM: Finally fall asleep.  
7 AM: Mobile Phone begins to go crazy, alarm is ringing at full volume, I am pissed off but I have to be at work at 8  
7:50 AM: Mom comes into room, ""DOODIE_IN_SHOWER WHY ARE YOU NOT AT WORK YET?"" I have to hurry but poop badly. Fuck.  
8 AM: Arrive at work  
10:30 AM: Hunger is killing me, still need to poop, get to pee really fast but have to hurry since I work at a gas station.  
10:40 AM: A schnitzel-sandwich is bought and devoured in less than a minute.  
1 PM: Can finally go home, fortunately I have a car, else I'd be walking for 20 minutes.  
1:17 PM: Run to toilet, have small but astonishingly smelly poop. Body decides to fail on me and passes out.  
2 PM: Shower and decide to shave bullocks with my DE as usual. Mid shave I have to poop again so I decide to wafflestomp. Bad idea. Now comes the biggest fuck up of them all: The poop doesn't go down the drain since my gf's hair blocked it. Poopy water is standing up to my ankles, stomp like crazy. Nothing happens. As I decide to unclog the drain I begin to gag and eventually puke and since the DE is still in my hand I slit up my leg as I throw up. Blood, poop and puke is everywhere.  
2:20 PM: Drain is finally unclogged, I nearly start crying thinking about this bad, bad decision. I reek of poop and gag like crazy.  
2:30 PM: Finally shower again, properly for a long, long time. Decide to continue shaving bullocks since it was only half done. Nether region decides to bleed. A lot.  
3 PM: Poop is gone, I smell like flowers again, my junk is smooth as fuck. Decide to sit in front of computer and tell reddit how bad I felt as I continuosly fucked up. Damnit.  
  
This wall of text (sorry) was not only an actual and really sad fuck up, but also an exercise for writing short stories because I just realized I have an english exam tomorrow. FUCK.  
  
TL;DR: (lack of sleep + work + hunger + urge to shit) + all in one shower = not good",TIFU by not sleeping enough,727
MisterOdi,117,94,w9vwg,512,"We had just come back from a late dinner. I had been slightly gassy all day, and the food wasn't sitting well. I told my gf that I needed to make poo, but she argued that she needed a quick shower. I didn't mind cause she doesn't ever take too long anyway.

As soon as I heard the water run, I felt my stomach rumble. I knocked, let her know that she should hurry, and started doing the classic ""clench your asshole and walk/squirm around the room"" thing .. anything to help me hold on. 

Couldn't hold it. Ended up barging into the bathroom. I mumbled an apology, slammed the door behind me and went for it.

It was all one motion. As I bent down to throw my shorts off, my asshole literally threw up into my boxers. I had half a second to aim my butt towards the toilet and missed terribly. There was runny poop everywhere, a small mound on the ground, a huge pile on the toilet seat cover. 

It was all out within 10 seconds. Immediately started damage control. It was one of the most disgusting things I'd seen in my life. As I was mopping up, I heard my girlfriend gag, then cough, then ask for a courtesy spray (we have a bottle of febreeze to mask poo-poo smells). 

When it was all over, I had wiped and bleached the entire area. Took a really hot shower, drank some water, and finally saw my girlfriend.

She told me she had thrown up five times from the smell of shit.

TIFU","TIFU by shitting all over my legs, the toilet seat, and floor while my girlfriend was showering and puking from the smell",606
D0M1NATE,74,183,1lhntt,514,"   So a few months ago, went on a trip to vegas I kept secret from my parents, had an incredible time, but was also bombarded by the corner guys shoving cards with nude photos of girls in your hands. No big deal put them in my dress pants. 

  Fast forward, my great grandmother past away after 93 years this week and I flew out to attend her funeral and took my dress pants.  Just to make matters worse my extended family is super conservative. Long story short, pants were being ironed and my whole family got so see some porn pictures fall out of my pants. -___- And vegas is no longer a secret. I'm destined to be an outcast. 

tl;dr went to vegas. porn cards accepted. conservative family saw them right before great grandmas funeral 
",TIFU by wearing dress pants to my great grandma's funeral,697
brownmike3,136,193,14u45p,513,"Welp...  So today I went over to the ex's house.  She and I are more like siblings more than anything, It's been 5 years since we dated but her family and I are extremely close.  Every Thursday is ""bar day"" and we go out and get shitfaced,  go home, order food and argue about mundane shit. tonight, we were low on ice, so I drove the full two blocks to the nearest 7-11 to snag some for our whiskey 7's.  I just bought a new car 3 days ago, and was more than willing to volunteer to go to the store.  As I am exiting her house, I notice that the neighbor's smoking hot daughter is in town.  Probably just visiting from college for Christmas Break.  As I am walking out and approaching my car I notice she is wearing some tight yoga pants and bending over into her trunk, retrieving her luggage or some shit.  I am 100 percent an ass guy and this girl has a phenomenal dumper on her.  She turns for a second and must have recognized me from previous visits and gives the cutest little smile and waves.  I am filled with all sorts of giddiness and excitement and wave back, responding with the least masculine, pitiful fairy wave and high pitched ""hello there"" humanly possible..  I'm kicking myself for being such a bitch but she just keeps smiling and goes about her business as I enter my car.  I can't keep my eyes off her ass and she turns again as I get in my car and gives me another cute smile.  At this point I'm thinking that she wants to say something or ask a question.  I fumble with my keys, sitting in my car, heart pounding as I prepare to roll the window down and engage with Hot Dumper Neighbor Girl.. She is now covering her beautiful mouth and laughing pretty hard.  How hard you ask, so hard that she is on one knee and I'm pretty sure she had tears rolling down her cheek.  I finally grab a hold of my stupid fucking key and attempt to stick it in the ignition.  It is just now that I realize, that in my stupid fucking ass-struck stupor, I've climbed into the backseat of my car, and Hot Dumper Neighbor Girl is laughing her ass off, at me..  I rested my head on the back of the desired seat, eventually sulked out and drove off..  I said fuck the ice and went straight home.  Yeah, I guess you can say I kinda fucked up.

",TIFU and well... Hot Dumper Neighbor Girl made me fuck up..   ,706
[deleted],110,147,1mqfmr,509,"I was a good distance from any other bathroom so I decided to walk into this office building and find one. 

This was an extrteme bowel emergency so I entered the first one I located, which was the handicapped accessible bathroom. 

So, Im in there doing my business and I hear two women talking outside the door. One of the women is clearly upset stating, ""I just saw some young able bodied guy walk into the bathroom. THIS BATHROOM IS FOR THE ELDERLY OR DISABLED! Im waiting out here and he is in there when he could have walked up one flight of steps. I DEMAND he be held accountable"" Another woman replies, ""I apologize about that ma'am. I'll speak to him when he leaves."" 

At this point I get a bit nervous. What do I do? So, in all my infinite wisdom, I decide to pretend to be handicapped. I open the door with my left hand, while walking out of the bathroom with my right hand held up to my chest like [this](http://imgur.com/clfp14S). The first woman I see is an overwight woman with a walker. She looks at me and says, ""Oh, sorry hun. I was mistaken."" I turn to look at the other woman who is a security guard and immediately recognize the face. Its my next door neighbor who I have been flirting with for a few weeks. She knows I am not handicapped. She gives me the most dissappointed, judmental, look of disgust I have ever seen. I stay in character and continue the ruse while I walk out.

About an hour later I receive this text: ""You are a manipulative and inconsiderate JERK. Lose my number.""",TIFU by pretending to be mentally retarded to use the handicapped bathroom in an office building.,656
bunnyUFO,129,158,y9xyu,509,"I was at Fred Meyers and I needed to take a crap, so I went to the bathroom and took the bigger stall because ""why not?"" So I take the bigger stall and a dude in  wheelchair comes in shortly after... Apparently he cant take crap unless he uses the bigger stall because he can't manage to fit and sit on the toilet in the smaller stall, and for no fucking reason I had a bad case of diarrhea. So yeah, the poor man was telling me to hurry up for over thirty minutes (probably less), but i couldn't stop shitting. So the poor handicapped handicapped man craps his pants, and I felt really bad. To make this even worse i find this to be funny, but it makes me feel worse about it.

lesson to you all, don't take the bigger stall if you don't need it.",TIFU by taking the bigger stall at a public bathroom,667
what_a_cat_astrophe,84,104,185xo7,510,"I'm a photographer, recent college graduate, and still living with my mother and father as my new full-time job settles in.

I photographed a wedding recently, and I am finally loading the pictures into my Lightroom library.  They are beautiful.  I am so proud of myself, and cannot wait to show my mama that all those college funds actually went somewhere.

Well, **side story**.  My boyfriend is a photographer as well.  We were playing with lighting in his home studio and I was his stand in.  Then clothes started coming off, and our experiment became a full-blown artistic nude shoot.  However, his computer had broken so I had loaded his images into my computer for storage one week prior.

So my mother peers over my shoulder as I go to click the ""library"" tab and select to import the wedding pictures.  Only there are no brides, no churches, and no flowers..

Just 25 thumbnails of her only daughter, boobs out, and smoking *cigarettes* in a photo studio.

This is worse than the time I forgot I left my dildo on the bathroom sink and only noticed a hour later when I went to use the restroom.

**TL;DR**: Wanted to show my mother wedding photos.  Showed her my tits instead.",TIFU by accidentally exposing roughly 25 nude thumbnails of myself to my mother,614
angstamongthepigeons,103,159,1o7m76,503,"  So, my wife came home from work before. It's night time here and she got home around 9pm. Same as every other night, how was your day? what did the kids have for dinner? just like any other day. 

  Anyhow she's getting ready to take a shower and she asks if I can wash her hair for her, saying that her arms are tired on account of her going to the gym today. Now grooming requests aren't uncommon in our relationship, she'll get me to come into the bathroom to scrub her back sometimes and I shave her legs with a straight razor every Monday before she plays basketball. So I took it as a serious question, and politely declined, saying that I'm not good with long hair, I can't do it properly and the last time I tried to wash her hair was when we were dating over a decade ago, and it wasn't a pleasant experience for either of us. 

  She persisted, and asked me again to wash her hair for her, but I said that another reason why I didn't want to wash her hair was cause I didn't want to get wet as I was already in my pyjamas. She then replied "" Take your clothes off then"", and all I could think about was that it was too cold to be standing there naked washing hair. 

  So yeah, took me a few minutes for the penny to drop, by which time she was just about done with her shower. 

TL;DR "" Can you wash my hair?"" means "" Let's fuck in the shower""",TIFU and missed out on shower sex...,662
carpet_dont_match,80,103,10ev9t,502,"Recently moved to Europe from the US. I hate shaving my downstairs as much as the next lady, so I went to the store to buy some hair removal cream. I was looking at all of the boxes and picked one with a brand name I recognized- Veet- but didn't really look at the packaging. I though, hey, Veet is the same everywhere, right? So I'm in the bathroom, a little confused as to why there are two things I have to mix together instead of just one tube, but I'm going with it. It's another country, why not? So I apply it to my business and set a timer. As I'm sitting there, I realize it smells sort of familiar, but not like any hair removal cream I've used. It smells like peroxide. So I look at the box again. It says ""Crème décolorante"" which, OF COURSE, means ""Cream decolorant."" Then I remember that it's like a european thing to bleach your body hair instead of shaving or waxing. So I wait it out, thinking it couldn't be too bad, until I rinsed it off- it didn't bleach them fully, it just turned them like a weird gingery color. 

TL;DR carpet don't match the drapes no more




EDIT: To all the people asking for pictures, no. Use your imaaaaaginations. To all the people complaining about the throwaway, OF COURSE I'M USING A THROWAWAY! I don't want this shit attached to my normal account! See: people asking for pictures of my pubez",TIFU by accidentally bleaching my pubes,605
Megan_Bee,186,63,t3ei9,507,"I was messing around with the webcam on my new laptop for the first time and I thought it would be cute/funny to take a picture of my boobs and send it to my boyfriend as a test picture. So I took the picture and sent him a facebook message with the caption ""bewbz lol"". Then I had a heart attack as I realized I sent the photo to a different guy who I hadn't spoken to in months. Awkwardness ensued.",TIFU- sent a picture of my boobs to the wrong person.,570
ecudorian,97,133,1jf6ty,502,"I just saw a post on the front page of funny about a nail being more aggressive on feet than legos, and it made me think of when I was young and possibly retarded.

So a friend and I are approximately age 12, walking through a construction site. I see a large Route 44 sonic cup (they are 44 ounces and made of styrafoam.) I'm thinking fuck this cup I'm gonna stomp this shit. But I some how miss, my inner angst wants to destroy this cup; so I must find something to keep it in place.... a board with a nail through it. I set this Route 44 kingdom atop the nail for placement purposes, and sure enough I stomp on it. Nail only went halfway into my foot. Didn't get a tetnis shot, just rubbing alcohol and kept it wrapped up. Every time I look back to that day, I think god damn I was fucking idiot. 

TLDR; put a cup on a nail and stomped.",Thought of a childhood TIFU,635
mugzy86,153,178,15hax5,498,"Last week, at my office Christmas party, I won a gift card to a local restaurant for $40.

Saturday night my girlfriend and I went and had dinner and drinks there and our bill came to $40.55.

I used the total amount on the gift card and having no cash, I decided to put the .55 plus her tip on my debit card.

When she brought the debit slip to sign, I wrote $50.55 on the line and signed it. We finished our drinks and left.

I noticed the error just now when I checked my account balance online.

I tipped my waitress $50. I hope she had a merry Christmas.
",TIFU by tipping my waitress $50.,676
opheliaq,78,111,1i9gpw,497,"Ok. So, I broke up with my ex boyfriend not too long ago and after a few dates with my friend from uni, I finally decided I wanted to sleep with him after our date tonight.

So I've been getting ready and groomed in anticipation for tonight, had a shower did my makeup but then it occurred to me that I haven't shaved down there! So I think about it for a second and decide that shaving gets too itchy and it's way to expensive to get a Brazilian and my gaze drifts over to my epilator (it's like a shaver but plucks hairs out instead of just cutting them). And for those of you who don't know how an epilator works, there's a metal cylinder with protruding metal and plastic 'tweezers' that rotates extremely fast so that the hairs get stuck in the gaps of the tweezers and are subsequently pulled out at the root.

Well all's going fairly well, I've pulled my lips to the side so that nothing gets caught and I'm almost hair free when I get a little too excited. 

I let go of my vulva (the lips of the vagina) and it gets caught in the metal fucking cylinder and I'm getting eaten out in the worst way possible as the little metal tweezers chip away at my flesh. I then attempted to painfully pry open my vulva to examine the damage and see if date night will go ahead but as soon as I felt the sticky red liquid ooze onto my fingers and a flap of skin hanging from where I should've been, I knew I was a goner.

So right now, I'm sitting on my couch naked after canceling my date, with my makeup done and hair curled, nursing a bleeding vagina, hoping, pretending and trying to convince myself 'it's only your period.'",TIFU by getting ready for a date,608
throwaway_p0rn,188,168,13wj2b,498,"**As a disclaimer, I am a 5'1'' innocent looking female who attends a prestigious Midwestern University**

Last night, I couldn't fall asleep so I smoked a bowl to myself to try to fall asleep. Instead of growing tired, I become insatiably horny and watched porn (Daredorm anyone?) until I passed out at around 4 am. When my alarm went off at 9 am, I turned off the alarm in my exhausted state. I woke up 10 minutes before class started, threw on some clothes, and ran to my class. This class happened to be a discussion (interactive class of about 20 students with a graduate student instructor). I got to class a few minutes late and the instructor placed me in a small group (5 students) and told me to take out my reading assignment for the day. I take out my laptop to pull up the .pdf, and open my computer to see dare dorm still open! I quickly click out of the website but there were at least 5 porn popups open behind it. I look around and see three of the girls in my group staring, jaws dropped, at my computer screen. I hurriedly attempt to click out of the popups but suddenly, my computer freezes! Here I am, with my porn on display in front of 4 other students that I have to work with for the entirety of the class period. I turn off my computer immediately with my cheeks burning in embarrassment. While the girls in my group clearly were disgusted by the incident, I couldn't help but notice that the boy in my group smiled at me whenever I caught his glance.",TIFU by leaving porn open on my laptop and opening my computer in class for all my peers to see,666
smirtch,95,118,1aco66,495,"Today, I had two exams. One midterm exam at 8am. And a chemistry O-Chem exam at 9:30. This wouldn't be so bad normally but both classes are terribly difficult. (My common-curriculum theology class is at 8am)

Last night I stayed up until 3am trying to cram for both tests. I set my alarm for 6am so I can get up early and review one last time. I got up and went straight to my desk, opened up my laptop, and started studying. Then I woke up a second time. This time at 8:45am with my head on my laptop keyboard. I feel like the biggest idiot I've ever met and I don't know what to say to my Prof. I don't want to make up any BS excuse but I don't want to fail the class because I fucked up one time. Help?

Edit: I know cramming and pulling all-nighters is bad for my exam scores. I don't need a lesson in that. But, I e-mailed her immediately when I woke up. I went to her office after the next class time as she has a class immediately after mine and I had to take my chemistry test. She allowed me to take the test but hasn't told me if she would take any points off of it yet. She said she would decide after she graded mine and everyone else's.

Edit#2/UPDATE: My prof just e-mailed me my grade and I would have set the curve in the class. She said she was extremely impressed with my test score given the situation I put myself in. She said, ""I was impressed with your test. It is the highest score I've ever seen on this mid-term in 8 semesters of teaching this class. Even though you recieved incredible marks on exam, I cannot accept it for full credit. I have turned students away before in situations like this one. You were allowed to take the test because of your consistent attendance at my lectures and the leadership you have taken in the discussions. I would like for these patterns to continue as you are an asset to this class whether your peers recognize that or not. Now, to the business part of this e-mail. I have decided to accept your test for 75% credit. As an FYI, every semester I allow students to ""make-up"" points they miss on exams by writing a 5 page research paper on the essay question of the test. I normally allow students to recieve back half of the points they lost on the exam. I will make a special provision for you, provided your paper is of high quality, that allows you to recieve full credit for the exam you took. You originally earned a 97/100 on this exam. Your current score is a 72.75/100. I ask of you, because this is such a big point jump, to complete a ten page paper instead of five. I will give you an extra weekend to complete this assignment. It will be due on Moday the 25th.  I feel this is fair. If you wish to only complete a five page paper you will recieve half credit back like everyone else and the due date will be this Friday. I hope you have a wonderful weekend. Good luck in your rugby matches and I'll see you in class on Monday.""

I plan on having the paper to her by Friday (the due date for everyone else). I can't believe this e-mail and I am completely shocked. I'm 3 pages into this paper already. Fucking awesome.",TIFU and slept through my midterm,613
RancidPonyMilk,122,161,u68q8,495,"It had been at least 30-40 minutes after and i had washed my hands but apparently that naga jolokia oil stays with you for hours. Things got a little ""hot"" later on and started fingering her and she started screaming and unzipped my pants and told me to fuck her. She didn't tell me she was in pain at first. Started burning like hell but I still had to come and led to a pretty intense orgasm. However I'm sure some of the oil got into my pee hole and we've both been contemplating suicide as we're all out of percocet.

tl;dr: fingered gf with hot pepper oil on fingers, she returned the favor by getting it on my dick by making me fuck her. super fucking painful. my neighbors probably think we're filming a porno with all the screaming and moaning","TIFU: fingered girlfriend after eating ghost-pepper infused hot wings, then she made me fuck her, god the pain",656
graziano8852,211,102,t72hg,498,"I was at the local fair by my house when my friend introduced me to some chick will just call her Amy. We really hit it off and hung out everyday for a week straight. We had a ton of the same interest and our senses of humor were very similar. One night after the movies we went back to her place and we just started going at it like animals. She was afraid to do anything vaginally because she was still a virgin so she told me to put it in her ass and i am not going to lie i tore that ass up for over an hour. We ended up passing out after that and when i was leaving the house I noticed a picture of one of my great uncles on the nightstand. Confused i asked why she had a picture of my uncle and she responded with saying that was her uncle. It then hit us both that our families had split up a generation back and she was my cousin... what turned out to be a great night ended in a horrible realization. We both were speechless at this discovery, she just looked at me with a horrified expression and darted back into her room. I quickly headed out the front door and dashed for my car. Its been two days and i still do not know what to say to her.
TL;DR Ended up having anal sex with my cousin due to our families splitting up a generation ago and both of us not knowing we were related. ",TIFU: I  had anal sex with a girl who turned out to be my cousin NSFW,600
shmeedledee,142,112,1bs3m5,496,"Well, we were in a cramped car doing the deed, 69ing very uncomfortably...I guess I had drank too much Cheerwine, because I had the impending need to burp.  It didn't help that this gentleman is particularly well endowed, and so as the act proceeded, I gagged.  Usually in this scenario, I just power through and try to relax.  Apparently this time, however, my gag reflex wasn't having it.  Needless to say, I saw my Cheerwine and dinner for a second time that night.  Not the most excellent way to end a Friday.",TIFU by throwing up while giving head.,608
FUS_RO_yay,98,122,w610d,501,"Earlier today I was hanging out at my boyfriend's house. We were there alone, everyone had gone to movie. My boyfriend had told me he was going to take a leak about an hour earlier, so I'd gotten out his laptop to lurk on Reddit. I started to get a bit concerned and wondering what was taking so long. So, I walked into the bathroom to find him furiously fapping on the toilet seat. When he saw me, he looked a bit embarrassed. (Even though we've shared sexytimes before.) I smiled at him and asked if I could join in on the fun to which he replied yes. I got on my knees and lowered my head, ready to help, but I guess he was already at the point of no return. A huge glob of cum sprayed out of his penis and shot up my nose, much to his amusement. I spent two hours getting that shit out of my nostrils while he just kept laughing.

TL;DR Caught boyfriend fapping, tried to help, got a nose full of erection juice.

(Btw, this was my first post on Reddit, so.) :D

EDIT: Fixed it to make everything a bit more detailed.",TIFU: Got jizz in my nose,623
runrabbitrun6,85,102,1518wa,491,"I am a Certified Nurse's Assistant at a hospital.  It was the end of my 12 hour shift I was done and ready to go home. My coworker still had to give report to her replacement.  One of her call lights goes off, I answered it so she could finish up and leave, she had a hectic day. I gown up and put on gloves, the patient is infected with Clostridium difficile (google is your friend). Apparently my coworker left the patient sitting in a chair for 9.75 hours and didn't check her pad to see if she had gone potty! The patient had stiffened up from sitting in a chair for a long time, and couldn't support her weight (250+ lbs.) to get back into bed so I look out the door and ask the nearest CNA for assistance. We get her up, and to our surprise there is a turd stuck to her pad when she gets up. I'm holding her up while the CNA helping me is about to start wiping her.  When it happens.  Her C. diff infested shit begins spraying all over the floor and down her legs.  At the same time, her legs start giving out and she starts going for the floor.  At this point in what seemed to have been a lifetime I realized I had two choices: 1. Let her go and cause whatever injury 250+ pounds will do to a 70 something year old woman hitting the floor or 2. Reach in from behind, support her weight, risk getting shit all over me and pivot her into bed. I chose the latter, as we have had a string of patient falls on my unit and did not want to feel the wrath of my boss over another patient fall on our unit. Let me say something, the gown did nothing. It offered me no protection as her gargantuan ass brushed it aside and continued to spew the contents of her bowels all over my leg. Microseconds became a lifetime, but I got her in bed. The other CNA suffered no tragedy, but I was left a broken man. I couldn't even get mad, because it wasn't the patient's fault and I didn't want to make her feel worse than she all ready did.  I ended up staying 30 minutes overtime when I could've just walked out without a care in the world.  I didn't even tell the CNA whose patient it was how she fucked up with her lack of patient care and human decency because I knew I would blow up on her and probably get fired. I had to explain to my father why I was standing in my boxers in the garage where he met me with a garbage bag and pants. Being a nice guy ended up costing me $40 for my scrub pants. Also, a small part of my soul died.  ","TIFU by being a nice guy and helping my coworker, I was repaid by getting shit on.",593
ShitMyselfToday,123,173,1fniwe,492,"Today I am not a proud man.

It started like any other day when I work in the evening. I tried to get myself out of bed early to enjoy more of the day. It's a beautiful weather today. Sun is shining and not a cloud in the sky. I got up. I ate breakfast. Browsed reddit for a while and then it was time for my daily run.
I run every day. I guess you can say I'm a bit of a addict to jogging.

Before every run I try to hit the bathroom and get everything out so I don't need to run back home to go take a shit in the middle of my run. It can be a long way to the get home to if you really need to go you know... Stomach felt good. Nothing out of the ordinary.

I started running and since I've been working out hard the last days I felt a little sore but efter a couple of kilometers everything was back to normal!

Fast forward to when I had like 4 kilometers left of my usual path I felt like it might be time to need to think about taking a shortcut home to go to the crapper. But I decided to try to keep going.

But the pressure down there got worse. Fast.
Now I decided that ""Yep, I need to get home as quick as possible"". I took a shortcut home.

It kept getting worse. I started to ""prairie dog it"". I though ""Maybe I need to do it in the woods?"" but I couldn't find a good spot or a big enough leaf to use as toilet paper. I felt I needed to take a piss too. So I went behind a bush to do it, hoping it would release som of the pressure. But I couldn't take a piss. I would need to take a shit at the same time.

Now I was realizing the seriousness of the situation. This was really getting bad and escalating quick. I was about one km from home. I needed to run quicker!! But the quicker I ran the closer the turd got to getting out of there. At some points I actually had to walk to not lose the control of ""the situation"".

Now I could see my door a hundred meters away. I felt I needed to hold my asshole shut with my hand but there was a lot of people around so I would have looked stupid. I just ran. It was VERY close now.

Five meters from my front door... It was too late. I could keep it back anymore... I was so close... But I was defeted... When the first small piece of poop got out of there there was no way to keep the rest back either.

I walked up the stairs to my appartment feeling like a fucking baby in a dirty diaper. Lucklily I didn't meet any of my neighbours.

I got to my bathroom. I tried to get out of my clothes careful. But well.. Now I need a new bathroom rug.

I clened myself up. I thought about where everything went wrong. How did I end up here? What did I do wrong? Did I really deserve this? What did I eat yesterday?

I did everything I could to remove all evidence of the disaster and then I decided to finish my run. And to got for a couple of more kilometers to make up for the ""rest"" I got. I ran like one kilometer and then my stomach told me:

**BUT WAIT! THERE'S MORE!**

I had to run home again and take a shit. Seriously? Yes, seriously. I crapped myself and then I actually had to take a crap 10-15 minutes later. C'mon man...


So I had to run home and THEN I finally got to finish my run. I wouldn't let a little poop ruin my exercise.

I have taken two showers since the accident and even though I'm clean now I plan on taking at least one more before going to work.

Later on a bird actually shit on my laptop when I sat on my balcony.

This is turing out to be a real shitty day.

**TL;DR:** Went jogging, shit myself. Also I need a new bathroom rug.",TIFU by shitting myself,665
SchmisterTyler,264,98,17y4if,492,"UPDATE: After about 2 hours of awkward silence he started making fun of me then bought me a sandwich. Then we both chuckled over lunch at how dumb i am. I live to see another day! Turns out the truck is OK, had to drain the gas tank and change all the gas filters. It ended up costing $350 that's a lot less then a completely blown engine that i was expecting. 

Edit: It was a Banks turbo diesel my dad uses to tow his construction equipment.

Edit: I've filled this truck up properly with diesel fuel countless times in my years working for my dad. I feel like a lot of you are assuming i am child which would definitely make my mistake not as bad. I am 22 years of age! EVEN MORE EMBARRASSING. I just got side tracked in between eating my just heated Cup of Noodle and cleaning a pretzel spill out of the center console.",TIFU dad let me drive his diesel and I filled up the tank with normal gas and fried his engine. He's giving me the silent treatment.,590
Loborious,34,71,18affo,493,"My grandfather's girlfriend passed away on Friday. I intended to go to the funeral to represent my family (who are all overseas at the moment). I looked up the obit and found what I thought was the ceremony for her.

After arriving at the cemetery, I collected with the small group of people around the grave, keeping an eye out for my grandfather (who I thought was running late). After about 20 minutes, the pall bearers removed the casket from the hurst and the rabbi began to speak. Long story short, I realized I had the wrong Edith when the rabbi said the date of death, two days earlier than the Edith I was looking for",TIFU by going the wrong funeral and paid my last respects to a complete stranger. ,564
sixstringthing,78,96,1i8en7,497,"After leaving the bar last night, the SO and I had to find a washroom. Me being a shit drunk guy, I opted to go round behind the bar. She said it was a bad idea, and didn't want to. But I went anyway, and as I extole the benifits of public urination in dark alleys, I hear ""Can you stop pissing on me please..."" in a sad, drunk and frankly to polite of a voice. Flow stops, I look down, and low and behold some poor girl decided passing out behind the bar was a good idea. I've unintentionally just given some little drunk girl a golden shower. Whoops...",TIFU by peeing on someone.,593
DrissPinker,107,97,zzw6x,488,"I'm your typical, neck-bearded, loner redditor. This means I spend an unhealthy amount of time alone down in my basement, PC gaming, redditing... you get the idea.  

Occasionally, I will bring a large bottle of drink downstairs so I don't have to produce effort and actually go upstairs to get one. On this occasion, I had a 46 Oz bottle of apple juice with me. So, late at night sitting next to an empty bottle and having a full bladder, I thought of the most time-saving idea yet - pee in the empty bottle. 

I managed to justify it to myself - ""No one would know if they saw it because it looks like Apple juice"", and ""I'll empty it as soon as I go upstairs"". 

So I do the deed, relax, go on the internet for a few hours and then retire to my bed chamber, telling myself i'll empty it in the morning. Morning comes, I go to school. I get back from school. I rush down to my basement and it subconsciously registers in my mind that there is apple juice by my seat. I pick it up, bring it up to my lips and swig some. 

It took me a few moments to realize that something was up, but I kind of went into shock when I did. I spat the remaining fluid back into the bottle, and kinda just sat there, mouth open, not moving. For anyone wondering, it basically tastes like it smells but with an astounding amount of salt - almost an uncomfortable amount. I have amazing respect for Mr Grylls. 

So I run upstairs, still with my mouth open and vigorously scrub it with copious amounts of water and mouthwash. It took a while to get the lingering taste out - But nothing can remove the shame.

I tried some apple juice a few minutes ago, and it tastes just like piss. It's probably a subconscious thing, but I will still be avoiding it in the future. 

**TLDR - Pissed in an apple juice bottle, forgot about it then took a swig of day old urine.**",TIFU by drinking my own piss.,585
Fwdslash1,163,87,za8jm,485,"I went to Six Flags (Jackson, NJ) this past Saturday. I got on the superman ride  location. I had my cellphone in my pocket. Went through a sweet loop and felt something slip out of my shorts. Turns out it was my iPhone. Asked the employees what I could do. They said to file a lost/found report. 

As I was getting off the, a couple friends and I saw where the phone had landed. It was inside of a danger zone which only Six Flags employees could access. We asked an employee who was around that area and he said he usually does the rounds at all the rides picking up items from danger zones. His name was Mike.

I went to file my report and gave as much information as I could. At this point, i used my wife's iPhone and logged into the ""Find my iPhone app"" and it showed up here: http://imgur.com/9k6i2. I showed them this image and they immediately knew the phone was in a danger zone and that no one would be able to access it until the next day when the park closes.

I went home thinking I would be fine because it would be returned to me because it was in a safe ""Danger Zone"". WRONG.

I checked the Find my iPhone app early Sunday morning just to see if they had grabbed it. To my dismay, it showed up here: http://imgur.com/HbmNt

I was shocked. I couldn't believe what I was seeing. There was only 1 explanation. An employee from Six flags, that has access these areas, stole the phone. I immediately called the Lost &amp; Found office and told them that I had image proof that the phone was taken from a Danger Zone. They said they couldn't help me and that their employees wouldn't steal items.

At this point, I'm really pissed and don't know what to do. I tried contacting NJ Police but they didn't sound too happy about allocating resources into finding my phone. 

**tl;dr: Dropped my iPhone in a Danger Zone at the Superman ride at Six Flags, about 100% positive a douchebag employee stole it.**

Edit: Guys, I haven't heard anything back from anyone (Police, six flags, the media). Looks like this baby is long gone. I have since deactivated it and sent a full wipe request through Find My iPhone. Thanks for everyone's advice on this small dilemma. 

I've had a few days to clear my mind. I don't know if any of you have heard but.....

They're announcing (most likely) the iPhone 5 next week! It couldn't have come at a better time. 

Once again, thanks all for your advice. You guys are awesome.",TIFU by dropping my cellphone in a 'Danger Zone' at Six Flags,572
MSciCSI,78,141,1qrzde,487,"So today I was in Costco buying supplies for a family party I was to attend later in the day. I passed by the tyre section of the shop and noticed a beautifully presented case of windscreen wipers. They were good quality ones, Bridgestone, compared to the worn 'imported' eBay ones currently on my car. My current ones were ok, they were a bit noisy but I had no reason to change. I figured I could put something decent on her for once and splurged the £13 ($35) for a set of two. 
I got her home and figured I would fit them right away! This is the point when I remember that life isn't fair and no matter what youre doing you'll be able to find a way to fuck it up. So, the first wiper went on no issue.  I began on the second. It was a bit more difficult to get off but I got there in the end.
I left to get the new wiper. 
There was a light breeze of wind. 
The wiper arm fell back down. 
My windscreen smashed. 

Yeah her £13 upgrade turned into an £80 new windscreen. 

The wipers suck too. 

TL;DR;  don't let gremlins near your car. ",TIFU by being nice to my car,628
Fr4t,139,106,113vtg,492,"So I was on vacation for a week and simply had no (private) time to release some pressure. Horny me couldn't wait for the girlfriend to show up so I decided to go on a date with rosey palms and her five sisters.

So as I was about to finish, well... I was prepared for a bigger load than usual. But man did I underestimate my balls' dilligence (maybe it was the healthy food I ate all week). What came after I finished can only be described as a sperm-fountain. I exploded propably a metre high and jetting cum everywhere. The chair was dripping, cum on the desk on all of my clothes and the carpet.
My reaction was between excited and aphasic. 

Twenty minutes later the girlfriend arrives and sees me naked on the floor (clothes in the washer) trying to mop up the jizz (I hadn't even started with the desk...). So here it is. My fuckup.",TIFU by ejaculating all over the place,598
JaedenStormes,84,121,1feu66,487,Title says it all ;(,TIFU by oversleeping the doctor's appointment I set to determine why I'm always oversleeping,608
adamandatium,31,56,10hilw,487,"I work at a grocery store, and like most stores there's an intercom/phone system. One of the Pepsi/Coke stockers needed to find another employee, so I picked up the phone to page him.

""Employee, dial 1213. Employee, 1213.""

The employee did not hear the page, so he sent a return message over the loudspeakers: ""Repeat the page for Employee, please.""

I repeated the message, and while the phone was still off the hook (and still in loudspeaker mode), the phone began to ring. I didn't know that I had to hang up the phone in order to answer the call, so I began to panic. 

In my confusion, I blurted out: ""**OH SHIT I DON'T KNOW HOW TO ANSWER THE PHONE**"" Vaguely, in the distance, I heard my words echo over the entire store...

I went crimson. The stocker next to me was laughing so hard he was crying. I was shaking as I clicked the hang-up button and answered the call.

Thankfully, no customers complained about it (we're a relatively small store, we get lots of regulars and they know the employees personally) so I didn't get into trouble. But when I went up front every single cashier was laughing at me.

TL;DR: I became flustered over technology and ended up swearing over the loudspeaker systems at work.

EDIT: Oh shit, front page. Hahaha thank you for liking my tale of embarrassment.",TIFU by swearing over the intercom at work.,543
jeremiahfelt,81,218,1gup93,486,"More of a [yesterday I fucked up], but this is more fun.

So I work for a really big company. I spend a lot of my day on one conference call or another. This one was with four or five people from another division of our company, who wanted to ask us questions about a piece of software we have deployed, how we use it, how we like it, etc.

Now, we have this one project manager who is... a loose cannon. He tries really hard to be personable but it always blows up in his face. I'm pretty sure he's got aspbergers or some similar disorder, and gets frustrated with his level of expression AND what comes out. I digress.

We're joining the call bridge, like ya do, a few running late. The PM from the other business team jumps on, and the bridge introduces him. Our project manager quips up and says ""That's quite the last name you've got. Is that Swiss?"" The fellow replies, ""Nope, it's French."" We start the call, and maybe 90 seconds later, the bridge reports that Mr. Frenchlastname has left the call (his phone disconnected). 

Completely without thinking, I mutter 'Eh, he must've surrendered.'

Half the bridge laughed. One dude laughed uncomfortably. The rest I assume were moritified (silent) or not paying attention (also silent). Our PM about lost his shit, but didn't know it was me who said it.",TIFU in front of coworkers and colleagues by speaking without thinking,704
redhottt66,144,95,1cesw6,481,I usually don't let her sleep in my room but I recently had her fixed. I felt bad and let her climb in bed with me and went to sleep. Next thing I know I am woken up by excruciating pain in my right nipple. She had climbed under the blankets to suckle me. Has anyone else had accidental animal experiences? ,Tifu and fell asleep naked with my kitten in the room...,576
phi186,139,85,1bw07c,484,"Foreword: There is no sexual attraction to my little sister.  For the purpose of this story, we'll say my sister's name is Rachel. (it's not)

I was just laying in bed tickling my girlfriend and went for her butt hole because it tickles the most (just going near it makes her freak out, not in a rapey way, calm your tits). But anyway, she asked me to stop so I stopped and said ""sorry, Rachel"".  She was like, ""Did you just call me Rachel? I was speechless and just laughed it off.  I don't know why my sister's name popped into my head, but my girlfriend is now mad at me thinking I know more than one girl by that name (which I don't).  

Anyway, currently in the dog house, I fucked up.",TIFU by laying in bed with my girlfriend and calling her my sister's name...,569
grant0,65,89,14gc80,475,"I set my alarm clock across the room from me to make me get up to turn it off, otherwise I can turn it off in my sleep. Today my alarm went off, and I stood up to turn it off…without realizing that both my legs were still asleep. I instantly collapsed and twisted both my legs in an inhuman manner. I couldn't stand up so had to crawl around my apartment searching for the strongest painkillers I could find. Ever since, I've been walking around with a horrific limp, trying to think of better reasons for my limp than ""I suck at standing up.""",TIFU by waking up wrong and failing to stand. Wow.,564
PurpleTrainRide,139,169,1nfox8,479,"So usually I would just grab a razor and go to town. But I decided I wanted to trim up a little bit and reduce the time. So I get out the scissors and start snipping away. All of the sudden I can feel a sharp pain. I'm hesitant to look down at first. Blood everywhere. I'm freaking out and it didn't take long for it to stop. 

TLDR; I cut my balls while trimming my pubes ",TIFU while manscaping,648
NoKumSok,70,71,18gn8f,477,"So I just want to preface this whole thing by saying fuck Canada Post. I was home all god damn morning and their delivery still somehow failed. So I had to haul my sore ass (gaha, foreshadowing) all the way to the post office to pick up my god damn dildo of doom.


So I've never owned a dildo before. Figured I'd buy one with some left over cash I had on a prepaid credit card I got for christmas. How couldn't I - they're so cheap! $20 for a glorious 8-inch silicone rod of pleasure! What a bargain. It even has a suction cup! And it comes in blue! The thing practically ordered itself.

Anyway, so after the somehow-still-embarassing-even-though-nobody-knew-my-secret walk home from the post office with my package in hand, I anxiously unwrap this thing in the bathroom. Bathrooms have showers, showers are hard to get messy. Perfect place to try out Carl. I've already named him at this point.

So I take it out of the box and admire it for a second before placing it down, suction cup first, on the nearest available surface, which so happens to be toilet tank cover. You guys know what I'm talking about, right? The ceramic cover that goes on the tank behind the toilet. The big, heavy, detachable part of the toilet. Stop me if you already know what's going to happen.

So after undressing and turning on the shower I try to pick up the dildo. Unbeknownst to me it's suction cup had the adhesive power of nuclear grade duct tape, and the fucking toilet tank lid came along for the ride. The entire god damn thing lifted up a good foot or so from where it should be. My initial reaction was to move my feet as far away from that thing's potential drop zone as possible, aaaand then the dildo's titanic grip let go and the cover fell, breaking both itself and the toilet bowl where it happened to land.

Damn you, Carl. 

",TIFU by breaking the toilet with my new dildo.,548
Semetastic,43,120,15c0yt,481,"Yea. So. That was awkward. My sister and her boyfriend have been a little shaky and my sister came home yesterday all depressed after leaving her boyfriend's early. My mom kept pestering me about their relationship so when I heard that my sister had come home after being out all morning I stopped getting dressed. I ran and yelled over the railing ""HEY! MOM WANTS TO KNOW IF YOU ARE BREAKING UP WITH ___?!"" and then ran downstairs in my bra and pants.

He was standing at the bottom of the stairs, holding her christmas present. Apparently they are okay and he came by to exchange gifts, and I sounded like the whole family is rooting for them to break up now.","TIFU by yelling about my sister possibly breaking up with her bf, coming downstairs half naked and having him standing at the bottom of the stairs.",601
mustangwolf1997,235,202,1ic2sx,471,"I swear... I have the worst luck in the world.

Ok, I'm tired, and I have a doppler in a couple hours. I'm not gonna do my usual wall of text. Just a short post this time.

----------------------------

So I'm watching episode 17 of Black Butler. [The episode, if you're interested](http://www.dubbedonline.com/black-butler-episode-17-english-dub)

I reach a... Fun part... And my dad walks in to show me a guitar I might like. *The Yamaha 012 Pacifica, light blue. I love it* 

He sees the screen and simply says ""The fuck kind of porn are you watching?"" and walks out.

Knowing him, there's no doubt he told the rest of my family just to be an asshole.

**FUN. NOW MY WHOLE FAMILY PROBABLY THINKS I WATCH HENTAI.**

-----------------------------------------

TL;DR A sex scene showed up in an anime I was watching, and my dad (And probably the rest of my family) thinks it was hentai porn. 

-----------------------------------------

Edit: Since everyone is asking... The timestamp is 12:17.

[And a non-dubbed youtube link](http://www.youtube.com/watch?v=xiwLjdrxjCY#t=12m0s)

Have fun...",TIFU by watching anime,673
sunglasses619,79,125,1hmuwj,476,"I am interning over the summer at a marketing firm and our projects are mainly compiling presentations for startup companies to use for potential investors. 

So it's presentation day and we're all sitting in the main boardroom, the company taking notes as we go one by one.

It was my turn to present so I hooked my laptop up to the projector, and opened a new tab to find my presentation. I accidentally opened the wrong browser so I exited to use Safari, and the first tab open is a Google search for 'can I get pregnant on my period', projected in huge font for the entire boardroom. Then the little rainbow wheel came up so I had to wait for like ten seconds, frantically clicking and moving the mouse, until I could close the tab and open my presentation.",TIFU by using Google.,601
lshabowco,165,128,1keth2,480,"I'd just gotten out of the shower, so I was only in my underwear when I stumbled backwards and trod on a plug. My first thought was something like ""fuck sake"". I have a high pain thresh hold so I wasn't so much worried about the pain, just sort of got curious to how bad it was. I look down and see the blood, everywhere, literally gushing from my foot. It's all over my hands, my feet, my floors, my cream underwear and my fucking cream walls. Guess I'm making a trip to B&amp;Q as soon as I can walk again for some cream paint. I start to feel woozy, and realise I can't even hobble down the stairs to get a snickers bar and get sugar back into my bloodstream. The gash has taken a huge lump out of my foot and I realise I won't be able to do anything for my birthday in two weeks (the cut is really deep, all the thick layers of skin taken off). Eventually, my cousin showed up and helped me stop the blood flow. We were planning to go ice skating, but instead we're watching freddy got fingered and I'm hopping everywhere. I'm not going to the doctors because they're going to tell me it's a viral infection, so I got my mum to play nurse and bandage up my foot.

To summarise: made the common occurrence of stepping on a plug into a severe danger.

EDIT: The pictures of my foot afterwards: 

http://imgur.com/moFK6Hz

http://imgur.com/az23zRb

http://imgur.com/sr9IA98

See that darker bit under the skin? That's where the skin flaps back. I would pull it back so you can see how deep it is, but there's the small matter of it **fucking hurts**",TIFU by stepping on a plug.,608
airborneANDrowdy,107,100,13gx62,479,'Nuff said. ,TIFU by calling my new girlfriend by my ex-wife's name. In bed. Twice.  ,579
Bareback112,38,108,1r4ehu,474,"I was round at a party of a girl who I had had previous sexual relations before. So i felt pretty confident I would get sex again at this party. We drank all night and her little brother who has just started drinking as he's young came out and got high with us. It was a great night and me and the girl end up going to bed earlier.
Round 1 was great, round two was better. Two used condoms I wish I had deposed of properly...
I get up in the morning and go and make some coffee, as we're friends and had known each other for years. So it was OK to help myself.
Next thing I hear is a shout and a fall.
What had happened was when I went downstairs to get coffee, I left the bedroom door open. The dog went in, into the bin and extracted one of the used condoms...
He then took the condom into the hall and left it at the top of the stairs...

The little brother... hearing I was awake and probably wanting coffee too decides to come downstairs. He steps on the condom, it sticks to his foot and he proceeds to fall down the stairs....


TLDR: Had sex at a girls house, evil dog steels used condom to plot attack on her little brother....",TIFU - By not closing the door...,582
PKfire12,91,93,1iva5v,479,"Up to this point, I've always used lotion or Vaseline to twiddle my diddle, and sometimes I would have to borrow some from my mom's bathroom. Well, today my mom came into the bathroom while I was getting a fingerful of Vaseline to take to my room and asked what I needed it for. Having no real excuse, I told her I was going to masturbate. She sighed and said ""so that's where all my lotion keeps disappearing to!"" I left and did my thing and that was the end of it. Or so I thought. Later that day I was sitting in my room reading when I heard my dad stomping up the stairs. I didn't pay it much attention until he threw my door open and threw a bottle of astroglide across the room at me. Without making eye contact he shouted ""Stop taking your mother's lotion!"" Then slammed the door and stomped back downstairs. I think I made my dad just a little uncomfortable.",TIFU by masturbating too much,572
Nightwing73,122,329,1fxjoj,477,"So last night was my graduation, and afterward this girl came back to my place to chill. We ended up cuddling and eventually making out. During the flow of events, my dick decided now was a great time to get hard as hell. I adjusted myself so it wouldn't be obvious, but my thumb nail rubbed up against the side of my pants making it sound like I unzipped my pants. Obviously, this wasn't an okay thing, this being her first time over, and she got a little freaked out. I asked if she wanted to stop, and she said yes.

TL;DR accidentally made a zipper noise while kissing a chick and made it awkward.

Edit: spelling",TIFU by making out,806
LegitAndroid,151,171,187nuf,473,"It is my first time eating sushi with Wasabi, I didn't even know what wasabi was all I knew was that there was some green stuff next to my sushi. So I dipped it in and the whole glob got stuck to the sushi, and I had no idea that Wasabi was capable of making me cry, so I plopped the thing in my mouth and I was dying for the next 15minutes. ",TIFU by eating a whole glob of wasabi with a tiny piece of sushi because I didn't know the power of Wasabi.,644
nylon_carpet,81,112,17pu6l,470,"So today in class we are watching some video about a viola player, when a nervous looking girl comes in. Our school is doing a fundraiser for starving children. So she starts her presentation with a badly made video and everything is going fine. 

So then pictures of starving children start being shown. Everyone is soaked in and focused on this video. No one is talking. I turn and see everyones eyes glued on the horrific images. Then, a picture of an african baby being held up by hands comes up. You cant see who is holding it, just the hands. 

""He's being buttfucked by a monkey"" says my friend next to me. 

I lost it, I have no clue why i did, but i did. Its awful. Everyone near me was cringing and they looked pissed. I was literally in tears. 

**TLDR**: I'm sprinting to hell.
",TIFU by laughing during a video about starving children.,582
omelettegod,63,139,15qc27,470,"Ok so it had been a bit of a heavy session at my friend's party earlier that night and I don't stumble home until around 4:30 am. I'm pretty impressed that I've made it through the night thus far without any major incidents but I decide that it's most definitely time to call it a night. I get into my normal routine, glass of water, brushed the teeth then the pre-bed numero dos. Well, apparently I just got too comfy on the old throne and I went out like a light and crashed head first into a bowl of [sea glass](http://en.wikipedia.org/wiki/Sea_glass) that is on display in the bathroom, sending it everywhere and making a loud noise waking the whole family. My dad comes down to see if I'm good but he finds the door is locked. He starts freaking out thinking I've gone all Jimi Hendrix or something until he looks under the door and sees me passed out with my boxers to my ankles and I get up and go to bed. We had a laugh about it in the morning but shit... that was embarassing.",TIFU by blacking out mid shit and making my dad think I had died,609
Dammitlemon,122,87,11ir9c,465,"So I work at a diner as a busser/hostess and I have a nervous smile when things go wrong at work because I have no clue how to react. Anyways a large table of about 10 people came in, they had a baby and sat it on one end of the table. . To clarify, this was not on purpose nor could I have prevented it, but this is what happened...
I took their drink order and went to just get all the coffees first. Once I came back it was all going fine until I got to the end with the baby. I had about 3 cups of coffee on my tray left and was about to hand them out when I saw the kid staring at my tray. He reached up for it and pulled it down towards himself. I managed to maneuver the tray so the cups didn't fall off onto it's head, but some of it still splashed onto his arm and face. Needless to say, i felt like I deserved to die. I injured a 6 month(ish) old baby. 
The worst of it was the father of the kid told my manager I was LAUGHING as I walked away to get ice and my boss. No. Fuck that guy. I still feel like shit, and probably always will, even though it's not my fault what so ever. The parents also put ice on the burn right away so the babies skin ended up looking worse than it actually was because you're not supposed to put ice on burns right away. 
Ugh. Parents

**TL;DR** I was handing out coffee to a big ass table and the baby sitting at the end grabbed my tray toward itself, I managed to catch the tray before it fell on the baby's head Once the Dad told me to get ice and my manager, I had a nervous smile because I have no clue how to react at work when things go wrong. Needless to say, the parents wanted to rip my head off and feed it to a bunch of termites.

EDIT: Thanks, Reddit. I've learned a few things:

*NEVER carry trays next to a baby.

* I should learn to control my nervous laughter.

* Parents can't help being assholes to teenagers when it comes to their child.

* Babies kind of suck, so I don't have to hold onto my guilt for too long.

**Update:** If anyone cares, my mom bought me chocolate to feel better. She knows the feels because she was a waitress.","TIFU by splashing a Baby with hot coffee at work and ""laughing"" about it.",552
BaconMcTryhard,58,99,1cdo97,472,"Basically, i bought a container of Breyers triple chocolate ice cream, and opted to eat all of it in one sitting. I then proceeded to spend the next 20 minutes shitting what seemed to be the entire contents of my bowels throughout the week into the single staff toilet. I did get lucky in the fact that no one else went in there for a while, or i probably would've killed them with the ridiculous stench i left.","TIFU by eating 1.6 litres of ice cream, on my work break.",571
worriedaboutroommate,182,107,11xmu9,471,"So I've been living with my roommate roughly 7 months now. She's a very attractive woman. She's smart, funny, gorgeous, and has a body to kill for. We've become really close friends, and naturally (as idiots are wont to do) I've fallen for her. I want to avoid pursuing any romantic entanglements with her, since the living situation would just be too complicated.

Tonight we were cleaning up after dinner, she was washing dishes and I was drying them and putting them away. She hands me a measuring cup and it goes in the cabinet just above her, so I reach above her to put it away, and she turns around. She's looking up at me, I've got her basically pinned up against the counter with my arm on the shelf above her. Our bodies are so close together we're swapping heat, and she's got this vulnerable, doe-eyed look going on. It's driving me crazy, and our heads come in that our lips are *thisclose*. Our lips are just barely grazing each other, and our breath is hot and intermingling. All it would take was a centimeter and I could be kissing her.

But instead that stupid fucking *common sense* is like ""No, dude, that's your roommate!"" and I turn away, and just keep putting dishes away. We try to make a few jokes to dissipate the awkwardness. As soon as she turned around and we were so close it was damned-if-you-do-damned-if-you-don't. If I made a move it could be a disastrous hook-up that ends terribly with one or both of us moving out. Not making a move and there's sexual tension, regret, and more regret.

Masturbating alone tonight.",TIFU and almost kissed my roommate (but pussied out),578
BamboolessPanda,164,119,11twcf,471," 15 minutes ago I was enjoying a wonderful bowl of Coco Puffs and watching The Big Lebowski. I was watching it on my laptop. Lebowski entered his apartment and then two guys jumped him. Being the first time I've seen the movie, I didn't expect it and was startled. I then proceeded to spill my cereal all over my clothes, laptop, desk, and carpet. I scrambled to clean it up, but my laptop gave up and died. My carpet now has a huge brown stain. At least it didn't spill on my desktop that I saved up for and built myself. Now I'm going to finish the movie, angry and with no cereal.
Edit 1: Looks like I'm going rice shopping. Thank you for all the advice!
","TIFU by watching ""The Big Lebowski.""",590
NoAttentionAtWrk,213,116,xeem4,465,"Story time :

I started working with a new team / new project in my office. So for this I had to fly to a different city with my boss and stay there for a month. Me and the guy were talking on the flight and turns out that his wife was a professor in the college I went to about 6 years ago. He asks if i knew her and I said that i don't recall her because she used to teach in a different department.

Once we land, for some reason his phone isn't working. He asks me if he can use my phone to call his wife to let her know that his cell isnt working. As soon as he dails the number, his wife's name flashes on the phone with a picture of her! 

If that wasnt enough, i had saved her number as "" X Name - The Hot Professor"". The X before the name was due to an unrelated TIFU where I had texted my dean instead of my GF since i was in a hurry and their names were next to each other, but that X made it look like i was saying that she was an ex of mine

He says I thought you said you did not know my wife. I told him I didnt. He hands me back the phone and says ""So why do you have her number saved on your phone?"" For the life of me I couldn't recall at that time how that number got there. I said it was probably from all the numbers I had to keep on my cell to call up various departments for some events that i used to organize. 

He didnt believe me. obviously. Even i didnt believe myself. 

Later that night  I heard him argue with his wife over this, outside the hotel room.

Technically, this happened a couple of years ago. I am writing this today because I just got to know that they divorced after they found out that they were both cheating on each other.

Also, received a text from her last night ""You guys really thought I was the hot teacher?""

Update here http://www.reddit.com/r/tifu/comments/xilrs/tifupdate_coffee_with_my_exhot_teacher_who_is_my/",TIFU by getting my boss to believe that me and his wife are cheating on him because I had not deleted old contacts from my phone since college,581
themeowzart,59,106,1nxn5y,465,"So today I got called in to manage one of the stores I work in because the GM had an emergency (her 16 year old son was stabbed by a girl at school). Now scheduled to work a 12 1/2 hour shift while already behind, I began to feel the effects of the stress. 

It didn't help that I'm working with a really hot girl and I'm probably ovulating because I'm horny as fuck. Regular stress + sexual frustration = having a bad time.

I managed to get a break in during the afternoon and went out to my car to smoke (it was raining and I had no other protection). Thought to myself ""Hey know what would be such a good idea? Why don't you rub one off real quick before you go back into work! That'll calm you down and maybe make you not want to jump that girl's bones so much!"" Fucking fantastic idea! Didn't take long, but being in my car and trying to make this whole thing not obvious I pulled a muscle in my leg immediately upon finishing. Walked back into work with a serious and painful limp and no good way to explain it. 

That was an hour and a half ago. Still have 6 more hours left and I'll be closing (alone) with the hot girl who unknowingly had a part in this whole fiasco.

**TL;DR: Flicked the bean, walking with a lean.**",TIFU by relieving some stress during my break,571
ifuckedupbad_12,206,199,1nq6h0,468,"So yesterday I turned up a few minuets late to college, I try looking for my class but can't find them, I go to a class where the lecturer asks me to wait whilst they try and get ahold of my lecturer. Whilst waiting, the person I've been waiting for comes into the classroom and I end up leaving the classroom with him.
He tells me that the people who have turned up have mostly gone home because they couldn't find the class that we were meant to be in and that he was phoning around and trying to get people to come back in. We have a polite conversation and he tells me that I don't have a class until 11am and it'll hopefully be in the room that's timetabled for us. By this point it's twenty past nine in the morning and I have an hour and 40 minuets to kill, so I decide to go to somewhere familiar and end up doing that for awhile. When my friends go on their break I join them, I've completely lost track of time by this point and by the time I've noticed this, it's already half past 11 and I go hunting for my class, I go to the room that's been timetabled, or atleast I thought was timetabled, and no-one was in there, so I've ended up in the library fucking around on the internet, my friend, lets call him Sam, has joined me by this point and I tell him the situation, he agrees to go to the library and we're both just fucking around, I'm on Tumblr and he's on YouTube and stuff. 
I should of really known better than to go on Tumblr but there really isn't much else to do and as my dashboard has some 'explicit' content, I try my best to scroll past it as quick as I can without causing a problem, however as I'm doing this a message pops up on my screen saying that 'screenshots are being taken of my 'inappropriate' use of the computers and are being sent to my lecturer', I obviously closed Tumblr straight away because I didn't know my computer usage was being monitored and the next thing I know my computer has been logged off and my account has been logged off, I didn't really think much of it, to be honest, was abit worried but I was just thinking that I'll get a smack on the wrist, type of thing. 

Fast-forward to today, my parents have been called and the college are calling a meeting about my 'inappropriate' behaviour and I know it's not going to end very well at all. 


TL;DR - Couldn't find my college class so I went to the college library where I was browsing Tumblr, instead of trying to find to my class, screenshots of 'explicit' content which I was trying to scroll past on Tumblr was screenshotted by admins who work in the library and sent to my college lecturer, they phoned my parents and have called a meeting for Tuesday afternoon and I'm probably going to be kicked out of college because I'm on a trial period anyway. I'm from the UK and I've just turned sixteen, so this is a big deal. 

Edit: I tried to explain the TL;DR abit better.",TIFU by going on Tumblr in the college library..,667
Kicktoria,79,224,1ifcgg,465,"Okay, this wasn't ""today"", it was ""twenty years ago"", but...

Sophomore year of college, I was home for Thanksgiving break.  I'd started smoking cigarettes about a month previous.  My folks didn't know and I didn't want them to find out, so I hid out in my closet to smoke.  It had a full-sized window, open it and voila, no smoke.  I left my butts in the space between the glass and the screen, no one's the wiser.

Two problems with this that hadn't occurred to me:

1. My window faced the front of the house.
2. It rained pretty hard that entire weekend.

My parents come into my room after coming home from an errand and say ""Kicktoria, do you have something you want to tell us?""  

**Apparently the space between the glass and the screen had filled with rain, which dissolved the cigarette butts, which caused a flood of tobacco-stained water to run from my window down the front of the house.**

It still gets brought up in my family, eighteen years after I finally quit.

--Edited to add that I just remembered my MO was to buy 100's, and then smoke only half, saving the rest for later.  So I was leaving half-smoked cigarettes in the window, which was even dumber of me.
",TIFU by smoking cigarettes in my closet,689
CaptainSnowy,47,196,1mv4w9,462,"Alright. So, at around 5:15 in the evening (about 25 minutes ago), I decided to make myself a cup of tea to fight off the mid-evening snooze and get focused for the night ahead. It started off just like any other mid-Saturday affair, except all day today I've had a piercing headache.

Actually, let me elaborate a bit. A few hours before, during, or after a big rainstorm, I typically get a decimating skull-fuck from Satan himself for an uncomfortably long period of time. The rain had just stopped a few minutes before I decided to take that fateful walk over to the kitchen. 

I was pretty much just wiping the seed of Lucifer off my chin. 

Naturally, I was in a haze. Everything looked really bright, and my eyes dully throbbed whenever I moved them. I wandered over to the stove, and put on the kettle. My hands shambled over to the cabinet where I keep my cups. 

There were none. The dishwasher was running.

fml.jpg

Now, here's where the fucking up starts. Instead of being a non-dumbass and just not making any tea, I decided it would be a better idea to search for an alternative drinking vessel to employ for the job.

I made my way to fridge; a journey that seemed to take hours. Opened the door. The only remotely cup-worthy receptacle to be found was an apple sauce jar of dubious age. It was about 3/4 empty, so I washed it out and plopped a tea bag into its murky depths. The water boiled. I poured it into the jar. Waited 2-3 minutes. Ready to drink.

Take a large sip. Swallow with gusto.

...

Holy mother of all that is shitty, it was bad. 

Imagine throwing up after drinking too much booze. Picture that watery, sticky ooze all over your carpet. Your hasn't-been-washed-since-1995 shag carpet. Now, imagine scraping all of that up and scooping it into a used, steaming toilet, chunks and all. Stir it up a little. 

That's what this nightmare fluid tasted like.

Part of me couldn't believe how utterly disgusting it was. I stood for a moment in silence, slowly understanding the error I had made. I ran to the bathroom and promptly vomited into the shitter. I stood up and looked myself in the eye in the mirror.

""You pathetic fool.""

As it turns out, the apple sauce I thought I had washed away was about a month past the expiration date. Also, my hardly lucid self failed to do a proper job of rinsing it out, and upon further inspection, there were still congealed chunks of congealed demon-bile floating around in the tea water. 

The stomach ache hasn't gone away. I feel like a possum being eaten alive by a rabid raccoon.

TL;DR I drank tea out of a jar containing spoiled apple sauce and may have given myself some kind of rare tropical disease. ",TIFU by making tea in an apple sauce jar,658
Alexanderr,57,104,1b3203,464,"I bought my female friend [pepper spray](http://www.amazon.com/Sabre-Compact-Pepper-Spray-Release/dp/B000UVTDLG/ref=sr_1_2?ie=UTF8&amp;qid=1364349317&amp;sr=8-2&amp;keywords=sabre+red) and thought it would be a good idea to order an extra for myself to carry on my keychain just in case somebody tries to mug me at knifepoint or something. Big mistake.

Today, the safety got deactiated somehow and it deployed in my pocket during class. Pretty sure the entire canister emptied all over my leg before I noticed the slight burning feeling. 

Not wanting to miss out on any calculus notes (have an exam early next week), sat through the entire lecture with the inside of my pants soaked with the pepper spray and my leg feeling like it was sitting in a vat of habanero peppers. I thought the worst was behind me....

Nope. Got up out of my seat and suddenly it felt like somebody was trying to light my balls on fire. The pepper spray spread... suddenly I was experiencing borderline agony. It stung bad. Really bad.

Quickly traveled home while trying not to yell at the pain, stripped naked, and hopped into the shower. Big mistake - this made is SO MUCH WORSE. Suddenly my balls were being incinerated. 

I posted about it on Facebook and did a lot of Googling and tried many of the remedies (baby oil shampoo was the most effective so far). My balls feel much better now but my leg still is burning. This occured over four hours ago and I am still suffering the consequences. TIFU",TIFU by accidentally spraying myself in the balls with pepper spray,568
SelectaRx,77,137,18r0o3,465,"I went to the club tonight to hang out with a friend I hadn't seen in a while. The club is frequented by several people I know and I was having an awesome time reconnecting with people I'd not spoken with in a long time. I went outside to grab some air and struck up a conversation with some people I knew who were doing the same, one of whom I failed to identify. She and I got into a bit of an in depth conversation regarding a sound system at another club and toward the end of the conversation I asked, ""What was your name?"" As soon as I finished the sentence I knew I'd opened up a giant can of cringe, as I instantly recognised who she was when she told me her name. After some awkward ""Uh... sorry I didn't recognise you"" and ""It's been a long day"", I wandered off and she didn't speak to me for the rest of the night. ",TIFU by introducing myself to someone I've known for 8 years. ,602
mistofsunshine,160,262,1elanh,461,"Well its my time of the month and mother nature just knocked on the door.Behold the time that I very much despise and love at the same time! And of course the time when i get bitchy and lazy.Well lets get to my TIFU moment.Everything was going good until I woke up and went to the restroom for my morning pee. Then I noticed it was finally here! (Hooray! I am not pregnant.) Anyways I was running late for my morning classes. So I grabbed a pad from my cabinet in a hurry and didn't even bother to look if I put it on right. C'mon now, I've done it a bunch of times I think I Am a pro here!Well... bad idea. My dumbass should had looked. Turns out that I put it on sticky side up. And well lets say I am a women who loves the pubes. Likes to have them trimmed/cut and simple. Ha well I sat through class wondering why my ""lady parts"" felt unusual and rather sticky. And just plain out weird, I wont get into detail. Lets just say it was a horrendous moment.So I kindly walked out of the classroom to the ladies room, pull down the pants and then I noticed... My poor tootsie was literally stuck to that damn wonderful pad of mine.My pubes where stuck to it as well and it was a pain in the ""vagina""(pun) to get it off. It felt as if I where getting a slow type of Brazilian wax. I got rather angsty and thought ""maybe if I pull it off real fast it might not hurt"". Well ladies and gentlemen I was **WRONG!** I closed my eyes and pulled it off as fast as I could. There where literally pubes on the damn pad! I don't think I ever wanted to cry as much as I did today. My lady parts still hurt, and I have a zip lock bag filled with ice on them. ): Ladies! please learn off of my mistake and **ALWAYS** look if you put it on correctly.

TL;DR:I put on my pad sticky side up, pubes got stuck to it, and I basically gave myself a Brazilian wax.

EDIT:Spelling errors.",TIFU by putting on a pad... (NSFW),723
JohnEGeostigma,142,109,157o5q,463,"Okay, I know this sounds bad, but it wasn't on purpose. I had a bottle of a drink that's similar to champagne, but for kids. It's just like really fancy sparkling juice. And like champagne, it is INCREDIBLY carbonated. I was opening it on my porch just for shits and giggles, and as promised the cork rocketed off. Right into a squirrel that was climbing the telephone pole in front of my house. I heard a muffle screech, then it fell and didn't get up.",TIFU by killing a squirrel with a cork.,572
mueslimonster,53,119,136ki1,456,"The local club had been handing out free t-shirts at the beginning of the night, and a cute girl that I'd struck up a chat with was wearing one of them. We're literally one minute into conversation, and she mentions liking the shirt. I agree, and I also want to keep the chat going. So I ask her what she had been wearing when she stepped into the club.

At least, that was my plan. Unfortunately, my brain fumbled a bit. I'm afraid my exact words were:

""Yeah, nice shirt! But I'd like to know... what are you wearing underneath that?""

She stared at me with a curious mixture of awe and disgust, then turned away saying some stuff about my terrible lack of manners. My attempts at explaining myself were sadly lost below the loud music. Too bad, she was really a very cute girl!

TL;DR: tried to make ""TIF"" happen, instead I got a ""TIFU""",TIFU talking to a girl in the club,575
GravyMaster,194,117,vjpct,462,"So first a little back story. I am a guy, as you can assume from the title. I had an extremely busy December last year and this resulted in me not committing the heinous crime of masturbating for a while. After about two weeks, I realized the combo I had accidentally built and thought ""*Eh, what the hell lets keep this thing going.""*  I successfully did so until today. All of my roommates were out of the house for a solid three hours and I decided it was time to end it. Time for my moment of glorious self-pleasure. I had the mood all set, I was comfy, the lights were dimmed, and I had my favorite visual assistance leading me on. Things were going well and I was feeling pretty good. After about 5 or 6 minutes of work, I made a huge mistake.

What I forgot to take into consideration in this instant was my largely diminished endurance. Like, damn, I was on a short fuse. My huge mistake? Adding a lubricant. Within what seemed like seconds I had gone beyond my limit, there was no turning back. What's done is done, what's fun is fun. Normally this wouldn't really be that much of a problem, but, I was laying on my back with the cannon pointed directly at my face. Before I knew it, I was scrambling to scrub my face clean with Kleenexes. Mind you, I hadn't cleared the pipes for nearly 7 months so you can imagine the magnitude of what occurred. Never again.",TIFU and blew the largest load of man gravy upon my own face. (Slightly NSFW),579
fuckityfuckfuckfuck_,283,285,1gc60v,462,"God fucking dammit. So I cheated super hard on my chem final exam (got the answers before the test), and proceeded to get a B (aka not failing the class). I was super fucking happy I hadn't failed.

My buddy knew I had it and asked if he could have it after I used it. I didn't care, but I told him that if he got caught, to, and I quote, ""not nark on me"".

He proceeded to use it, and get caught (you have to be REAL fucking dumb to get caught cheating in this class). And when he was threatened with 10 days (just a threat), he gave up my name. 

I have my morals. I knew that if I did get caught, that I WOULD NOT give up who I got it from because fuck it, I made this bed, and i'm gonna have to sleep in it, but he fucking sold me down the river. So yep, here I am, suspended on the last fucking day of my junior year. I failed the class, btw.

tl;dr CHEATING DOESN'T PAY

edit: i went back after they got out to take my last final. after that i went to see the counselor, and managed to not need to take summer school! still have to retake it, but during next year so fuck it.",TIFU by cheating,747
tifuagain,179,91,133pc5,463,"So, TIFU by trying to deep throat a guy. A guy who, not going to complain or anything, is hung like a freaking race horse. I was already gagging a bit, so we decided to move the fun into the bathroom just in case I couldn't resist the urge to puke. So there we are, butt ass naked, and I'm on my knees giving this guy a bj. Then I go in to deep throat him and I was doing pretty well (I was pretty dang proud of myself) when BAM I need to throw up immediately. So I push him back and I was happy when I mostly kept myself from throwing up, so I just spit the little bit that did come up into the toilet...but when I went to take a breath, I couldn't freaking breathe. No air, wheezing, me freaking the fuck out. He kinda giggled at first, thinking I was just recovering from his huge cock (I'm sure I had made similar sounds before). But then I managed to choke out, ""something's wrong."" So, all the while I'm choking I'm sitting here thinking, ""Oh dear God I'm about to die butt ass naked from choking on a damn penis!"" ""This guy is going to have to run out NAKED and get my roommate who he's only met once!"" ""Oh my God my family is going to think I'm a whore!"" And while I'm choking, thinking all of this, he picks me up turns me around and gets behind me, (in my terror I didn't comprehend he was getting ready for the Heimlich and just thought, ""Oh come on John this isn't the freaking time for this!!""). So he's behind me, starts to do the Heimlich maneuver and I finally think to actually cough and that cleared up whatever was going on and I finally took a full breath. I still don't know what happened, I wasn't choking on anything, I think my throat kinda...just decided to close up. I don't know. So needless to say, we kinda took a breather after that. So yeah... I choked on a penis. 

tl;dr Choked on a gigantic penis, thought I was going to die naked. ",TIFU by trying to deep throat a guy,554
Blue_Water,59,82,185amf,459,"I do PLC work for a large manufacturing company. Normally Im in my simulation lab or at my desk, but today my team was working on the shop floor on implementing one of our packages to a production line. We were working all morning, and I finished the nalgene I keep with me to stay hydrated at work. I needed to go piss, but we only had a few more clients to update, and we would be done. As we reached the last workstation, I excused myself and follow the signs towards the bathroom. Now, I gotta go, but not piss my pants gotta go. I walk in the bathroom and I see this round metal dish with a drain. It reminds me of the troughs you would see in a baseball/football stadium. Not thinking twice about it, I proceed to eridicate my bladder into this dish, and halfway through I hear a flush from deeper in the bathroom. I figure it's just from one of the crappers, so I continue on pissing into this odd circular urinal. I hear the sounds of heavy work boots as the deuce-dropper heads towards the door, he walks straight towards me with his sleeves rolled up, but he stops in his tracks when he sees what I'm doing. He proceeds to bust out laughing and says ""that ain't where your supposed to piss boy."" It's then that I realized I had just pissed in the ""sink."" The plant worker told his buddies, and now Every time I walk through the shop floor I'm followed by laughter. 

I think Im just going to call it a day and head home for the weekend. 


In my defense this is what it looks like: http://imgur.com/urP1Zan",TIFU by pissing in the sink at work ,541
mustangwolf1997,114,200,1darck,457,"Erm...

Yeah.

See, I like to watch videos on YouTube and drink tropical blue lemonade.

I also have a nasty habit of forming a vacuum with my lips and removing all the air from the cap when I'm done with the drink.

I fucking hate this habit.

Want to know why?

That's how you perform a Hickey.

Now I have a fucking Hitler 'stache style bruise on my lip, and I have to go to class with it in the morning.

Well... Shit.

------------------------------------------------------------------------------------

Update: You're all begging for pictures.

You're in luck. I got my camera to work!

Now I just have to find the USB connection cable before the end of my 3rd and 4th period classes, and you shall see the shameful hickey.

Edit, the reason this is a fuck up is not just because of the fact that I have to go to school with this hickey, but a hickey is the reason my girlfriend admitted to having sex with another guy, hence the breakup. Now I have to face the humiliation of her seeing the hickey and fucking up my day even worse.

Update 2: [You wanted pictures, HAVE THEM!](http://imgur.com/a/cM1ME)",TIFU and gave myself a Hitler Hickey.,657
thatsmypenis,62,110,1ibl3x,454,"So blah blah blah wind up with a used condom, and I throw it in the trash can in my bathroom. Fast forward a couple of days I notice some torn up toilet paper in my living room. Well I assume my dog got into my trash, so I check my trash can and find the condom mysteriously missing. So fuck, now I have to deal with my dog shitting a condom sometime soon. Fast forward two days later surprise visit from my mom while I'm out grocery shopping (she has key to my place). As it turns out, my dog (potty trained, but inclined to act out) decided it was a good time to shit in the kitchen. And of course, this wasn't just any shit, it was the condom-shit. I imagine it was like a little scrunched up bit of latex, crusty cum, and of course canine feces all mixed up like a meatball. So I come home to see my mom sitting in my living room, and all she says is, ""You'll never guess what I found in your dog's shit.""

Never been so embarrassed.",TIFU by putting a condom in a trash can,564
jivpop,153,144,1dverg,454,"I was at a park with my friend near water and we were hiking around and taking pictures. My phone case has a slot on the back to hold my ID, so when I set it down on some rocks, gravity took charge and my phone and ID went skittering down to the rocks below. The worst feeling is knowing exactly where it was but being unable to reach it. Maybe I'll be able to kayak over to it someday, but for now I have to live without my smartphone. I feel stupid.

This was taken seconds before http://imgur.com/hVzUqv5",TIFU by letting my iPhone fall off of a cliff,598
Felpeh,158,86,10qw11,448,"To begin, I am not the most eloquent speaker. I often slur my words without realizing it.

Anyway, my friends and I went to Red Robin for lunch today. Our waitress was a young girl, probably not a day over 16. She asked if she could start us off with something to drink and I, sitting closest to her, immediately said, ""Yeah, I'll get a freckled lemonade"".

She flinched a bit and didn't respond. I quickly glanced at the menu and asked, ""you do have those, right?"" 

She slowly nodded and scribbled down my order, looking somewhat ashamed. As soon as she took every drink order and left, a friend leaned over to me and asked, ""Dude, what's with the harsh language?""

""What? I didn't use harsh language.""

""You said you wanted a *fuckin'* lemonade. Those were your words exactly""

""Oh no, I said I wanted a *freckled* lemonade"".

""Oh, I definitely heard fuckin' instead of freckled"".

Everyone else at the table confirmed that they heard 'fuckin lemonade'.

Sure enough, about 20 seconds later the waitress returned with my drink only. And it was a regular lemonade, not a freckled lemonade. So she definitely heard 'fuckin' and I accidentally bullied her into serving me quickly. I profusely thanked her, and as she was walking away I decided I should have tried to clear things up. I shouted across the room, ""Hey wait, I said I wanted a *FRECKLED* lemonade!""

She quickly returned to the table and grabbed the lemonade. I stared at her with a friendly smile, expecting to laugh off the misunderstanding, but she stormed back to the kitchen without a word. It didn't occur to me that I hadn't cleared things up at all until my friends told me that I sounded like a major asshole. Rather than awkwardly trying to explain myself further I quietly accepted my newly freckled lemonade and left a $20 tip at the end of the meal.

There's probably a very confused waitress somewhere out there right now.

Tl;Dr: Young waitress thought I cussed at her and sent my perfectly fine drink back

Edit: A freckled lemonade is a lemonade with pieces of fruit in it that Red Robin serves",TIFU by unintentionally ruining a waitress' day.,534
laxerado1313,102,119,1a86dr,456,"So there I am, sitting in class, counting down the minutes until I get to leave this place to go home. Class gets out, begin to walk to the bus to head home. Suddenly massive urge to shit overtakes my body. No way I'm making it home. Rush to nearest bathroom in library building. Only open stall is the handicapped stall. In my head I'm thinking, ""perfect, more room for me to take this massive shit that's about to come out."" Commence defecation sequence, feel way better. Reach for TP and guess what? ITS ALL FUCKING GONE. Begin panicking, not sure what to do. Suddenly genius strikes, ""ill just rip out a sheet of notebook paper and use that."" Begin tearing out paper quietly so people around can't hear what I'm doing. Slowly crumple it to make it softer for my bumski. Wipe with it, feels like sandpaper but it had to be done. Think I'm home free, but Noooo, its not that easy. Pull up my pants, flush, and the motherfucker starts overflowing from poop and paper cloggage. Immediately leave bathroom, head straight to the bus.  Feel terrible. 

TL;DR ran out of TP, used notebook paper, clogged it, got the fuck out of there.",TIFU by shitting at school...,575
strongbadiophage,59,52,wxhu3,452,"I was fishing at a dock, hanging my legs over the edge so my feet were in the water.  I was fiddling with my sunglasses, no real reason, when they slip and fall in the water.  At first I watch them become less and less visible, thinking,""Hm I thought these float,"" but then my mind woke up and I realized I didn't want to lose those.  So I slid the rest of my body into the water and shoot my hand at them, keeping my head over the water.  I wiggle my hand around and feel them tap my hand, I fumble them, but manage to grab them.  I recovered them and put them up on the dock.  I'm wet up to the chest.

Oh shit.  My phone.  Was in my pocket.  At least it isn't an iphone or something.  I bought it for 25$ on sale.  About the same price as the sunglasses I bought on sale (sigh).  I try to dry it out, even blow dry it, but still, the thing doesn't totally work.  Buttons often don't work, has trouble turning on.  Without the buttons working I can't unlock it, sometimes the screen stays on forever so it depletes battery and makes it impossile to recharge.  Sigh.  So I just lay on the dock, letting my liquid embarassment dry out.

At least I got those damn glasses.

","TIFU: Dropped my sunglasses in the ocean, jumped in to save them.  May my phone rest in peace.",504
facetious_journalist,159,144,14f8u1,450,"Golf is something I thoroughly enjoy. It's something I'm fucking good at. Today marks my fucking Christmas - Friday the 7th of December. A date that's been circled in blood since last December. Company golf day. Ambrose rules can be a blessing, or in my case, a fucking curse worthy of Horatio Alger himself. When I pulled his name out of the hat, the feeling hit me like a cop killer in a court room.

Brian is a terrific fellow and a very flexible accountant - every company needs at least one flippant person behind a cheque book. But fuck me, the guy is fucking terrible at sport. He has the hand-eye coordination of a Panda Bear with an extra chromosome. The time he came to shoot hoops with us one afternoon was just *so* entertaining - because he wasn't on my team. Picture this. About 5'9' with very thin hair on top. Lethargic pot belly and the fashion sense of Jeremy Clarkson. His wife is a lovely homely woman with the *compulsory* degree in psychology - so she is quite smug. 

You can always tell the people who have a psychology degree because they'll tell you.

Nine in the morning. The dew is lifting from the first fairway - the kind of rising mist that you see in Lifetime movies. We pair up with my editor and Harry the sports journo. Harry is a fucking brilliant sportsman - state rugby player and Olympic swimmer. He does not fuck around when it comes to this kind of shit.

Our editor is old as fuck, by that I mean 60. He even struggled to toss a coin, let alone swing a club. Harry won the toss and lined up on the tee. 

It went a long fucking way - pushing 220m. Brian started clapping before he looked at me and stopped. This wasn't a game of tiddlywinks - this was golf. It was Brian's turn now. At this point in time, I'd assumed that he was quite handy at golf, so I wasn't worried. As he set himself up, I was chatting away to the editor about this typhoon in the Philippines overnight. That's when it hit me. What the fuck was he doing? Why the fuck is he holding the club like that? His leading arm had a worse bend in it than David Spade's popularity. It went a total of 30 odd metres and came to a merciless halt at the base of a groundsman's spine. 

You might ask why he was standing in Brian's ""killzone"". Well, he wasn't. He was at almost 90 degrees to the tee - and 30 metres away. In my time, I've done a fair amount of hunting, both large a small game. One disturbing fact about hunting is that animals and humans react eerily similar. The inital impact made him jump and run a few steps before collapsing next to the pro shop in furious agony. The screams will stay with me for the rest of my life. 

""Ooops"" said Brian as he turned around. Harry, the athletic bastard, was already half way there in a livid jog. The editor and I walked over to see if he was alright. Somebody called an ambulance as there was quite the crowd gathering around us now. The groundsman was quite old too - turns out his superannuation was lost during the GFC and he had to go back to work. So Harry notices that Brian is nowhere to be seen. 

His clubs are gone and his car is no longer where it was. 

This whole episode lasts about two hours, which really took it out of the editor so he went home in a cab. The rest of the company was almost around the front nine by now. Harry was fucking ropable - considering this stack of poor genetics we call Brian has totally fucked his day. Once the old codger was loaded in to the back of the ambulance, Harry and I decided to go to the bar and wait for the others. 

It was getting late by now and the first players through were filling in to the bar. I'd been shooting pool and taking the piss with Harry all afternoon - having a laugh. Two baby-faced policemen walk in to the clubhouse and ask around for us - to which some idiotic goon from the advertising department was more than happy to point us out.

""Can you two accompany us down to the station to make a statement?"" the taller cop asked.
""Can't we do it here?"" asked Harry.
""Sorry mate, we're going to need you guys to come with us to ID somebody"".

So now the day is totally fucked. Rabbit fucked. Harry and I get in the back of this police car, get stuck in traffic for an hour. I don't know about you, but if your five or six pints deep, you need to piss often. I couldn't exactly get out and piss on the road.

We get there, thristy as fuck and annoyed as Eric Bana in Munich. 

""What's this about, sir?"" I ask him.

""A hit and run""

""What?""

""There was a hit and run at the golf course this morning""

""But.. I.""

""Just step in here boys, I'll be with you in a minute.""

Harry and I shuffle in to a dark room with some DT's and a few lawyers. It's a fucking lineup. Holy shit! Level of engagement up ten-fold.

Out shuffle the men, one by one. No. Fucking. Way. It's fucking Brian.

""That motherfucker!"" said Harry.

""Did you see any of these men at the golf course today?""

""Fuck yes we did. Number four.""

""Cheers lads, you can leave now.""

A day ruined. 

I""m never playing golf with fucking Brian again.


**TL;DR: Played golf with a grown mongoloid who crippled an elderly victim of the GFC then ran a person over as he fled the scene.**
","TIFU by playing golf with Brian, from accounting.",594
Jay21310,142,99,ynn1l,454,"I meant it in a positive way saying that she was cute and I was so glad she wasn't a ""10"" because if she were she would be high maintenance and stuck up. I'm not attracted to those types of girls.

She straight up asked me if I really thought she was a 6 or a 7 and I was trapped. Either I say ""no honey, I think you're a 10"" and she would rant about how it's a lie and that's not what I really thought, or I tell her the truth and she rants anyway.

I told her she is a 10 to me because she is exactly what I was looking for. She didn't want to hear any of it.

TIFU.

Edit: Wow, I've never seen so many different opinions on Reddit. For the record, I have officially smooth talked my way out of this. Right after all this happened, she went to work for 5 hours, cooled down and when she got back we had another talk. I told her that I didn't mean it in a negative way and she really was perfect for me. I told her that I couldn't picture me with anyone else, gave her a kiss and I just complimented her a lot. So far as I know, she's not worried about it anymore.",TIFU by telling my friend on the phone that my wife wasn't a 10. She is a 6 or a 7 but she has a great personality... and she heard me.,553
HuckItDeep,39,126,1f653z,446,"Background: I have dislocated my left shoulder 10 times.

Today I was lifting with a friend and I decided to try and do a pull up. I was going throughout the day doing just fine, then we get to the part where I am supposed to do 10 pull ups. So I grab the bar and I am using the machine where you can stand on the weighted bar that helps you do a pull up. I realized that I had set the weight way too low, but it was too late. I dropped down too quickly and I can hear my shoulder just crunch and feel it move out of place. So I end up just hanging from this pull up bar with my right arm and I am just kind of dangling there while my friend looks on thinking that I just missed the bar with my other hand. In the end they bought me to the hospital room and give me some lovely things that made me feel all happy inside and they made my shoulder all better again. The End.",TIFU by doing a pull up,572
HeartlessSkeleton_,149,166,y17qi,451,"Let me just go ahead and say here that I'm addicted to these fuckers.

Ever since I was a tot, I've loved Capri-Suns. To me, they're urine from the angels. I cannot get enough, plus those pouches are so damn TINY.

My dad decided he'd get me a box. I was too busy drooling over the box to catch whatever he said, so I shrugged him off and said ""Yes Daddy."" Like I always do. And that, ladies and gents, was the fuck up.

He left to go somewhere (like I said, I wasn't listening) and I began pouring the delicious liquid down my throat, going through about two pouches minute. Like any Capri-Sun lover, I had that FML moment when my hand touched the cardboard at the end of the box as I reached in for another pouch of the good stuff. As I finish my last pouch, I hear my dad pull up and realize that I here the voices of little kids outside. That's when it fucking sank into my blonde skull: My ten year old cousin was having her birthday party today.
At my house. 

My dad comes in followed by seven little kids, and by now my only thought is ""This is how I die."" I'm trying to think of an escape route but too late, he sees the empty box, it clicks in his brain, and I swear to God, he changed colors like a fucking chameleon.

He told my cousin and her friends to go out to the backyard. He grabbed my wallet out of my purse and left to go to Wal-Mart.

The way I see it, it was a win win on my part. I got tons of juice and my Dad had to walk around the grocery store with my pink wallet with cartoon cats and baloons covered in it.

TL;DR: Didn't listen to dad, drank Angel urine, was robbed by my father.",TIFU by drinking an entire box of Capri-Suns,617
[deleted],88,109,1kzmia,444,"So I do theatre and I was recently cast in a one-act play. In said play, my character is on a date with another girl, and we're required to kiss sensually a few times during the play. The girl that was cast as my date is...shall we say, quite homely. She's quite large and doesn't dress right for someone her size, and she also has gross teeth. It is very difficult to act as though I'm attracted to this girl, let alone make out with her. So I was lamenting my trouble to a co-worker today. My co-worker was laughing along as I'm describing the horrific experience of kissing this girl, so like a fucking professional stand-up comic, I bust out some material about how bad her breath is and congratulate myself on my charm and wit. But then said co-worker says 'hey, my best friend does theatre and she's in a one-act too'. Immediately I start shitting myself internally, but I try to maintain my composure and reassure myself that plenty of girls do theatre. But co-worker pulls up the Facebook of her best friend. Sure enough, and to my horror, it's the aforementioned homely girl who for the past 2 weeks has been the bane of my existence. I somehow manage to maintain my poker face and say ""oh, that's cool"", all the while knowing that in two weeks when we perform the play and co-worker is there to support her bestie, all will be lost.",TIFU by telling my co-worker that her best friend is ugly,553
ChildishSerpent,46,137,1qovdm,443,"So, this morning my schedule and my wife's schedule have overlapping time at home from work. I work nights, she doesn't have to be in until 11 am. 

So, I'm a little tired from working my shift, but we haven't had sex in a little while, and I'm kinda horny, so I start going in for the kisses and the touches and the sexy times.

I happen to also have a slight pre-cold, and after a few smooches she pulls back and says, ""you know, this would be a lot more attractive if you didn't have a booger in your nose."" 

At that point I realize that our noses were touching while we were kissing, and she has some (of my) snot on the tip of her nose. I make the big mistake of pointing it out. 

""Ewww! Ew ew ew"" punctuated with laughter. Laughter? Perhaps I still have a chance! ""Well, it's not that bad..."" Ohgoddon'tfinishthissentenceshutupshutupshutup. ""I mean, you get my semen in you and that's also mucous."" 

Needless to say, that's why I'm laying here typing this up for your amusement instead of getting laid. You're welcome. 

TL;DR: Trying to put on the moves I get snot on wife's nose, try to backpedal by pointing out that semen is also basically snot.  ",TIFU by snotting on my wife's nose.,580
Im_not_gay_dad,166,143,1ponbs,440,"So I'll start by saying I'm totally straight. Me and my dad usually have political arguments. Daily actually. Well often it gets down to views on human rights. Gay marriage. Well when it gets down to this I usually flip shit. I admit, I get out of control but he literally says shit like, ""Well if we let the gays marry, then people are going to want to marry their car!"" Actual dad quote by the way. Well anyways today, when I went off, I said, ""If straight people can marry, why can't we?!"" Shit got silent there. I tried to correct myself with, ""they,"" but he just said yep and walked away. Needless to say he's ignored me for the rest of last night. 

tl;dr: Tried to defend gays to conservative dad, told him I was gay. ",TIFU by telling my conservitive father I'm gay.,583
slopsicle,86,102,1ah168,446,"Today, it's 2:30 AM in the morning me and my friends go to waffle house, and indulge in some glorious waffles and other breakfast feasts.  Feeling satisfied from the full course meal I just consumed I decide to sleep naked in all its glory and fall asleep.  While sleeping I have a dream of playing GTA IV for some reason, and it's wierd cause I've never played that game in forever.  Anyways in the dream i run a stop sign and end up getting shot and killed by a cop for it.  Just keep saying in my head ""Why the Fuck did he shoot me?""  

Next thing I know I'm awake with my throat burning, and i'm not breathing.  Jump out of bed still not breathing and gasping for air to no avail I run through the house to my mother to aid me.  When I get to the kitchen fully naked I see my whole family enjoying Sunday dinner, and not just my family today.  My grandmother and two of my aunts, and uncles are there too.  I just keep one hand on my dick while pointing to my throat and gasping for air. My mom asking freaking out with the phone in her hand debating to call 911 and asking me ""what is wrong?"" but I can not reply because of the lack of breath I am currently getting. 

Finally the burn in my throat subsides and I can breath again. I immediately say ""I couldn't breath"" really loud and run to my room.  My mom pursues me in a chase to my room to see if i'm alright.  I then get dress and bring myself to the dinner table to eat with my family, but the dinner is awkward because one of my aunts will ask ""Are you alright? We don't need to go to the doctor do we?"" and a minute later one of my uncles would be talking about how he was immersing himself into the glorious chicken feast before him and when he looked up all he saw was penis. It is a lunch that will be in my family for ages, if I just keep breathing.

TL;DR :  I woke up not being able to breath and ran into the kitchen naked with my whole family eating dinner.",TIFU by running into my Sunday family dinner naked.,548
mast3r0r0m1s,74,104,1aitg5,442,"First, happened yesterday. Secondly, I'm sorry if you had to clean up vomit yesterday by the check-outs somewhere in Canada.

So I just got back from vacation and I went through a couple time-zones, apparently the jet lag and being exhausted will make you sick or something like that. I didn't know that, anyways got up about 4 hours after we got back as I had to furnish my room. I felt like shit but I usually felt like that when I was on vacation so I just thought as soon as I ate it would've gone away, wrong.

We were walking through Ikea and I knew it wasn't going to end well but I was trying to just make it through the store than I could do it in the parking lot. We got to the self-serve furniture area and I felt it, it was coming, I was running to the washroom but I knew I wouldn't make it, using my hand to try and hold it in (Btw, doesn't work, thought I would've learned from my other bad experience), I vomited in my mouth and I was good, just had to swallow it and continue on. Was only 30 seconds away, still trying to swallow it but I felt the next rush come and I knew it was to late, went all over the place including my face.

I looked around and no one was looking at me so I just pushed my coat up to try and cover my face some and rushed to the washroom to finish it off. 

Apparently people stepped in it though so that was pretty funny.",TIFU By Puking In Ikea,546
Engineer_Man,206,90,17miq6,441,"I usually have the end of day run down with my wife and kids at the dinner table, a time to catch up on what happened in their day. Normally it consists of my wife complaining about things at her work, my son replying ""I don't know"" to questions about what he did at school, and me recalling all the funny crap I hear at work.

So today, our office secretary comes back from some well earned leave. She comes up to me and and hands me her phone with a picture of a girl on it, a FB profile shot. It looks remarkably like her 17 year old daughter, who, in her own right is quite stunning. I will admit I admire, but will never, ever, go anywhere near there, ever. It turns out that her (the secretary's) father left early in her life, and went about his merry way. On his merry way he managed to marry another lady, the same age as his daughter (the secretary), and have a child. The photo she showed me was that of her 15 year old half sister.

So back to the dinner table I was recalling this story, and because my body decided to have have a perfectly timed, and near fatal brain fart and shut down my logical thinking and filtering capabilities, I explained to my wife that my secretary's 15 year old half sister is as hot as her 17 year old daughter. My wife promptly stood up from the dinner table and hasn't said a word to me since.

Reddit. I dun fucked up a big one.

**tl;dr - I explain to my wife that my secretary's 15 year old half sister is as hot as her 17 year old daughter.**



EDIT: Well she is talking to me again, and I attempted to explain what I meant, and now she is cool. I think the age and bluntness in which i said it (poor choice of wording) sort of made for a shock.

 Interesting to see both sides of this argument being so defended vehemently. Yeah, it was a combination of poo thing to say and timing, but at least I was being honest.


EDIT2: I think given some of the discussion I need to clarify. My definition of the word ""Hot"" is about physical features. It is an objective view. It has nothing to do with physical or sexual attractiveness towards the person. I am confidently heterosexual, but I can still comment on a male being hot if I believe they are.

Some people are naturally born with good looking faces/bodies/features. Some people work hard to get theirs through working out/gym/makeup/surgery. I can appreciate the way someone looks without having the any sexual desire towards them.",TIFU by being TOO honest with my wife.,531
throwawayseriguadfga,93,170,1nh4c1,441,"She's not pregnant. She took two tests and she's not pregnant. I had a trusted friend with her while she took the tests because I was worried she'd lie about it. I'm using a different account because I forgot the password to my last throw away. Thank you guys so much, those three days were probably the worst days of my life. The sex we had was protected by the way. I forgot to mention that in the original post. Everything's fine now and she's currently out of state. I'm so incredibly thankful that she wasn't pregnant and also thankful for all you guys commenting. I love you guys.

TL;DR: She wasn't pregnant. I'm happy. You guys are awesome. Forgot password.",Update: TIFU by ruining my life,611
QueenPoopbutt,94,166,1luhwv,440,"I was driving down the street with my bf the other day, when he started to fart. He did it a few times, and I actually had to beg him to stop. ""You can not stop THE BEAST!"" he screamed before letting another fart.

I was overwhelmed. The stench of onions and sewage filled my poor car. The smell started to really get to me, and I began coughing. I coughed, and coughed.... aaaand the dam broke. I was on my period, and it seemed my coughing fit had brought on the crimson tide.

My driver's seat is ruined. He promised me that he'll roll down the windows from now on when he has a fart attack.",TIFU when my bf's farts triggered a period,606
[deleted],134,95,15xrn3,439,"Last night actually- drinking this fine ass rum called The Kraken with a friend. There's nothing wrong with this so far. 

There's also a girl at work who i've been interested in for awhile.

 Also, nothing wrong with that. 

So, five or seven drinks in I received a Facebook message from this girl. Definently no problem with that. Except ..the blacking out. 

That was a problem. Now if I just didn't respond, that would be great. However, historically, whenever I blackout I ALWAYS pull some sh*t that comes back to bite my balls. Now I mentioned a facebook message. I don't know what possessed  her to say this, but at some point in the night she said 'if we're 25 and single, let's marry. I promise not to get complacent with the sex.' 

Awesome. 

Fast forward to the morning. I have succeeded in getting a terrible headache, pissed on myself (and my friend's couch) and a terrible stomach ache. I reach for my phone and suddenly the severity of the situation hits me. I hit the social networks hard and found that not only did I make no sense in my replies, but I also called her for a conversation that supposidly lasted a minute. I turned to my friend and asked him if I called someone. He just laughed. Fast forward to now. Saw her for the first time since the incident. at work. Yes. Work. Where I have to see her at least 80 hours a week.

Me:""Hey? Did you get my messages?""

Her:"".....""

Me:"" ...I fucked up huh?""

 She brings out her phone and hits voicemail. The horror of listening to oneself verbally dig their own grave is a situation I haven't had to deal with before now. The added effect of starring straight into the eyes of your fail is something I wouldn't wish on anyone. Imagine my eyes as this ensues.

Me:""Whaaaat? Dis fwaking beeotch deedn't pivk up da fone? Da fwak is this, offerin dat pus puss and not andswerin. She lawky I dont geet ovr dare and pop dat funky munky and bust all over dem puuuuuuurky boobanies...what? What da mean the...oh...shit....OH FUUUUUUUU-""

I stare.

She stares.

I fucked up today.


EDIT: If you like that, or were slightly amused let me know. I plan on releasing a saga of drunken misadventures due to the fact that I have often made an ass out of myself and apparently, the internet eats that sh*t up.

Edit 2:  Got a text from my mother today. Linked to this page. She recognized my name as my ps3 gamertag. She's dissapointed and i'm impressed she's a redditor
",TIFU by keeping my phone while I was drunk,534
ironlassie,306,149,108u56,440,"* *If you find bad language offensive:  You will not find this amusing in the slightest, but I will continue regardless, just please, sweet jesus, learn from my fuck up!*

So, I live with 3 friends (all white). One of them brings over a friend (who is black) and we're all in the living room/kitchen making/eating food. 

I should explain at this point that we're all very close friends (except the visitor who only one of us knew well), and we insult each other in the most vulgar manner, but only ever in private at home - You know what it's like when you're so close to someone your terms of affection become creative insults; the worse the insult, the greater the affection displayed. 

Anway, my housemate and I were joking around pretending to argue. She called me a ""shit-for-brains cunt bucket"", which is pretty much equal to ""I love you"", then went into the kitchen. I felt the need to step up on the insult scale as a reply. 

I cannot emphasise enough that this would normally have resulted in hugs and friendly banter.  

I chose to yell ""FUCKING NIGGER BITCH!"" into the kitchen with as much hatred and disgust as I could muster. 

What I failed to realise was that my housemate's black friend was in there. She wasn't familiar with our insult love at the time. 

I heard the hysterical laughter from the intended recipient cut out just as the door swung shut, evidently having just realised who had heard it, followed by her running from the kitchen looking horrified, whispering ""shitshitshitshitshitshitshitshit!"" 

... my housemate's black friend then slowly came out of the kitchen, with tears in her eyes, saying ""why the fuck would you say that? You don't even KNOW ME!"" before storming out of the room. 

I have never felt so awful in my entire life. 

We ran upstairs to find her, and she was fine after a very awkward apology and explanation. She's now clued in on the 'insult love' situation and thought it was hilarious once she understood ... but I literally have never felt like such an ignorant, evil, hideous human being in my life! 

**TL;DR: Always lovingly insult housemates, one had a black guest, forgot she was there, accidentally dropped an N-bomb, visitor thought it was directed at her, apologised, felt awful. All is well now.** 

* **Edit 1: I've definitely offended a lot of people with this post, so I whole-heartedly apologise for that. I need to put a little something in here to explain that I said what I said without thinking and with absolutely NO racist or genuinely insulting intent whatsoever. I am NOT a racist person and I do sincerely apologise to anyone who has read this and thought the opposite. I've tried to explain more in the comments but I've pretty much just made it worse so I'll quit while I'm ahead.**

**Again, I am genuinely very sorry to anyone I've offended and I cannot emphasise enough that there was absolutely no real racist or in any way malicious intent in what I said, for which I apologised profusely to the girl involved.**

* **Edit 2: Apparently my TL;DR was TL;DR so I shortened it slightly.**",TIFU by accidentally being an evil racist. ,589
meowcat789,108,79,whg7s,435,"Yes, I am a woman. I was trying to help out, but I shall now stick to making sandwiches. ",TIFU by spending 30 minutes flattening grass while the mower's blade was turned off.,514
monotoko,74,96,1i356r,434,"Well, today has certainly been fun. For those of you who don't know I'm a lone sysadmin, I take great pride in my job and hate it when the spammers decide to abuse my bosses service. It's often me and the servers, I like it that way, but sometimes you need someone to watch over your shoulder and say ""The fuck you done that for?"".

On this fateful day I decided to build the best, automated spambuster ever in the entire universe, it was a genius idea! It would scan peoples websites and straight up remove the ones that were obvious link spam. A few hours of coding later I decided to test it...

This was my first fuck up, I accidentally uploaded and ran the script on the live server. But that wasn't the worst, oh no it wasn't, see - I think I'm an excellent coder, do I need anyone to look at my scripts? Especially in a language I only just started learning last month? 

Hell no! - but sometimes even the best of us fuck up, and in one fell swoop the entire 400,000 strong user base was deleted. Alright, now I'm panicking a bit, because 400,000 was far more than I expected, but it's still good, it can be saved! - or not...my third, final, and in my opinion biggest fuck up was forgetting to turn on the automated backup system a few days ago. Oops.

Yes Reddit, today I truly fucked up, I'm currently waiting for the restore of all sites from a week old backup after being chewed out in a most unprofessional manner by my boss. 

Update: Yes, you're all calling for me to be fired - Yes, I probably should be. HOWEVER! I was hired known to be inexperienced, and placed into this position with a load of coders and the last sysadmin didn't really explain the procedures.

Update 2: I got 98% of sites back online, to clarify this was supposed to be run on the test server. Server names very similar, ran it on the wrong one. I'm not stupid enough to straight out run it on live without **intending** to test it first.","TIFU by wiping 400,000 websites from the internet.",530
I_Already_Know_OK,151,120,10maf7,434,"I made it out of the friendzone and into the endzone with her.  She is 36, a solid 8/10, funny, smart, and really my best friend.  I am 39, 5/10 , and a balding ginger (think a 6 ft version of Powder).
  
When we first met, I asked her out, but she turned me down.  We still really enjoyed hanging out, and became the closest of friends.  She knew all my secrets, and I knew hers.  I really was ok with being only her friend, but she was just so funny and cute, I couldn’t help but hold a small torch for her.  It didn’t keep me from dating other people, as I just marked it up to “see you next lifetime.”  

All the while, she was dating too.  I would meet these built, tanned guys with full heads of hair she would date, and these were good looking guys.  I’m not fat (6ft, 200lbs, 35 waist), but did not look like the guys she usually went out with.  I figured she had a ‘type’, because we all do.  She just happened to be my type, but I don’t have that kind of luck.

Until one day, I guess I did.  

She invited me over, sat me down, and told me she had fallen for me.  It didn’t take a lot of convincing to get me to admit my own feelings.  Best of all, it wasn’t weird.  It was an easy transition from BFF to BF.  
…..Did I mention the sex?  Mind blowing.  Epic.  Statues were erected (giggity) in our honor.  Remember when I said I knew all her secrets?  That included the one about the fact she had never had a vaginal orgasm from intercourse.  She hadn’t, until now.  Reddit, I walked, nay, I floated with pride at my sexual accomplishment.  It was quite a boost for the guy who felt he had sealed the deal with the girl who was out of my league.

Now, on to my mistake…

We are 7 months into a great relationship. I was sleeping at her place in the afternoon.  (Third shift daysleeper)  She was out running errands.  I knew she had a diary, and she had even mentioned in her initial statement of romantic interest that she had been pouring her heart into the diary in making her decision.   The diary was in the nightstand drawer.  I had always been curious about what she had written at that time, because I am an egomaniac and what is better than having other people talk about you?

The diary entry from that day had a lot of the same things that she said to me that day.  The fact she did not want to ruin a great friendship, but wanted to take the chance since everything else about us worked.  She told her diary that feelings had begun to emerge that she didn’t expect to feel about me.  

Until this point, I am enjoying my playful violation of trust.

Then I read, “I love him, but I am just not attracted to him AT ALL”.  AT ALL was written in ALL CAPS.  It might have even been underlined.  

My heart sunk.  I love this girl.  She is amazing.  We never run out of conversation.  She is amazingly clever.  She is a sex god.  I found my best friend and lover in the same person.  She is beautiful, but she is not attracted to me physically.  

I have decided that I am not going to bring this up, because it does start with a pretty outright violation of trust in reading her diary.  I also don’t want to think that she is settling for me.  She is amazing, and I want only the best for her.  I just wanted to believe it was me.  

Edit:  First of all, thank you all.  I needed some perspective.  

Second, the entry I read was from three days before she told me how she felt.  A few posters mentioned that her entry was, to paraphrase, a snapshot of how she felt that day.  It may not be how she feels now.  This is what I hope to be true.    

Edit 2:  Wow!  I know know the irony of Throwaway Karma.  Many Redditors have brought up working out, and making sure I am doing it not just because of her.  My weight loss has always been for me and my health.  The side effects have been great.  I also have been dressing to better reflect my new body type.  My girl had helped me with this even before we we dating.  

I have also taken a lot of comfort in the idea many of you put forth that the diary was her unformed thoughts.  I even thought about my own thoughts that would have changed from that time.  ","TIFU I read her diary.  While she loves me, she is not attracted to me AT ALL ",554
django_rechained_,38,100,1pjfey,432,"Let's make one thing clear. I saw my opportunity, and I took it. I have a friend who recently broke his leg playing baseball (a rather valiant way to break a leg, if you ask him) and I help him get around when I'm with him. We were taking an SAT prep course, so I help him get situated and wait with him for other kids or a teacher to come. I can't remember why, but I walked away from the table at one point. 
As I walked back to the table, I see his backpack sitting on the table. ""Go take his backpack, he can't chase you!"" Good idea, right? Like I said earlier, I saw my opportunity, and I took it. I ran to the table where he was sitting, jumped on the table, and reached for it. As a glass half full guy, I would like to mention that I got the backpack. 
That being said, I knew I had to get out of his range. I started to slide off the table, and only one of my feet hit the ground. The other foot missed, cause my leg to bend in such a way that my knee dislocated. As I hit the ground after hearing the ""SNAP"" that dislocating your knee makes, I remember two things.
1. Seeing my friend laugh as I fell
2. Losing grip of the backpack. It fell on my face.
In the ER, got my knee reset an hour ago (it took 20 minutes). I will be on crutches for a while, but I won't live this down for a long, long time. ",TIFU by bullying a cripple,532
Djcalied,93,133,1e51eu,436,"Simply doing some manscaping on the chest in the shower, noticed this weird black hair sorta by my nipple (I'm blond), so engage full retard mode I swipe over the hair real quick and.... BLOOD LITERALLY LACTATES OUT OF MY NIPPLE. I start saying oh fuck oh fuck... Then the delayed stinging pain sets in, and 2 hours later it still stings. For clarity I nicked the actual tip of my man nipple... :(

Please note that this cut looks like a got poked with a needle, yet so much fucking blood came out! It finally scabbed up and I'm thoroughly embarrassed as everyone is calling me a wussy because its so small. You try shaving your nipple then talk to me, fuckers.

Tldr- I can lactate blood","TIFU, cut my nipple shaving",569
katoso22,78,81,1cjnk9,433,"Thought I would make my sleeping situation better with a bit of freshing up.  Little did I know the horror that awaited after the spin cycle.  A goose was murdered here!  The casing was obliterated feathers, feathers, all over the room.  The sick anticipation of waiting until my wife sees...

Update I think I have figured out the photo thing.
All cleaned up as well.

http://imgur.com/JT7dbNo
http://imgur.com/16ys66L
http://imgur.com/RhzmALr
",TIFU by washing a pillow.,514
vomitstrain,75,99,14jmd1,439,"I had just had a big lunch and I really needed to go, but my colon thought otherwise. I ended up pushing so hard that I vomited all over my pants and shoes.",TIFU by trying to poop so hard I vomited.,538
Fecesofwar,63,90,1jw8gy,434,"*I've posted before here. Karma's a bitch.*

A couple days ago we were set for a big rainstorm, so I decided to ride my bike. It's always nice to get out in warm rain. So I went out for a few miles up along a forest preserve path, and once it started drizzling, I turned around to enjoy the rain. And that's when I decided to piss.

I've done this before - when it's just pouring rain, really drenching you, there's a terrible pleasure in just taking a leak. It's the same as doing it at the beach I suppose. And the water just washes the sin away. I've done it while walking in rainstorms and never had a problem. Now, kind of as a dare against myself, I decide to do it while riding my bike.

So I start trying to overcome centuries of evolutionary instinct, convincing my body that I'm really okay with this. My body gives me about a minute of ""You're sure about this?"" resistance before taking it waaay too far. I feel the moment coming, and I stand on the pedals, coasting, feeling exultant, when it happens.

Karma, karma everywhere. My body opened all the floodgates, and right after I had started pissing, I shit. My ass just opened with foul, black, post-drinking soft-serve shit. It was more like bursting a water balloon than dropping a load, and it was over in a moment. 

I actually didn't fall or crash. I just kind of coasted forward, gently applying the brake. I thought ""Maybe it was just a nasty fart?"" but visual observation discounted that hypothesis. My right leg, my bike seat, my shoe were all victims. 

""Okay, okay, it's raining. I just need to pull over and hide off the path for a bit."" Nope, it stops raining after a few minutes. Home is miles away, and while I can stay in the forest preserve for a little while, I eventually am going to go into pretty trafficked areas. So I decide to sacrifice my shirt to wipe things down. It is destroyed in moments, but I think it was worth it, as I can at least distant or casual observation.

I get going again, and now the smell is getting to me, so I decide to take a detour to stop by the river that crosses the trail. I ride down and out of the way to find a spot where I'm 95% sure I can't be seen by passing looky-loos. I find a suitable shame corner and dismount.

I pull my shorts and underwear off over my shoes and wade into the water. I give the clothes a good shake and rinse, then squat in to wash myself, paranoid about about fish and turtles snapping at my business. As I'm wrapping this up, I notice a male deer on the other side of the river, just watching me. 

Shorts go back on, and then I give my shoes and socks the treatment. Now it's time for my bike. I pull it into the water with me and let it rinse for a while, which gives me some time to think about my life. Once I pull it out, I realize I'm not confident that my fabric-covered bike seat is safe.

I remove the bike seat and start shaking it around in the water to make sure it's safe, only for it to slip out of my hand and sink after floating several feet. This is when the deer stopped watching and just slowly walked away. I tried to find it, but after a while I just gave up. I ended up riding home, standing on my pedals the whole way.",TIFU by trying to piss while biking,524
sotheniwaslike_wut,45,58,wnz4l,435,"It was recommended that I post this in /r/tifu as well (originally posted in /r/AskReddit).

When she approached the house, we all hid and whatnot. Right as she had her hand on the doorknob, I yanked it open, which was the initial startling. We flipped on the lights and yelled ""SURPRISE!"". She hobbled backwards a little out of shock and fear, and then fainted, smashing her jaw on the concrete steps leading up to the house. We had to rush her to the hospital and throw a small, non-startling party in her hospital room. She also learned that she will have to have surgery to fix it. 

I fucked up, Reddit. I really fucked up.

**Edit:** Wow! I did not think this would get so popular. Thanks for all your responses!","YIFU: Yesterday some friends and I threw a surprise party for a friend. When we yelled surprise, she got so scared she fainted and broke her jaw and ended up in the hospital. ",493
Fusrohduh,76,50,qgsfy,434,"I work as a police officer, and I was working security at a large multi school function today. Approximately 3000 people from surrounding schools were in attendance for multiple activities. 

ate lunch, needless to say epic dump proceeded to commence after. As a uniformed officer, shitting is complicated, involving removing all gear and duty belt. 

in the public bathroom I'm removing my gear and sat my firearm on the shit tickets dispenser, do my business and proceed to reassemble my outfit when my supervisor called me to the far back parking lot, so I hastily gear up and head that way.

Halfway across the large parking lot I felt my stomach clench as I reached to adjust my holster...AND THERE WAS NO FUCKING GUN IN IT! I had left my loaded weapon in a public bathroom surrounded by thousands of students. 

Long story short I sprinted back to the bathroom and by the grace of some deity I dont believe In my gun was still there.

That could have been the most monumental fuck up in the history of the department, the end of my career, and personally I am completely ashamed at my lack of focus and firearm safety....but all I can say is today I fucked up.","-Tifu, almost potential lock down of school with 3000 people visiting.",484
fora-mejora,64,101,1b828m,427,"I had my electronics class today and my professor gave us an assignment where we have to make something from nothing. Nothing being the broken computers and other electronics that we could find in our workroom. 

My group decided to build a boat, because honestly, hot gluing a block of styrofoam to a CPU fan is the easiest idea that any of us could think of, but we wanted to get a bit more creative. We found a couple of speakers in an old bin, and one with the audio output still intact with an auxiliary headphone cable, so we decided to play around with them a bit and see if we could mount them on our boat. 

Before we began work on them, we had to see that they worked, so I took the speaker with the intact audio output, plugged it into my phone, hooked up the speaker to the oscillator, kicked it up to five volts, and started playing a song on my phone.

Little did I know that the current would travel through the speaker, up the auxiliary cable, into my phone's audio input where the battery beyond had a maximum load capacity of only three point eight volts. 

I literally held my phone in my hands as the voltage fried my motherboard and the screen turned black, never to turn on again. 

**TL;DR: I bricked my phone by giving it shock therapy with an oscillator.** ",TIFU by testing a speaker. ,528
catchupwiththesun,70,107,1d0z50,430,"So this literally just happened. Its mid-day, neither of my roommates are home (or so I thought).
Perfect time for some ME time...right? wrong.

Let me preface by saying I live in an old house, our doors are old and leave gaps between wood floor and door, so everything echos. EVERYTHING.

Anyway, I'm getting kinda horny, so I shut my door, pop on my headphones and get the going. I'm getting really into this video I'm watching. Neglecting to notice that the top of my vibrator (the part that screws on that holds that batteries in, and can adjust the intensity of vibration) is broken, and if it is moved slightly the whole top pops off. 

At this point I'm literally on the tip of orgasm, I move my hand, the top pops off and the damn thing SHUTS OFF PEAK ORGASM. Now, ladies. I really hope you have never experienced this abrupt halt of stimulation, but if you have, you can attest to my actions.

I twitched trying to get the top back on and fell backwards quickly in my computer chair, far enough to pop out my headphone jack which fills the air with moans and groans of the skanky sexcapades occuring on my laptop. 

In what seems like hours I managed to get up and turn the full blast sounds of pleasure off.

It's beautiful out, the windows are open, I live in a row home and can hear my neighbors as I type this...shit. It's okay, at least no one is home. I open up my door and my roommate is in the bathroom which is connected to my room, and would have been outside my door while this all happened. She had been napping in her room the whole time. 

Ugh. It's fine though, she would laugh at me, I'm more sad about ruining the orgasm.

TL;DR - Ruined an orgasm and the neighbors/roommate most likely heard the sounds of freaky sex coming from my room.

edit: words",TIFU by masturbating with a broken vibrator,537
PunkDoesntFit,113,173,1lghlz,432,"On Thursday, I was accepted into college so I decided to have a party like anyone would. I got a few friends over and so the mayhem began.

Smashed a bottle of Jack in the space of an hour, topped off a Bacardi and coke, 80/20 and dropped about halfway through whatever I drank next. Needless to say, I was out until 12:00pm the next day. 

I waddled over to the kitchen to get some dry biscuits in an attempt to stop myself from emitting viscus death all over the house and just as I did a perfect 120 pivot to face the fridge only to see the hand-drawn notice tacked to it with a magnet that was once a squirrel but now only his body and one arm.

""Hairdressers at 1:30 FRIDAY""

I could have collapsed, I could have convulsed, I could have done both and left myself strewn on the cold floor for my roommate to discover my frozen corpse but no.

I couldn't help but feel that not attending this appointment would be a grave mistake, after all, college means new people and this hair was three months behind a Vietnam vet, 3 months in a spider-hole so, it must be done. A challenge that I have accepted, as god as my witness, I will get this hair cut.

And so, with a quick freshen up and some new clothes, I speed off out the door. 12:50.

Drive into afternoon traffic, barely holding sick down. 1:12.

Pull up on the parking lot, a block away from the hair dressers. 1:27.

Hoist myself through the doors, finally here. Vomit at the ready. 1:32

and so, the empty hairdressers greeted me, this would be an in and out job, nothing more, nothing less. Quick and clean.

The woman at the reception desk comes up to lead me to a chair after a few minutes of waiting and just as I open my mouth to say 'Thanks'. A storm of regret, Jack, Bacardi, Coke and dry biscuits topples out like Niagara falls, sliding down her dress, the majority of it on the floor and her shoes and then I slump back into a stationary position only for her to do some sort of Patrick Stewart quadruple take. I'm freaking out, she's freaking out, the other hairdresser is in a limbo of anger and laughter and I just lift my hands up in defense and walk at a fairly brisk pace backwards while saying sorry all the while. 

Still haven't got my hair cut.

TL;DR: I empty the contents of a college-acceptance party all over the hairdresser and run off.

Edit: I didn't add it for the overall flow and comedic effect of the story but my roommate drove me up there, I did not drink and drive. ",TIFU by going to the hairdressers drunk,605
[deleted],235,75,wi551,428,"I don't know about everyone else, but I like to be notified of any doppelgängers. Apparently, my gf does not. Apparently, she's had a secret fear of all of her past boyfriends, and me falling in love with her sister, and this just proved it was going to happen. She's been crying for a while, and won't talk to me.

I also forgot to mention to her that I wasn't having ""me time"", I just forgot to unsubscribe from /r/dirtysmall.

I feel like the king of all fuck-upery.",TIFU by Telling my girlfriend I found a pornstar that looked exactly like her sister.,503
davver,37,95,1gxf8y,426,"So about a week ago, I used my new electric shaver to shorten my hair. My uncle saw that I can do it pretty well, and wanted me to shorten his hair as well. Being a good nephew, I accepted and proceeded to do it using my new shaver.

Now here's where shit *starts* to hit the fan- I started shaving from the top, and then I realized something's not right. I accidentally forgot to change the length on the shaver, and I ended up giving him a number 1 haircut (a 0 will make you bald). I already shaved some of his head, so I couldn't just change it back to a higher number, because it will look terrible.

But oh no, this isn't all. My uncle had cancer around 3 years ago and he's still traumatized from the cancer, hospital and all the things they had to do to in order to get rid of the cancer.

He now looks like he has cancer again thanks to me. TIFU badly, reddit :(

**TL;DR:** Accidentally made my uncle looks like a cancer patient again.

***Edit: to those of you who're saying that 1 is far from bald: his hair is white and sparse. I'm not saying that people with #1 hair length look like cancer patients.***
",TIFU giving my uncle a haircut.,521
jdmf87,90,75,y7ilh,421,"Told my boss, in passing, I was thinking about going to grad school ""eventually"" and that I was ""feeling out long-term options."" Now they are looking for my replacement and taking away responsibilities because I'm a ""bad investment.""

I'm not going to grad school for another few years. ",TIFU by mentioning I wanted to go back to school,496
SkyWulf,101,118,1qpfvi,420,"So, long story short, these bunch of crazy assholes at my college start following me after class. Whispering to each other, staring at me, basically making me feel nervous as fuck. Naturally, I assume they're going to try to rob me. So I walk faster. They split up and one guy is left following me. He starts yelling at me, saying shit like ""Ay boy how much those shoes cost"" and ""what's in YO wallet?""

I ignore him for a while until I'm far past the edge of campus and he's still following me. I turn a corner and panic as he follows me again. He yells at me ""alright now"" and before he can get a word out I turn around and stare at him. I lean on the stop sign next to me, and notice it's loose. He comes toward me and I scream ""EVER SEEN THE MATRIX, ASSHOLE?"" And pull as hard as I can. The stop sign comes up slightly and the concrete block at the bottom falls off, leaving me holding the sign while panting heavily. He fucked off pretty quickly.

I only realized later as I was walking home that I seriously fucked up my hands. They're seriously cut up and bruised and it hurts like a fucking bitch, and now I'm worried that I'm going to have to replace a stop sign.",TIFU by threatening to beat someone up with a stop sign I pulled out of the ground.,538
VisualizeWhirledPeas,127,116,1o6vub,420,"The teacher told me to write something I was talking about on the board, so I did. She was so surprised/upset/?? when I wrote on the Smart board that she didn't say a word. The only reason I knew is because the students were screaming at me to stop. Unfortunately, fading into the woodwork wasn't an option. 

I likely caused thousands of dollars in damages. Ugh. 

UPDATE: Finally, over a week later, the teacher sends me a thank-you note and I ask her about the Smart board. She said the dry erase marker came right off. ","As a guest speaker in a high school class this morning, I used a dry erase marker on a Smart board, damaging school property.",536
Ucantaketheskyfrome,96,108,1i1q7i,427,"I was getting ready to bike to the gym and walked to my car in the driveway to get my headphones. My chiweenie Donny must have snuck out behind me while I was rummaging through the car. I went back inside, realized my dog was not inside, and went outside to call him. He came hobbling back, leaning on one side and keeled over onto the grass, which is usually how he ""submits"" after you play with him and wants his belly rubbed. But I noticed he had numerous cuts, a gash under his eye. He was also panting (which he NEVER does) and one of his eyes was looking slightly in the wrong direction. I freaked out and got my dad to watch him while I ran around the corner. A bystander was calling the police because a van collided with Donny and then drove off. Now I'm at the animal hospital and I feel godamn awful waiting for X-rays to come back. Donny is my responsibility and I should have been more cognizant of him. Fuck.

TLDR - chiweenie snuck past me while I wasn't looking and got hit by a van that drive off. Donny was out of his element =(

Edit: http://imgur.com/TfhugZE.jpg

Update: The vet says he is fine. He is sleeping now. He may have a bruised pubic bone, but no concussions, and he got away with just cuts and bruises. Phew. Thanks for the support everyone!

Update 2: I did not see the driver hit my dog. One of my friends raised the issue that a van may not have seen him get hurt. That is a fair point. Another bystander was calling the police, so I assumed based on an independent source that they drove off intentionally. 

This turned into a very insightful discussion about the obligations of drivers, and whether it is ethically sound to drive away after hitting a dog. In my opinion, I don't have enough information to make a judgment about this particular driver - maybe her/his first thought was ""shit, I have two strikes already, I need to bounce""; I hold no ill will if this was the situation because the fact that he was even in the street was entirely my fault.

I want to take the opportunity to thank everyone who posted. I made this post at the vets office, hopped up on pre-workout fuel and creatine, waiting for the vet to tell me the news. It was very unpleasant. Fortunately, tifu/ surprised me with support, good will, and candor (thanks Cougs67 for the hit-and-run info!), and I'm very grateful.",TIFU by not paying attention to my dog,535
illdrawyourface,46,206,1b8x2r,427,"A family has contacted me to paint a portrait of their grandmother who is dying. Emails have been sent back and forth about how they want it done, what I'm going to charge, and I just sent one now with the last line being ""Do I have a deadline?"" As soon as I clicked ""send"" my stomach flipped. I've never wanted an email to come back more.

 I hope they don't take it the wrong way because it really was a normal question to ask. I just wish I had used a different word. 

Update to come later. I feel like an insensitive jerk.

UPDATE: I sent her an email saying, ""After sending the previous email I hadn't realized my wording in the last sentence. It came across as being insensitive and I apologize.""


UPDATE2: thanks for all the kind responses. Now if only I could get a response from the woman I've been talking to. It would put my mind at ease!

FINAL EDIT: Her response, ""Haha you're fine. It wasn't insensitive at all. No set deadline.""
THANKS EVERYONE, FALSE ALARM! :)",TIFU by being an insensitive idiot in an email I can't get back. ,633
copypastesystem,81,93,10rlmh,421,"I woke up in a great mood and drove my husband to work. All was well at that time until I was on my way back home. On my way home, 2 people at 2 separate intersections ran stop signs and almost hit me. I blew it off and carried on. I then went to meet up with a friend of mine to do our Monday breakfast. We went to eat and on our way out of the parking lot, someone in their pickup truck decided he wasn't going to wait for me to back out of my spot the last foot and almost slams his truck into me. At this point I start getting annoyed but still keep my cool. I get down the street and someone in an Audi runs a stop sign and almost hits me as well as a bunch of preschool kids &amp; teachers crossing in front of him. I finally make it home unscathed and decided I wasn't leaving the house today because of all the crazies on the road. I open my front door to find my ceiling has collapsed due to my landlord's lack of effort in fixing a plumbing issue we've had since we moved in. I then take my dog out for a walk and step into a giant pile of dog shit (not my dog's) and turn around to go home and clean my shoes. My landlord comes as I am cleaning up my smoking supplies/pipes/etc and in a last ditch effort to run and hide the stuff from view, I bash my toe into a wall and split it open. While my toe is bleeding through my socks, my landlord asks me to help find the leak that caused the ceiling to collapse. With no luck he decides to fix the doorbell which has been broken since we moved in. My dog flips out at the slightest sound so when he kept ""testing"" the bell to see if it worked, I had to chase my 70 pound pussy of a dog so she'd stop shaking and freaking out at the doorbell on 1 foot. While this may not have been the worst fuck up ever, it's enough for me to want to lock myself in my bedroom and sleep the rest of the day away. Happy Monday to me... 

**TL;DR:** A series of unfortunate events starting from the moment I woke up has driven me temporarily insane and filled me with excruciating pain.",TIFU By Waking Up,514
the_REAL_Nyall,154,130,1ho00l,415,"Woke up at 2:30 AM this morning with my laptop screen bright in my face . I had dozed off in front of it a few hours prior, whilst searching for cars on Kijiji. I hit refresh and there it was. The ad for the car. The car was a 2000 Chrysler Cirrus LX. And from the pictures it looked gorgeous. And the price was well under the $1500 budget I had set at $1200. 

The ad was titled: First Come First Served Don't Miss Out on this Awesome Deal! And it was apparently very awesome.

•she my daily ride so she runs and start great 
•it come with four brand new tires on rims along with four winter tires 
•tinted windows
•new Sony CDX/GT40U radio that has USB/Aux port all in the front. 
•wiring installed to an amp for a sub
•new transmission that has less 30000km on it
•there is a new catalytic converter 
•E-tested 
•selling her as is $1200 

Me being the idiotic 21 year old that I am, texted that seller almost instantly after seeing it and even though it was 2 AM he replied back and we arranged to meet up at 12 noon. So I take my aunts car, drive to go meet up with him and take a look at the car, it had rust but it started great, and although it made a little bit of noise turning, the steering wheel was stiff and the breaks were hard, I still ended up buying the damn car when he offered it to me at $1000. I figured it would have required some, work and hopefully it wouldn't have cost me more than $500. after I believed him when he said it was his daily driver, etc.

So I get the car registered into my name, put the temporary plates on and drive it to the car service center to get safety tested so I could fully register the car and was told it would take an hour. One hour later, I come back and was told that the car is no good and they didn't even bother doing the test, they just drove it into their garage and knew it would fail instantly.. I asked them for a quote and they couldn't even give me that, all they could say is that it is no good, and fixing it would cost more than the car is worth. I had also set up insurance for it and tried to cancel that and I was pretty much unable to.. without penalty and tainting my Insurance record. 

So I just took the car drove it to a mall parking lot, parked it and walked to my aunts car and drove home. Right now I don't even know what to do. I needed a new car for my new job that starts Tuesday, and now all that remains is $400 and a maxed out credit card once the insurance company takes their first payment. 

At this stage I really don't know what to do. I was so happy to have finally gotten my first car and now I wanna cry.. Literally just curl up in a ball and die. I'm such a fucking idiot. I don't even know what to do. I'd need to get my credit limit increased to pay to fix the car and I don't even know if it would be wise or even practical to do, I've re-listed the car on Kijiji (making full mention of it's problems and offering it at a lower price than what I paid for it). 

But oh well... 

EDIT: After getting a lot of advice from users in this thread, mainly from combatcarlson and a night's sleep, I've decided to keep the car and try to fix this car! It doesn't look too difficult from the various articles/videos/pictures I've watched, and the parts all seem affordable. 

EDIT 2: I picked up the car today from the parking lot, bought some power steering fluid, motor oil and engine coolant, which I added to the car. And proceeded to drive it to a mechanic shop closer to where I live, some ~40 km away. About halfway through the drive, the smoke started to come from the hood of the car. I'm not entirely sure if it's my fault though for adding too much motor oil OR for using a different brand than the one the previous owner used before OR for not giving the car an oil change. It didn't really affect driving, which was already pretty bad.. I managed to make it to the mechanic shop who inspected the car for $40. I'm not entirely sure how thorough their inspection was, but they hoisted it up, looked under it, looked at the tires and also the engine. And I was given this quote:

- Front Rotor and Pads - $170
- Front Wheel Bearing - $130
- Rear Break Shoes - $80
- Rocker Cover Gasket - $130
- Total - $510 parts and labor. 

This is nowhere close to the thousands of dollars that I was projected yesterday. Still though I must ask, are these prices good? Or should I still try doing the bearings and breaks myself? 

EDIT 3: After driving it for a decent amount of time today, I kinda realize why the car appeared to be decent in my test run, I drove in a residential neighbourhood with cars all over the road and didn't go that fast (&lt;40 km; the humming noise starts at ~50 km), neither did I make a right turn (the car seems to make noise when turning right) only three left ones.",TIFU by buying my first car... which ended up being a lemon,545
ashessnow,138,77,10pi2l,422,"So I'm in my car about to reverse out of my parking spot in the ally behind my place when I realize that what I previously thought was a harmless little spiderweb I had walked through before getting into my car was actually a giant spiderweb that is all over me, and so is the giant spider that made it. I freak out and get out of my car trying to get it all off me without realizing that I had already put the car in reverse. I open the car door and am getting out when I take my foot off the brake. The car immediately starts backing up, and being on an incline, does so very fast. I realize my horrible mistake and try to get back in the car but the car door hits me, knocking me to the ground. My car hits what is apparently a water line or something because the car hits something metal and it sounds like something is spraying water. The car, after hitting whatever it was, and how it's possible I don't know, then begins to move forward, and because I am still on the ground, runs over my arm. As soon as the tire is done running over my arm, I'm up again, this time running after the car that's headed towards my parking spot, trying to stop it. My car then runs straight into the brick wall of my parking space. I jump in, turn it off, and am too shaken to check the damage of both the back and the front, not to mention the brick wall and the building behind me. This all took roughly 10 seconds. 



Edit: My car is a 1999 4Runner. And I'm actually fine, thankfully. The tire just scraped off some skin. While watching it happen I literally thought...well there goes the use of my arm for the next few months, but it didn't hurt at all, just a bit heavy. The fall hurt the worst though, I hit the side of my head pretty good, and got my hands cut up. On the whole though, I'm fine. Also, I was driving a few hours later when I saw that fucking spider on my side window. At first I tried to wash it away with the windshield wiper fluid, but the fluid didn't reach my side window. That was the point where I gave up and figured that the spider had done enough to me, and that it would be best to just call a truce. 

Edit again: The back of my car is a dented, but the rest of it's fine. I have however, been banned from parking in the back by my roommate. And I still don't know what the hell I fucked up for the other building. My roommate told me it smelled like gas after it happened, but it sounded like water was being sprayed, very weird. ",TIFU Backing out of my parking space. ,499
tripsyfag,99,89,189g02,420,"Female here, by the way. Anyway some background: I'm a debater, and our tournaments are typically Friday until late at night, then resuming early Saturday morning. on debate weekends, I typically don't interact much with my family until Sunday.

When I got home Friday night, I took a quick shower and hopped into bed. Before crashing I decided to have a little fun. I got out my toy, lube, and some lingerie. I really enjoyed myself and was completely spent afterwards. Instead of getting out of bed and cleaning up everything, I decided to just take care of it in the morning. I woke up late Saturday and had literally thirty minutes to get ready and head up to school, so I completely forgot about my stuff from the night before. I left it all sitting on the floor. When I got home, I noticed my room had been cleaned. I look in my top drawer and find everything, including my now-cleaned toy. I'm so embarrased and I can't look my grandma in her eyes..",TIFU by falling asleep after masturbating and not cleaning up first,509
CasioKnight,116,101,wvbdi,420,"I don't understand why people don't shake hands properly.  I get nervous when I see new hand configurations presented and I have to figure out how to shake it while being cool.  This handshake was accompanied by a lean-in, so I accidentally hugged him.  In my car.  Which did make it more awkward.  ",tifu and accidentally hugged my drug dealer.,521
CCgamer,30,55,1jsw7i,420,"Ok so this wasn't exactly today but encompasses my whole last week.

I was fairly sick and stuck with one of the worst sore throats I've had in a long while; unfortunately for me it wasn't strep throat so I couldn't just take an antibiotic and be done with it. So this sore throat makes it feel like I'm swallowing glass, and because of this I have literally no appetite. Over the course of 3 days I only ate 3 cans of chicken noodle soup that were about 70 calories a piece, and even that hurt like pouring molten lead down my throat.

To make matters worse... I had explosive diarrhea. 

I spent 3 horrendous days not trusting any fart as far as I could throw it and rushing to the restroom every couple of minutes. But because I had no appetite and wasn't eating any food at all I was shitting blanks, sitting on the toilet with massive cramps and a few squirts every few minutes. By the end of the third day my asshole was redder than a raspberry and more raw than Eddie Murphy's 1987 stand up comedy movie. The mix of both this and my sore throat made it really difficult to sleep and rarely got more than a few hours a night. All around, things were not exactly pleasant.

The only thing I had to make life bearable was tea. Since I was shitting out all of the 70% of liquid my body had, I had to constantly be drinking and luckily for me I found a few days prior that a nice warm cup of tea actually felt pretty good. I drank so much tea that I ended up finishing half a box of some menthe tea and a whole box of my parents diet green tea. I'm a big fan of green tea so I finished that box within 3 days. 

As I'm throwing away the box of diet green tea, I start to think. How can tea get any more diet? It's just tea leaves and hot water... I looked at the box again to find that it actually read dieter's green tea prompting me to look at the back of the box where in semi bold letters it reads, ""This tea contains laxative properties. Do not exceed more than 2 cups within 24 hours."" I finished a box of 20 tea bags using a 20oz mug for each bag in only 3 days... I was giving myself explosive diarrhea. I was to blame for the 3 excruciating days of shit coated pain. 

TL;DR *I put myself into a shit induced coma that lasted 3 days because I drank laxative infused tea.*",TIFU by drinking tea...,475
Estranged_Noodle,75,67,12iywd,417,"Fuck. 

Last night I went out with a bunch of my colleagues to grab some drinks and to wind-down. There was 10 of us - mostly the younger crew from the office - and an even ratio of guys-to-girls. 

This one girl, Rebecca, is my age -  cute and single but fucking wild when she drinks. I, being my horny-self, love to spit game and saw her as a solid target for the evening, so I went for it. 

Unfortunately by the time I was ready to man up, I had already reached high-levels of insobriety and lost all functioning memory-systems.  I woke up with a blazing headache ... and to an absolute grizzly sight: *muddish-colored blood all over my face.*

I panicked and for an instant thought my jaw was broken or I had a gash hidden underneath the layers of partially-dried blood. I recall in my moment of panic, a modular-swab or what looked like a tiny chunk of bloodied skin or as my colleague later recalls a ""bubbly, fleshy, string of red shit."" 

I cleaned up and gagged for half-the-morning, all the while enduring the world's worst fucking headache. I scrutinized all parts of my chin, upper-chest, and bits of my cheek to happily determine I wasn't injured but in-fact bathed in someone else's blood for the last several hours. Although that made me feel slightly less-disgusted, I'll never forget the crusty-stained pool of hemoglobin, poop, or who the fuck knows that seeped into my pores and stuck to my body like a red-colored, mud-mask. 

Focus Estranged_Noodle, I told myself. I was clean and ready for work, but terrified of who knew what. In anticipation for the weekend, I relaxed and forged new memories that I could surely share with those whom inquire ... maybe someone got hurt and I helped out, or it was a vampire party of the sort that I later stumbled upon (NOTE, this is just after Halloween so this was a legitimate thought). I cruised into the office, with my pride and confidence wobbling on the precipice to self-abhorrence, and opened the door to the darkest of welcomes that has ever billowed through this now hallow frame. Our receptionist, Sandy, gave me this cold, unforgiving stare to indicate how much of a cluster-fuck I got myself into from the night before - and if Sandy knows, everyone knows. 

Gossip is notorious in our company and last-night's events had unfolded like a 1920's noir, with gruesome details and picture-by-picture events of what happened, the emotions each party felt, and the dark, bloody scenes that unfolded. Murder stories may never match the speed and potency at which my story had spread. I tipped my head low and for that first hour of work, I never experienced such powerful feelings of guilt, shame, and anguish in my life. I felt locked in an isolation unit and for a moment believed death would be a better outcome than all the emotional-pitfalls exposed in the eerie air of the office. I'm not necessarily disturbed by the actual act itself, but deeply regret confiding the act to others who would juice up the story rather than burning it. An overwhelming majority of the guys in my office handed me pats on the shoulder or would mouth something like ""fucking *brilliant*"" or ""*you are GOD*""; the women, however, sneered and passed full judgement my way. It was an incredibly bitter, awkward day to be on the job.  

The sun began to fade and as the hours ticked down to just minutes before the weekend, my good colleague Tom approached to reconcile the final details of last night, helping piece together what was a very messy puzzle. 

As Tom recounted ... Rebecca and myself were the last two to leave the bar all the while pounding shot after shot and getting as drunk as we possibly could. Tom had stayed with two colleagues to catch up but kept a vigilant eye on the both of us to ensure we didn't up dead or worse. But oh boy, did it end up worse.  

In an blurry instant, the night transformed into an absolute horror show. Our colleagues had watched Rebecca and I enter the woman's washroom and 20 minutes later, gasped in complete disbelief and horror as I exited alone. As to what happened (remember, I have NO recollection), Tom remembers seeing ""a blood-dripping demon"" with a grin plastered across its face. They freaked and knew something was terribly out of place, and came running towards me. What I can deduce - from the network of stories and details passing through as gossip at my workplace -  was that as I splashed my head into a butt-pool of vaginal blood and menstruation fluid, Rebecca passed out and lost control of everything and anything while on her period. I must've dug so deep that when I walked out, the guys saw what they describe as an ""ocean of rancid dribbles of blood and [what looked like] musty placenta grease."" They were horrified and completely shocked while I stood prim and cheeky.

Tom and the two others rushed to Rebecca's aid and found her slumped over the toilet bowl, with her panties around her ankle and a sess-pool of blood quickly staining the bathroom floor. 

As they approached the messy card Rebecca had just dealt, they watched as I walked away a victor, audibly mumbling these fateful words: ""This was done to restore my honor my father bestowed upon me."" I strolled home, completely blacked-out, scaring the likely living-fuck out of every person I came across; but I made it home, alive and well. 

I stirred from my slumber, hours later and woke to an awful, awful sight. I strained my heart with a year's worth of hurt and anxiety from all the tension and stares I received at work ; I am also INTENSELY freaked out in the belief I have contracted some alien-form of chlamydia because of all the liters of blood I inhaled the night prior. 

God fucking fuck.  
_____________________________________________________
**TLDR: Drank with work-buddies, go down on a colleague to wake-up the next morning with soiled blood all over my face and upper-body. Not only am I ashamed of having to go to work these next few weeks, but scared shitlesss that I sucked up some rampant sexual disease of any or most sorts.**",TIFU By getting black-out drunk and waking up with (what I believe) is my colleague's period-blood all over my chin. ,484
dirge702,68,87,12eo27,422,"At my work place if a plastic piece breaks or a screw is stripped on a computer we're fixing, (computer repair) which does happen from time to time thanks to people bringing in these ancient laptops, we use super glue.

I was working with some today and the stuff is super clear and if it's spread out thin enough nearly impossible to notice. And I unknowingly got a lot on my hand. 

I went to the bathroom for some much needed relief, and I was stuck. To paint a picture, my whole palm was stuck to my junk. Balls and noodle. I zipped up with my hand down my pants, told the boss, and after about 5 minutes of straight laughing he let me go home. 

On my way home, (about a 45 min route) since I have only one hand and it's not my main hand, I swerve a little bit every now and then. A cop decides to pull me over for that.

 He walks over and he asks me: ""Sir, please take your hand off your crotch and show me your ID."" I explain what happened and he breaks out laughing. But I still get a ticket. Only 20 bucks though, (which I question if he can even write out for that low a amount) ""for being a good sport."" I also got escorted home. 

So here I am now, sitting in my bathtub full of warm water and soap, typing on my phone. So reddit, how has your day been? Mine has been balls so far today.

Tl;dr: superglued my hand to my crotch, got a ticket, and I'm sitting in a soapy bubble bath waiting for my hand to be freed.",TIFU by superglue-ing my hand to my jingle jangles at work. And got a ticket.,509
xhable,58,123,1325jf,417,"Must pay attention more 0.o.

Ham and raw cabbage sandwiches taste freaky.",TIFU: Brought a cabbage to work instead of lettuce - my sandwich tastes weird,540
AirOrFourOhFour,89,79,12plmv,415,"Today I was texting a woman who wanted me to come over for, you know, science. She was relentless in pleading for a picture of my equipment and I held out for as long as I could for many reasons - I never send erotic pictures because of the many ways it backfire, come back to haunt later, or otherwise just go wrong. And go wrong it did. The desirous woman intended to go to my work function the next day, and while I was preparing the picture, one of my coworkers sent me a text message about the same event. In a lapse of attention to detail, I responded to the text from my coworker with a picture of an erect penis. 

The conversation went like this:

coworker: where do we park tomorrow?

me: idk. here's a picture [of an erection]

 I immediately realized what I had done and sprinted to intercept my colleague's phone, but the damage was done. 
EDIT - Here's the rest of the story, asked for and given in comments, but I figure I'll put it up here for ease of reading: I found the coworker and he immediately looked up at me and said ""WHAT THE FUCK?"" I took his phone and deleted the message and asked him not to share the story with anyone. He kindly agreed. (He's my subordinate, so it worked out nicely) I was mortified for the rest of the weekend. Upon inspection of my inbox for the next person it could have been accidentally sent to were: my mother, my sister, and a group text message between 10 coworkers (both male and female, including my supervisor)",TIFU and sent a Dick pic for the first time - to the wrong contact,494
PaxMalum,118,121,1lk1ru,414,"About a week ago, I bought several cans of tomatoes. Today, I made my first attempt at homemade salsa.  I chopped up three jalapenos and a few hotter peppers and washed my hands.  

Then I chopped up the garlic and washed my hands.  

Blended everything up and (you guessed it) washed my hands.  

Then I washed my hands again.  

And again.

A bit later, I had to go to the bathroom.  My fingers touched my lady parts.  Instantly, regret filled my mind.  ""But wait,"" I thought, ""I washed my hands, like, ten times! Everything should be fine!"" Nope! As soon as I stood up, fiery pain swept through my lady garden. 

I needed help.  I looked at my boyfriend and said, ""I feel like Gob"" and told him the whole sordid affair.  He googled and told me that milk would help extinguish the burning, so I grabbed the rest of the half gallon we had in the fridge, ran to the bathroom and poured ice cold milk on my angry vagina.  Nothing could have felt worse.  Burning quickly turned into icy horror as my vag tried to close up and escape. 

Now I'm out of the shower, and the burning and freezing has subsided, and I'm trying to figure out who I can push the rest of the peppers onto.

TLDR: Salsa is evil.

EDIT: Yes, latex gloves, I understand.",TIFU By touching my vagina. [NSFW],535
CatastrophicCereal,38,63,1aoltn,416,"Last night I was at a freinds party and I got a little bit more drunk than I intended to. It certainly didn't help that I was already quite tipsy from drinking throughout the day, but normally I am reasonably good at telling how drunk I am, so I didn't really think I was drunk enough to do what followed.

After the party ended, I stumbled home. I was hungry, so I decided I wanted something to eat. After deciding it would have to be something simple I grabbed a box of cornflakes. Unfortunately, I had run out of milk, so I had to improvise.

This was the point at which I showed exactly how drunk I was; for a reason I can't exactly remember, I thought putting the cornflakes in the oven would somehow compensate for the lack of milk. Even worse, it was at this precise moment when I passed out.

Fortunately, as the cornflakes in the oven were burning, one of my flatmetes found me and called the emergency services. I woke up in the hallway after a short while with basically no recollection of what happened (I had very little recollection of the whole thing until this morning), so to my mind I had only just got home, and was quite grumpy with the policeman asking me questions - I realised there was some sort of commotion but I had no idea it was me that caused it. 

Fortunately, there was no real damage (the oven might be fucked though), and I was allowed just to go to bed. I was told today that there were 16 firefighters, 2 paramedics and a few policemen. Overall, from my point of veiw I'm incredibly lucky; more damage could have been done, I or my flatmates could have been hurt, I could have been taken to the police station for questioning - as it stands the only real repercussion is that the oven might have to be replaced. Still its pretty fucking shameful that I managed to fuck up cornflakes this badly.

**tl;dr Tried to make cornflakes, started a fire.**",TIFU by making cereal,479
Xemeriba,105,31,rv7iu,416,"I decided to take my girlfriend and her mom out to brunch this morning. Her mom was applying makeup in the car and got a little lip gloss on her hand so she asked me if I had any napkins in the car. She was sitting shotgun because I felt it was polite to offer her that seat and my girlfriend didn't object. 

Time to divert... A few weeks ago, my girlfriend and I were having a great night. I took her to dinner and a movie and, well she had plans for after that involved my car and a very out-of-the-way area of town. Needless to say, we used a lot of condoms that night. We didn't have a place to throw them out at the time so she tied off all the rubbers, and then stuffed all the wrappers and condoms into my glove compartment so we could throw them away later. We didn't...

Back to today. Without even thinking I said ""I think I have some in the glove box"" and then everything went in slow motion as I watch her open the compartment and at least a dozen tied off condoms and their wrappers fly into her lap. There are no words to describe any of our reactions. We pulled over near a public trash bin and threw them all away. I'm still waiting for any sort of contact from either of them about the situation.

**Update as of Friday, April 6th: So right now I'm sitting on the couch with both of them. They are laughing and acting like nothing happened but there is still this uncomfortable air about the room. I want to crack a joke about the event or about anything but I'm worried it will make the tension worse.**",TIFU: Girlfriend's mom opened up my glove box to get a napkin and instead got a lap full of used condoms + wrappers.,447
Wizzer10,97,167,1pdqec,417,"Title says it all. 
I was making a piri piri marinade so chopped up some chillies. I tidied everything away and went to the bathroom to wash my hands. Unfortunately, I didn't wash my hands thoroughly enough as, thirty minutes later, after having a cheeky mid morning wank, the pain is excruciating. I didn't feel it mid wank but now, after all is said and done, my penis feels like someone rubbed molten rock over my glans. I've had several ice cold showers but it's still utterly excruciating. I'm considering getting a bucket of ice, next. 
Why am I so dumb?",TIFU by chopping chillies and having a wank,584
frikalika,125,153,16fmg3,418,"I don't often go to the beach, and when I do I usually cover up due to my pale sensitive skin (thanks, Irish and Scottish heritage). So I haven't bothered to invest in a quality swimsuit. But this was a super hot day and we went in the evening, so thought I'd be safe without my usual layers and just wore a shitload of sunscreen and my bargain box bikini.

Of course, being a hot day the beach was very crowded even at that hour. Also, the waves were rough. After a while of just mucking around in the waves I had drifted toward the sand and was standing up, with the water around waist height. A polite and usually very quiet male friend of the friend I was there with yells out over the general noise of the beach, ""frikalika, your top..."", blushes and looks away. I look down and yes, my top had come a little undone and left me exposed to the entire onlooking crowd.

TL;DR - Cheap top was cheap and I accidentally flashed boob at a crowded beach.",TIFU by wearing a $5 bikini top from the Kmart bargain box in fairly heavy surf,571
ozi_kaninchen,64,71,13fp9s,414,"Well, last Friday I was circumcised and things aren't normal down there.. It's quite hard to get used to the sensitivity. I had been inside all weekend with no pants on, so today I summoned the courage (aka paracetamol and codeine) to go out with a friend and sit by the sea. 

All was well until I had to pee, so I quickly shuffled into the nearby public toilets. I opted for the long urinal on the basis that I would have more room to move (I'm quite tall) and that accuracy wasn't an issue. There was a guy already there, and in hindsight I should have waited for him to go.

As I released my golden stream, it literally went sideways towards him, splashing him on the shoe and partially on the leg. I then quickly adjusted my stance to face into the corner (again, should have done this in the first place) so I wouldn't piss on him any more than I already had. He noticed immediately didn't seem best pleased with the situation. In order to explain myself, I ended up just showing him the stitches I have whilst apologizing profusely.

He just laughed and shrugged it off in the end, but I am still pretty embarrassed. I don't think I can use a multi person urinal ever again. TIFU.

**TL;DR:** My broken dick made a stranger wet.

**Edit:** [Link](http://www.reddit.com/r/tifu/comments/13aof7/tifu_fucking_no_fap/c729h0i?context=3) to a previous comment explaining my circumcision. In short, pre-existing Phimosis lead to a condition called BXO after many sexy times.    ",TIFU by pissing on a stranger and showing him my penis..,485
Metabilities,153,112,ug7hp,412,"So, mega fuck up on my part today. I am 26 and have been vegetarian for health reasons (not ethical) for about 8 years. I rarely cheat, maybe once or twice a year when I'm craving protein, and I keep it very small, like a slice of bacon or two.

Well today, I had an ultra-monster-mecha craving for meat. It's been building up for weeks and I can't hold it any longer. Ok, so time to cheat, what should I have? I'll just get a little something at the local diner. When I look at the menu, however, the repressed caveman in me can't stop staring at the steaks. So I order one. A 14 oz sirloin.

Fast forward a few hours, once all the deliciousness is inside me, I realize what a huge mistake I've made. My intestines are trying frantically to keep up with what I've just done to them, and respond by opening the floodgates and letting it all out.  Another bit of TMI for you, I also just happened to enjoy a bit of *ahem* backdoor action with the BF 
last night. That makes is much more difficult to hold anything in that wants out IMMEDIATELY.

Unfortunately I am at work, and cannot go home for another 4 hours, so I have been back and forth to the bathroom every 10 minutes or so. My colleagues are starting to wonder. Also I'm pretty sure they can small it from the hallway. The worst is when I'm mid-flaming shit squirt and one of them walks in, forcing me to clench as hard as I can to keep it in for just....ten....seconds....please.... Nope.

I don't know how much longer this is going to continue, but I'm pretty sure the next 4 hours of will be spent in humiliating, ass reaming agony as I battle the anal leakage and try oh so hard not to shit my pants at work.

TIFU, Reddit. TIFU bad.

TL;DR- vegetarian + giant steak = fiery buttpee at work

EDIT: Fucking FINALLY time to go home! Thanks to MustardMcguff for the Kenny G and Mad Magazines idea, sounds rather sexy. I think I'll light some candles too, and then ass-piss to my heart's content long into the night...",TIFU: as a vegetarian I ate a giant steak,524
searspoop,90,88,u97n0,414,"Today I enjoyed a nice coffee at home and departed for the mall.  At the mall I had a chicken sandwich, with a packet of Texas Pete hot sauce; it was delicious.  Not 15 minutes later, I'm standing in the electronics section of Sears, texting my friend.  I feel a bit of warmth in my ass; I figure I have farted a bit and am feeling the warmth of the gas.  I then realize that I also simultaneously heard a soft *plop*.  Glancing over my shoulder I see a 4 inch diameter puddle of brown liquid, my 100% liquid shit.  Assuming that the warmth in my ass is more shit, I rush to the bahtroom, which (thank god) was just around the corner and empty.  It takes me fewer than 5 seconds to get to the restroom.

In the restroom I free my right leg from my wide legged cargo shorts, thankfully there is only a small smattering of liquid on my calf, which I wipe off.  I also wipe a small dime-sized wet spot off of my fortunately black shorts.  Sitting on the toilet now, I decide to try to shit, even though I don't feel like I have to.  I proceed to diarrhea much more than expected.  I wipe my wet ass and then start to decide what I should do.  I can't just leave the shit there like [this person did](http://imgur.com/3aOVx.gif), can I?

Less than a minute has passed since the accident.  This bathroom is only equipped with a blow dryer, so I grab a large wad of toilet paper and shove it in my pocket.  I don't wash my hands, there's no time to waste and wet hands would just weaken the toilet paper.  I exit the bathroom, determined to clean this up as quickly as possibe, but also determined not to fess up to it if someone was already cleaning.  I definitley would have just kept walking if someone was there.  Thankfully for everyone, nobody was there.  I quickly stoop down and wipe the liquid up, it is almost entirely soaked up by the toilet paper.  In my head I formulated a story saying that I accidentally spat some chewing tobacco spit out.  Saying I had vomited after eating chocolate would probably have been a better excuse.

98.5% of the liquid is now in the toilet paper wad in my hands.  I speed walk the 20 feet to the rest room, walking past two people whom I hope did not see any of this.  I toss the wadded toilet paper in the toilet, and take another unexpected shit.  I realize that while my legs, shoes, and shorts are clean, my boxers are not.  They are wet.  I ditch the boxers and throw them away in the trash can in the bathroom.  I then take a slow, agonizing trip up the escalator, and promptly exit Sears.  I'll never know if the announcements of ""Jay, call 266"" were in relation to my shit or not.  Once completely clear of that half of the mall, I finish the text to my friend and enjoy the rest of my shopping commando.

**TL;DR** I shit on the floor of sears and cleaned it up.","TIFU and took a shit in sears...but I wasn't in the 
restroom.",502
[deleted],74,79,13rfmc,415,"Playing a night game of ultimate frisbee with my buds.
One of my friends makes a horrible throw and it goes sailing off into the night and lands on the other side of this street right across from the community park where we are at. 

Well, I started to jog after it. I get to the curb on the other side and miscalculate my step. I catch the edge of the curb and head face first into a pile of dog poo. I mean my face was a shit stain. Forehead, cheeks, nose, mouth, the whole entirety of my face was covered in it. And not to mention I landed with such force that some of it went up my nose.

Now I can't get the smell out of my nose..
Fuck up of my week indeed.

[Update](http://www.reddit.com/r/tifu/comments/13sv39/tifu_update_falling_face_first_into_dog_shit/)
 ",TIFU by falling face first into dog shit,494
edge_of_glory,91,81,127k5n,406,"I have been suffering from hard wax buildup for the last 2 weeks. I finally get to the doctor Friday and she says use warm water and peroxide a few times a day to get rid of it. So I do it, but I keep getting water trapped in my ear that wont come out. So I ask if anybody knows a way to get water out of ears. My friend says alcohol. Just my luck that I don't have any but I do have Germ X. I talk to my friend about it and she thinks it is okay. I then proceeded to put fuckton of **GERM X** in my ear. Nothing prepared me for this shit. **IT BURNED LIKE SATAN TOOK A FUCKING RAZOR TO MY EAR SLICED IT, RUBBED IT WITH LEMON &amp; SALT AND PROCEEDED TO FUCK IT WITH HIS FIERY BLAZING DICK OF FIRE**. It did not helo ears were swollen and kind of raw already. TIFU really bad now I am sitting here looking like a dumb ass.

TL;DR: I let Satan ear fuck me with out buying me dinner first

Edit: Obligatory I made it to the front page blah blah. I just wanna thank satan for ear fucking me and my lack of the different types of alcohol.",TIFU by putting Germ X in my already fucked up ears.,487
PugnaciousJay,76,65,10ul61,409,"Earlier today I got on a crowded elevator in my residence hall with one of my roommates.  We were the last ones on, and there were about ten other people standing behind us as the elevator began to ascend.  The elevator then stopped on the second floor, much to my dismay.  I turned to my roommate and quietly said ""Goddammit, who the fuck takes the elevator to the second floor"".  Though I didn't intend for anyone to hear it but him, I must have been louder than I thought.  From behind me, I heard a girl's voice timidly say, ""me"".  I turned around and saw the girl who had said it.  She had a broken leg and was struggling to hobble out of the elevator on her crutches.  Fuck me.  Everyone gave me quite a look after she got off.",TIFU by complaining on the elevator.,474
Dovanchester,38,123,160kww,409,"I work part time as a cashier. Last night it was becoming increasingly slow in the store and I was becoming increasingly lazier. At around 7:30, I was helping a customer when they requested a bag. As I take one off the rack, I feel a tickle on my nose and feel a sneeze coming on. I decide to itch my nose with my shoulder, and as I do, fan out the bag with my hands to open it. Because of this quick action, my shoulder decides to jump up directly into my nose, more or less punching myself in the face. There was blood everywhere on me, the didn't let me go home.

tl;dr: Helping a customer results in me punching myself in the face, kinda.",TIFU by exploding my nose.,532
XeroChancey,65,60,1ayn8j,409,"I was recently done washing the dishes at work and had accidentally  gotten my watch wet. I placed my watch in the pizza oven, thinking it would dry it off quickly. My manager had noticed and walked over to me and asked why I did that. I realized I had been being stupid. I quickly grabbed my watch from the oven and put it on, not thinking it would be hot. I was then rushed to the emergency room and had to have my watch surgically removed and now have second degree burns on my wrist. I done Fucked up today Reddit.

Edit: My boss got a photo.. He sent it to me over facebook. look for it in the comments, its not the full picture cuz he took it with his phone, but this was while i was out after they operated, before they got the bandages on (For filing at work, he says. They let him). https://sphotos-a.xx.fbcdn.net/hphotos-prn1/521362_560468753987925_757950285_n.jpg

Edit: Note i didnt know he had a photo. If i did i would have originally posted it folks.

Edit: My watch did get dry.","TIFU Yeah, I did this at work today...",469
Flamethrow-away,37,96,1h2wjq,406,"So my mom got a candle from the flea market the other night, and it REEKS. It’s some kind of pomegranate-mint shit, I don’t know. But she loves it.

This morning, I was watching TV when I felt a mighty need to toot. I thought to myself, “That candle smells so nasty. I’m gonna fart on it to make it smell better.” So I bent down in front of the candle and, to put it daintily, ripped ass. I should have seen it coming, but to my shock, a bright flash ignited behind me.

I turn around. My popsicle-stick framed photo of my late grandma is on fire! I threw it on the ground, but was afraid to stomp it out because I was barefoot. Then things got worse. The back of my skirt was on fire, too! I jumped out of it and ran to the kitchen for some water. We didn’t have any cups big enough to put it out, so I grabbed a gallon of milk. Let me tell you, bootleg Invader Zim skirts from the flea market burn like gasoline-soaked tissue. I put it out just in time for my mom to find me, in my pantsu, dumping milk on a picture of her dead mother.

Now my mom is pissed, my favorite skirt is ruined, and my parents’ house reeks of burning and milk. And that candle. And farts. :(
",TIFU by farting a fireball at my dead grandmother; ruined my skirt,502
pzbogo,182,65,z491p,405,"When I woke up this morning, I felt the urge to shit, so I took a quick powershit (diarrhea) before school. When I got to school, I felt he urge to go again, so I went, and ended up being late for my first class. Then about ten minutes before class was over, I felt the urge again. I told the teacher, but he wouldn't let me go. Even after I told him it was an emergency he wouldn't let me go. So I yelled ""I'm literally about to shit my pants!"" I didn't mean for the whole class to hear, but of course they did. He just kinda got this angry look in his eyes and said ""just get out."" I did he gotta-shit-waddle down the hall to the bathroom. Right when I pulled my pants down, my ass decided ""hey his pants are down, time to shit!"" but my pants weren't down far enough and I was standing, so the shit landed right in my underwear and started running down my legs. I stood there for about a minute in shock. Then I sat down, and finished shitting while I cleaned the shit of my clothes as good as I could. Then I went to the office and called my mom to get her to pick me up. The asshole secretary people couldn't keep a straight face because, I mean seriously, how many hichschool juniors have shit their pants in school. While my mom was on her way, I went back to class to get my books. I swear the whole class broke into laughter he minute I walked out. My mom drove me home in complete silence, with all the windows down. After I got home and cleaned up, my mom made me wash my clothes myself and then clean the car very thoroughly. 
  TLDR: had diarrhea, asshole teacher wouldn't let me go shit, shit my pants, had to clean car
  EDIT:today was awful at school, i got taunted alot. and the asshole teacher was three times as strict today.
  EDIT2: front page! great now everyone will know my story.",TIFU and shit my pants in school,470
reddisentevil,59,125,1hb6v4,409,"So i decided to go for a run this afternoon to expel some energy after playing playstation. My drive way is kinda steep and it had been raining this morning. anyways, as i jog down the driveway i twist my ankle and slide down the driveway in agony and have to be helped back inside back to the lounge.","TIFU going for a run, being carried back inside",534
[deleted],99,75,z9i51,402,So I was walking down the street of the town I live in and I see a very elderly woman in a walker having trouble with a large door. So I decide to be helpful and open the door. I got the door half way open then BAM! Faster then the hammers of hell she unleashes upon me a can of mace. I'm talking the high powered cop shit with an NYPD emblem I'm the can. I dropped to the ground while she screamed that I was trying to stab her (I luckily didn't have any knives on me) but as I rolled around in pain the cops come and start questioning me. I Didn't get in any shit but the ladies mace was confiscated and I couldn't see clear for an good amount of time.,TIFU by helping an old lady,477
puddlesofblood,92,111,1r7ueq,404,"Okay, so I'm in my Leadership Advisory class and I was just on my front page. Of course, this is a class where I can just do whatever on the computer.

My teacher was walking around, checking to see what we were working on. 

She came up behind me, and in an effort to quickly click away, I accidentally clicked on an image of a girl in latex, fully spread.

Shit.

She saw and when I tried to exit out, guess what I got???

THE SPINNING WHEEL OF DEATH! 

YAAAAYY!!

Now my teacher thinks I'm a complete nymphomaniac woman!",TIFU by accidentally opening /r/ShinyPorn on reddit in school on a mac.,515
[deleted],78,158,1js6m7,399,"So this was about a week ago. My boyfriend and I consistently hang out and we don’t mind. Sometimes, being stuck in a room with Netflix running all day can get a bit boring, so you know. We entertain ourselves. With sex. And lots of it. He’s the type who loves to go down and hey, why should I have a problem with that? So I let him proceed. We’ll do the little ‘oh yeah, let’s spoon’ and several seconds later it turns to dirty times. Well the day proceeded and we’re the types who are very curious and pretty much are open to anything. So he wanted to try something that I was not, let me tell you *not ready for*. He fixated me so that my ass would be near his face. Then he went on to you know, lick the bootyhole. I was cautionary at for but I’ll admit, it was different and I didn’t mind. Clearly he didn’t either. We didn’t really realize the medical precautions we should be taking because, what can possibly happen, right? Nope. Fucking wrong. Fuckfuckfuck. I woke up the next morning with the urge to piss and it fucking hurt like satan himself was lighting my vagina on fire. What the fuck is happening to me? I didn’t take it as much and I just went to his house. The problem got worse. What the hell? I looked up my problem and turns out, all the booty licking he’d done? It caused me to develop a fucking UTI. So we ended up waiting until the end of the week to run to a clinic, get antibiotics and get this shit fixed. Curiosity killed the cat, and yup, it definitely killed mine. ",TIFU by letting my boyfriend lick the bootyhole.,557
TIFU8June2013,48,92,1fyztc,401,"Alright, so I always laugh at the stories on here where people shit themselves and think ""no fucking way I'd ever do that..."" I'm now eating my words. Really just typing this up to relieve some of the stress that I've accumulated over the past few hours.

It always happens when it really shouldn't right? Here's some context. Myself and my parents sit down in the family room to watch a soccer game around 5:45 this afternoon. As halftime approaches we hear a loud dripping. We assume someone left the faucet on; not so. We go to the entryway of the house and there is an obscene amount of water dripping through a seam and a lightbulb socket in the ceiling and onto the floor. We immediately surmise that the hot water heater (which is, of course, on the top floor) has sprung a leak. We spend about an hour cleaning up the mess on the two floors, then my father calls our insurance company to get someone out and assess and fix the water damage and the water heater, and in the meantime we sit down to watch the end of the game.

The game ends, and my dog is a bit stressed from all the commotion so I decide to take him for a nice long walk. Normally I use the bathroom before a long walk but I literally felt nothing so I just ventured off into the wild unknown.

Bad idea. About halfway down my street I realize my bowels have decided to yell ""fuck you and everything you stand for"" and I immediately turn around. I run back with my dog (in retrospect I may have been able to hold  it in more effectively had I walked, but I felt it *bad*.)

I get to my porch and then suddenly jt just lets loose. I assure you it wasn't a pleasant firm log either, but a chunky, barely held together pile. I sprint into the bathroom, but the damage is done (although not nearly finished). I take off my shorts, meanwhile dropping my phone into the (currently clean) toilet for icing on the cake that was this shit evening.

Now, anyone who has shit themselves so forcefully knows that rationality exits almost simultaneously with your excrement. So it was that I found myself flushing a toilet that was filled with toilet paper and lumps of shit. What do you know, it overflows. Being a panicked and irrational teenager I scream for help, wrapping a towel around myself, and my wonderful father runs in and shuts off the water valve. Unfortunately it was too little too late, and the bathroom's tiles are covered in shit water and specks of toilet paper. To top it off I have shit on the side of my leg and on my shoes and my boxers are destroyed.

Somewhere in this commotion the two guys arrive to assess and fix the damage. By this point we've shut down gas, (obviously) hot water, and electricity in the affected rooms. I won't go into the cleaning process of cleaning the bathroom floor and unclogging the toilet. Then, I have to take a freezing cold shower with no water pressure to clean myself off.

Rather comical situation, I guess. I might have left out some details, but essentially the overflow in the bathroom leaked into the basement so we now have dehumidifiers running in four rooms of the house and there's just about no way I'm getting any sleep tonight. I can't tell if my timing was perfect because we had the guys (for whom I now have some immense respect for not even batting an eye) coming around anyway, or terrible because I then had just about no way to clean myself off.

TL;DR: Shitting yourself--it could happen to *you*",TIFU by making a pretty bad situation shitty,493
EyeStartledTheWitch,72,53,17lm9j,405,"I was in a hurry threw on some pants, and the first shirt I could grab, which ended up being a loose tank top. Keep in mind, I don't have the biggest boobs. So I pulled into the gas station, and the man asked me how much I told him 20.00. As he walked away, I looked down and realized my boob was hanging out the side of my tank top. I completely flushed with horror and embarrassment. I quickly pulled my shirt over my boob, and told myself if he seen it, he won't say nothing, but then again he's probably to busy to see it. I was wrong. He came back up to my window, took my 20.00 and put his head in side my vehicle and said ""Mam, I seen your titty"". All I could stammer out was ""Oh, I am so sorry"".. To which he replied ""Nothing, to be sorry about, you made my day"", and gave me a toothless grin. I felt like dying in that moment, and I think  a part of my soul did.",TIFU by wearing a tank top to the gas station,458
wafflebuster,89,91,1h0y6r,403,"So I heard that one of the girls from Teen Mom had made a porn, and being hoke alone, I thought why not. I usually watch that stuff on my Kindle Fire, and since the thing has pretty bad speakers I usually turn the sound up. So I gave it a quick fap and turned my kindle off. Fast forward to 3 in the morning, I get in bed and decide to check my facebook on my Kindle before I call it a night. I turn the thing on, only to have ""OHH! FUCK THAT PUSSY BABY! FUCK THAT PUSSY! OH!""blasted through my fucking apartment. I got startled, and yelled ""OH SHIT"" before dropping the thing as the orgasmic moans keep playing on full playing on full blast. Did I mention my parents werr asleep? Well, not anymore. They awoke to the sound of their son's porn. My mom walked into my room with the most horrified look on her face, stared me dead in the eye, then left back to bed.

Oh boy, it's gonna be a fun family breakfast tomorrow.

EDIT: So we had breakfast today. Nobody talked, or even looked at each other's faces. I ate 4 pancakes in like 2 minutes and ran the fuck out of there. I don't plan on leaving my room today.",TIFU by leaving the sound on.,494
DramaDramaLlama,97,139,1jztrv,399,"My boyfriend dislocated his knee over the weekend while he was out visiting me (we have a long-distance relationship). Since his knee is mostly okay and we're not about to let some quality bang-time go to waste, we've been coming up with creative positions for sex so that he doesn't have to move his leg.

One of these positions entails me laying across his chest in a sort of upside down 69. He decided to use the vibrator today. He's getting me close to climax and, since he knows I squirt sometimes, he was getting prepared for a possible onslaught of epic cum-portions. I start to climax and instead of cum, I squirt piss out onto his chest as I orgasm. I run into the bathroom to clean up as he lays on the bed laughing his dick off.

tl;dr Always pee before sex.

Edit: [The incident](http://imgur.com/Wlu8bSS)",TIFU by pissing on my boyfriend,538
sobakedlol,19,107,1cgive,399,"Hello TIFU, I'm here to followup and not be a scumbag OP!  It was a crazy weekend - between birthday extravaganza celebrations and all this fucked up stuff happening in Boston I haven't had time to post a followup to [me being baked off my ass at work](http://www.reddit.com/r/tifu/comments/1c87ca/tifu_by_accidentally_smoking_hash_during_my_lunch/), sorry about that!

**Good news, I'm still employed!**

Friday was just.... Hah!  Even though I was weirding the fuck out it ended up being pretty anticlimactic when all was said &amp; done; I barricaded myself in my office and proceeded to Reddit &amp; watch the fish &amp; giggle for 45 minutes, then locked the doors and wandered home.  Given nothing bad came out of it I'm honestly pretty glad that happened, if for no other reason than it made for a pretty good story.  One of my coworkers must've known something was up when she walked in and I was talking to the fish (to all those who asked, he's red!), but to her credit she just laughed at me and walked away.

Anyways, thanks to everyone for reading and for keeping me entertaining / borderline sane while wrecked the other day.  Stay cool guys &amp; gals!


Much love,

A moronic stoner",Followup to being ripped at work (love you guys),506
brownmike3,69,63,15alv6,397,"  So I've been talking to this girl right.. We went to my favorite taco truck for a quick delicious bite.  This truck in particular serves your tacos with avocado, pickled jalapenos and grilled onions.  We each ordered 4 Tacos and ate them down by the river, parked in our car.  Somehow, the post taco conversation led to kissing, heaving petting then finger banging.  That's where I fucked up.  I hadn't washed my hands after eating both our jalapenos.  She slowly pulled away as the discomfort intensified, asking, ""what did you do to my vagina!?""  It took me a second to realize my error.  Whoops.  I dropped her off at home so she could rinse off.  Fack.. ",TIFU and now this girl is rinsing her vagina..  ,460
wutabum17,46,101,zpft9,398,"When I want to smoke a bowl and it's really late I like to go in my front yard for a change of pace.

Well this time it was 5 a.m. and there were a few more cars out but still quiet most of the time. After 10 minutes a van that looks like [this](http://world-viewer.com/data_images/chevrolet-van-g20/chevrolet-van-g20-07.jpg) comes around the corner and the passenger throws something at the side of one of my neighbors houses and then passes the next house and throws something that hits my adjacent neighbor's car and I hear a thud and a splat. So he continues through my neighborhood going down every cul de sac doing the same thing and then leaves.

Apparently this is the right amount of marijuana and ambition to do something for the good of my neighborhood that I assume it's the worst, which is really just a couple of douches throwing eggs at random houses. So my dumb ass quickly packs up the materials, hides them behind a bush, and runs upstairs to get my phone so I can do what I think is the right thing and call 911 w/ a license plate #.

So I cruise around my neighborhood not seeing the van, or anyone else for that matter, until I get to the final street and lo and be hold, the van is coming towards me and we reach a stop sign at the same time so I turn after him to a stop light. 

I call 911 and say there's been a van w/ at least 2 people and one is throwing things at houses in my neighborhood. The operator asks what it was they were throwing and I say I don't know. Eventually she asks if it was a newspaper but by that point I had already answered a bunch of other questions and wasted her time.

**TL;DR: I wanted to be a good neighbor so bad that I ratted on a couple of what I thought were douchebags only to find out that my suspects were throwing the morning paper.** ",TIFU trying to be a decent neighbor,499
CallMeCatman,67,85,uz7mg,392,"Kinda self explanitory. I was walking in the halls, talking to my friend, when I tripped on whateverthefuck. Little did I notice the girl infront of me. I fell face first into her chest infront of a hallway full of kids. Accidental Motorboat. I have never been so delighted to fuck up so badly...",TIFU by falling face first into boobs.,477
CatBawx,37,108,1o0rfy,390,"It all sharted when I went out the night before and decided to eat jalapeño poppers while drinking

Fast forward to the next day...

What seemed like a regular day ended worse up worse than ever. Basically my roommate took off work today to get his car checked out and I thought ""Hey ill go along for the ride"" we didn't think about much more than that. Anyway we get to the place and they tell us they have to hold the car for a few days to fix things which was something we did not plan for

We were stranded but we decided to start walking to his grandparents which turned out to be an hour and a half of a walk. It was awful but boy did it get worse. About 30 minutes into the walk I felt that familiar kick in my stomach and I quickly reflected on my past meals which came back to the jalapeños. By god I had a severe case of the shits and there wasn't a toilet for about another mile. 

For the length of that mile the pain of clenching and walking was unbearable. 

As soon as I saw the closest fast food place I couldn't hold it anymore. I had released my clench and shit in my pants. I ran into that KFC like I've never seen a toilet before. That pristine white beauty my salvation. I let go and I could feel it going all over the place. It was rough and it was ugly. It was amazing. I didn't get to enjoy it for long after. I shuffled for toilet paper to find that there was none. I knew my choices were to use the sink or go out with shit in my pants.

I tried to lock the door but the button got stuck and wouldn't fully lock (I thought it was locked because it got stuck in) and leaned against the sink splashing water onto my ass

Not soon after a KFC employee entered the bathroom to my surprise. Saw me with shitty pants around my ankles splashing water onto my ass.

TL;DR Ate jalapeños, had to walk for an hour, got the shits, got walked in on while splashing water on my ass.",TIFU by eating jalapeño poppers and going with my friend to get his car checked out,498
serpentine1,110,106,zvzvh,391,"Really the title says it all. It all started two nights ago. It was poker night with my friends. All of the sudden my friend says ""did you guys know that Carly Rae Jepsen has a sex tape?"" Anyways, fast-forward to the next night. I'm on Facebook video chatting with my friend and IMing the girl I like. My friend starts singing Call Me Maybe so the obvious thing to do was tell him that Carly Rae Jepsen has a sex tape. He tells me to send him a link, so I find the video and send it to him, or so I thought. Really I accidentally sent it to the girl I like. It is hands down the most embarrassing thing of my life. Fortunately she thought it was absolutely hilarious.",TIFU and accidentally sent the girl I like porn.,497
arandomguy452,192,238,1nex9j,392,"Alright, this happened a week ago, BUT, i feel this Subreddit should hear my story. This is also my first post.
It was 3 AM, just got off using my computer and looking at Pornography,
I get in bed, and then turn off the lamp on my nightstand, then i start Fapping away after a few minutes... This is where the shit hit the fan, little boys and Girls, as i was whacking off, i thought i'd do some... Sounding with my usual Mechanical friend that i have. so i shoved it in, slowly, but deeper each time, and i had done this before, infact, alot. so my Golden Shower hose was fairly wide enough to fit it in, so i kept going, then, suddenly, i shove it in all the way by accident.... I then spend 25 mins trying to pull it out... but [IT WAS NO USE!](http://www.youtube.com/watch?v=kMUvFw0VlY4). the thing was stuck in there.

So my next thought is, wait for my father to wake up, and tell him what happened 5 AM rolls around, and then my dad wakes up, so i immediately tell him what happens, he then hurriedly gets dressed and takes me to the hospital, 10 mins later, we're inside the hospital, i get led into a room with my dad, it looks similar to an Operating room, but.. smaller. I lay down on this Patient bed and wait, doctor arrives, shit happens, then he gets the urologist, who bears a Striking resemblance to The Governor from The Walking Dead. TV version. Anyways, he does some Stuff, looks at my Peen to insure how deep this Mechanical Fiend is inside my Shlong, etc. 

He then leaves again, humming some weird Funk-like tune, and then him, The doctor, and the Male Nurse arrive with the WMDs. He then pulls it out, almost violently with 2 pairs of Surgical Tweezers while the doctor applies a Numbing gel onto my Man noodle, it took probably 5 mins... but it felt like an hour. BUt then finally, he gets the thing out, then the Urologist immediately says ""Hah, wanna keep it?"" and the doctor then says ""Remember, things don't go in there, they only come out of there."" and then they laugh it off, and all i can think is ""Thank FUCK for plan A."" because the doc said there was 2 plans. Plans A and B.
Plan A was pulling the thing out with no Surgery. Plan B was Surgery.
On the ride home, i looked at the discharge papers.. It said in big, bold letters ""DO NOT ATTEMPT THIS AGAIN."" My father said it kinda goes without saying.....

tl;dr I shoved a Mechanical pencil down my urethra and then had to go to the hospital to get it removed.
Edit: Also, from that day forward, my friends now call me Mech Dick or Pencil dick.... I Don't think i'll live that down.",TIFU by Shoving a Mechanical pencil down my Urethra VERY NSFW,630
lgf92,31,71,16uomu,394,"So I live in Quebec, where French is the language of 80% of the population, and I was raised in another country with English as my first language. So I tend to get grouped in with the English-speaking Canadians - and the running joke in the province is either that they don't speak French, or when they do, they do it hilariously badly.

So, determined to prove them wrong, and having studied French to university level, I have embarked on a campaign to try and get into as many French conversations as possible, if only just to improve my level and get used to the accent. So I'm at a staff party (I am the only English-first-language member of staff) this evening, it's quite a formal event, people have suits on and all that. Dinner's served, and my boss gets up and makes a speech. Everyone claps. Then, as the ""new import"" (as he refers to me), he asks if I'd like to get up and talk about my first few months in Quebec.

So I walk up to the front and clear my throat, ready to unleash my best French on a room of my peers. For the first minute or so, everything goes perfectly. I pronounce stuff correctly, I don't hesitate and people are listening.

Then, I decide I'll up things a little bit by using an idiom - I wanted to say that their welcome had took my breath away, and I really liked/appreciated it. Now, in French, to say that, you say [something] ""m'a coupé le souffle"" [pronounced ma coo-pay luh soo-fluh]. So I think ""this'll impress them"" and I come out with something along the lines of ""l'acceuil que j'ai réçu dès mon arrivée m'a sifflé le cul, ce qui j'apprécie"" [lakkuy kuh zhey reysu dess mon arr-ee-vay ma see-flay luh cool, suh kuh jap-ray-sea]. Someone sniggers as I realised I mispronounced the last part, mixing up the ends of the words. I think nothing of it, just thinking people are laughing at my funny foreign accent. I finish and wait for a stuttered round of applause.

People struggle to keep a straight face as I walk down, shake hands with my boss and he says ""thanks for that [lgf92], it was really...interesting.""

When I get back to the table, someone asks if I didn't mean ""coupé le souffle"". I said ""yeah, didn't I say that?"" He says ""no, you said 'sifflé le cul'...[in English] which means, er, whistled in my ass."" Laughter all round. I drink another couple of glasses of wine.

TL;DR - told a room full of French speakers that I really liked it that their welcome had whistled my asshole.",TIFU by accidentally describing a sexual fetish in French to a room full of native speakers,465
tifuthrowaway1994,70,103,11uwsx,390,"[Original post](http://www.reddit.com/r/tifu/comments/11ts0x/tifu_by_ignoring_my_doctors_advice_nsfw/): Thanks ~~to most of you~~ for your replies! Edit: I'm in a really fucking good mood right now. No comments ruffled my feathers.

So there I was, crying my eyes out, when my roommate came home. She gave me some comfort and then told me to stop crying and go back and talk to him. I brushed my teeth, took a quick shower, and changed into some clean clothes. I grabbed a package of unopened paper towels and a box of Lindor chocolates (courtesy of my roommate… she's pretty awesome).

I arrived at his dorm. I knocked. No response. I knocked again. Still no response. I sat on the floor and proceeded to write a lengthy apologetic text message to him. As I was writing, I heard someone coughing inside. I stood up and knocked again, belatedly aware that maybe he wasn't home and it was one of his roommates. But it was him… wearing a bathrobe. He looked shocked to see me. Before he could say anything, I rambled about the antidepressants and that I panicked and left because I was so embarrassed and upset. He tried to interrupt me, but I said it was really shitty of me to just leave him there with that mess. I said I would pay for any cleaning costs. I apologized. I felt like crying but managed not to.

He just smiled at me. He told me to look at the couch. I noticed it was a different color.  I was very confused. ""Yeah, living in a dorm and all, we bought a couch cover. And there was a blanket covering the couch.""

I felt so relieved and smiled too. I also noticed he'd cleaned up the mess. The place smelled like Febreze.

We sat down and talked. He admitted that the vomit was gross (the reason he didn't answer the door was because he was in the shower). But he added that he was very worried about me and was glad I was okay. He was very relieved that I came back to explain things. He said I could keep the paper towels but not the chocolate. Ha.

We talked all night, and we ended up falling asleep in his bed (so, yes, we slept together but didn't have sex). He said he really liked me too. He also said we should go on a few real dates and take things slowly. He said something like, ""I really, really like you. I want to do this right."" I might have melted. We learned so many things about each other. I like him even more and vice versa. Today I helped him with the laundry. The couch cover is being air dried but it looks like the stains didn't set in. Phew. He said he'd never tell anyone about last night. After class tomorrow, we're getting coffee. I am giddy.

tl;dr: Went back to crush/classmate's dorm, explained myself and apologized, classmate/crush said it was no big deal and he was more worried about me, we spent the whole night talking, fell asleep together in his bed, we're going on a date.","TIFUpdate to ""TIFU by ignoring my doctor's advice""",493
rocksandshit,119,64,1o8xgx,386,"This happened to me yesterday, and it's by far the worst thing that has ever happened to my life and will probably ever happen. It was so real that I was shocked by how real it was.

So I've been recovering from food poisoning for the past couple of days and I'm an avid rock climber so I haven't really been able climb recently because of this...

Yesterday, I thought what the hell I'll try it out.  I've been slowly getting my appetite back so I had breakfast and lunch so I thought I was all good.  WRONG.  I decided I should have a burrito with beans and extra hot sauce later that day, probably about an hour before rock climbing.

I'm feeling good, I'm feeling great.  I can't wait to climb.  I head into the place, scan my card, lock up my bike on the bike rack, put my clothes in the locker, put on my climbing shoes, put my gear on, get a random partner to climb with because I went by myself... and now I am ready to go.

My partner was a pretty cute chick as well.  Very positive girl and very excited to climb.  We rock paper scissored to see who wanted to climb first.  I won.

I'm getting ready to go and I take my first step on the wall.  ....But... something doesn't feel right.  I'm about 7 feet off the ground at this point and instead of going to the bathroom just incase I need to poop, I stayed climbing.  Now probably about 15 feet off the ground, make the 20, make that 30, 35, 40, now about 45 feet in the air I make it to the top.

As I rang the bell at the top I had a sudden urge to fart.  I said fuck it, and I did. 

I sharted.  I can feel shit running down my leg. I'm 45 feet in the air shit in my shorts.  I feel another strong feeling coming from my stomach and there's no way I can hold it.  I shit my pants.  I shit my fucking pants. 

BUT WHY IS POOP RUNNING DOWN MY SHORTS... POOP SHOULD NOT EXIT MY SHORTS 45 FEET IN THE AIR.

This is the part where I could not believe what happened.  I will never forget this.  This actually happened.

The poop landed on her fucking face.  I have never heard such a horrible scream in my entire life.  I look down and she screaming like crazy, with poop on her face, and her holding me up by the rope. She doesn't know what to do because I'm in the air and she also has shit on her face.  

She starts puking because of the smell, meanwhile this is happening theres like 60+ people in the building, people are laughing, taking videos, and freaking out because of the smell. She's fucking screaming at me and calling me names.

I kept yelling at her that I need to get down If I don't want shit to keep dripping from mid air.  She finally let me down.  And my god, up close and personal with this gorgeous blonde, but now with shit on her face and puke on the ground.  She ran straight to the showers...

EVERYONE IS FUCKING STARING AT ME AT THIS POINT.  I have no idea what to do.

My first reaction? Run the fuck out of there and never come back.  And I did do just that.

Right when I left the place, I realized, fuck, my wallet, my keys, my bike, my phone, and all my shit is in my locker.  I said fuck it I'll get it tomorrow.  I walked home with shit in my pants and my roommate buzzed me in.  

So in about 30 minutes I'm going back over there to get all my stuff.  I have super long hair so I plan on shaving it before I go so I don't get recognized.  This was the worst day of my entire life.

TL;DR: shit pants mid air, puke and shit everywhere

EDIT: I UPDATED IN THE COMMENTS SECTION ON MY VISIT BACK OVER TO THE ROCK CLIMBING PLACE. THE UNTHINKABLE HAPPENED.

EDIT #2: UPDATED THE DATE IN THE COMMENTS. I'M A NEW MAN.
",TIFU by going rock climbing... with diarrhea,450
jazzyd38,84,114,18zk0d,384,"Today was a real WTF moment for me, while taking a shower, i, for some reason decided I wanted to try to stick my navel in the shower knob type handle. It was a little higher than i thought so i kinda stood on my toes and tried to put it in. While doing this, my penis touched the cold glass shower door and i shrieked and slipped in the tub. Now my neck and my ass are in pain all because i wanted to stick my bellybutton into a shower knob.

the shower knob from the outside (no penis, i promise):  http://i.imgur.com/yI0jLZd.jpg
",TIFU by trying to stick my navel in the shower handle,498
iKilledMyFunny,38,39,tmaaw,388,Well actually its not like I fucked up today. Its like I've been fucking up for the past 120 days but just realized it today.,TIFU - Had been applying for a job for 4 months now. Didn't get one single call back and today I learned that I had the wrong phone number written on my resume.,427
toolongreaditall,74,229,1157j3,380,"So, the door in my room has a gap of an inch or two where it doesn't reach the floor on the bottom. The cat likes to paw down there and generally try to claw her way into my room. This is fine and usually pretty funny, except for today under the circumstances. I was enjoying some ""gentleman's alone time"" at my computer desk and I had just finished, and while sitting there, I happen to hear a meow at the door and make the HUGE mistake of looking. There is the cat, her face shoved into the gap as far as it can be, and she is just looking at me. Straight into my eyes. For like, three full seconds, while I still have my man parts in my hand. I think something has fundamentally changed in our relationship.",TIFU by making horribly inappropriate eye contact...with my cat.,609
RD_Is_Best_Pony,163,111,16e2dv,379,"Title says it all. I got a bit randy during my morning scrub, and as you know, water makes a terrible lubricant. I decided to use some slippery shampoo to increase pleasure, and I got so into it that a sinister wayward drop found it's way into my urethra. Needless to say, upon climax, I felt as if my member had been torn off. The sharp, stinging sensation did to a fine job of completely jolting me awake, so that's a plus I suppose


TL;DR Shampoo and piss-holes don't mix.  ",TIFU by using shampoo as lube,490
Vortex851,113,76,14shfq,391,"I would like to start off by suggesting that Dr. Dre sodomize himself with a microphone covered in brass tacks. Why? I'll tell you. I had been given an apparently ""top of the line"" pair of Beat Tours (the ones with the ear buds). They cost about $250.00 with tax. First thing I noticed was that the sound was absolute SHITE. Second thing was a bit more obvious, a month after purchase the right bud just stopped working entirely. I still grudgingly used them, as having only one ear bud in decreases the chance of death by bus while walking. Yesterday while on a bus listening to an audiobook I began to nod off with right fist resting on the side of my head. I was startled out of sleep by a crazy man jibbering about some new form of jabber. In the process of the startle, to catch my head from falling I used my fist essentially punching myself in the ear. The ear bud (shaped like an battle arrow that's meant to go in and not come out) jammed its way deep into my ear canal and detached from the headphones. At first I was just stunned looking at my earphones trying to figure out where I dropped the right one.  I felt a ""funny"" feeling in my ear that I quickly checked with my finger thus boring said ear-bud deeper. The friend I was travelling with looked and swore he could see NOTHING in my ear between fits of red faced laughter. Then came the PAIN. Like a deep earache that has decided to end its life by repeatedly banging its head against my ear drum. I thought I could get it out with tweezers and a mirror. Long story short NOPE. So I hopped off the bus at my stop and transferred to a bus that's on a route with a walk in clinic. Arriving at the walk in clinic tears running down the right side of my face I was given a info sheet for my information and for what brought me to this fine establishment today. I wrote ""Got earbud hella jammed in right ear"". Upon giving the (moderately attractive) young nurse my sheet, she looked down at it, looked up into my face and broke down laughing. Pretending that I had no more fucks to give that day, I Just took a seat in the exam room and tried to think about puppies, titties or anything other than the fiery cataclysm that was going on in my right ear. When the doctor arrived she read my chart, took one of those ear scopes and looked in my ear. Under her breath I'm %92 sure that I heard her mutter ""holy fuck"" then she left the room saying she'd be right back. There could have been more laughter in the hallway but I can't be positive. She came back wielding the most vicious pair of long shiny pliers I have ever seen, and it was about then that I resigned myself to spend the rest of my life with one working ear. It took her only about 2 minutes to remove the ear bud but every second was agonizing pain. It felt like someone was pulling a barbed arrow from the middle of my brain out through my ear. When she finally fully removed the damn thing my relief was palpable. I hugged her (half out of thanks half out of getting to feel doctor titties on my chest) and I left the room. On my way out of the clinic the nurse I had first talked to was on her phone laughing, and by the sounds of it probably at me. Lesson to learn here children. If you have earphones with detachable buds superglue them bitches so this won't happen to you. I did a little research and this shit is dangerous it can permanently scar your ear drum.  Oh and if everyone could give Dr. Dre a good swift kick in the box that would be cool too.

TL;DR Dr. Dre Beat headphone bud got lodged in my inner ear canal. No one could see it or get it out. Went to walk in clinic where moderately attractive nurse laughed at my misfortune. Had what felt like an Alien Symbiote wrenched from deep in my skull. Was laughed at again while leaving office. Went home drew a bubble bath ate some chocolate and softly masturbated myself to sleep


Edit: Just wanted to remind people that I received the beats as a gift. I did not spend $250.00 on headphones that make every performer sound like Bob Dylan. ",TIFU by getting an earbud so deeply jammed into my ear canal that it needed medical attention.,467
shamefullFailure,188,41,tl7bl,382,"Edit: 

Thank you Reddit, and thanks to every one of you who supported me, as well as those who did not.
Compared to how I felt when I posted this, I feel much better, even if I still worry about the consequences in my neighborhood.
I'm now going to get some sleep. Sorry to all who I did not replied, I'll try to catch up tomorrow, even if it's only to thank you.

Good night Reddit.

-----------------------------------------------------------------------------------------------------------

-----------------------------------------------------------------------------------------------------------

Edit2:

Update on Monday evening.

I spent a normal night, followed by a normal day. The only times I could think of the event were on the positive side, to try to use it as a valued experience and get out all the lessons possible.
My only coward move: I decided to doge the neighborhood issue and move to a new place. Will put my twenties behind me and use my newly and hardly earned experience to move on.
No news from the girl, no news from the cops, no news from the news. Might be early but I doubt than I'll get any actual trouble. My back is covered.
So in the end, this TIFU of the week (thanks to the mods) ended not so fucked up. 

Thanks to Reddit :)


-----------------------------------------------------------------------------------------------------------

-----------------------------------------------------------------------------------------------------------

Original Post:

So as the title says, I’m a 27 years old guy into bondage and shibari. I was clubbing with a friend and I met this nice 18 years old girl. We started talking and dancing then we took some drinks and started making up. We went to my place and she undressed herself and we started the preliminaries. Since she was very nice and that she did some kinky talking, I opened up myself and told her I was into bondage and that I wanted to tie her up. She agreed and laid down into my bed spreading her arms towards the bedpost. As I reached for my rope in the closet, a standard white rope from the general store, she freaked out, snapped, and ran out of my place, naked.

I stood still, shell shocked, for what could have been seconds or minutes, I don’t have a clue. Then my brain started to process that shit had hit the fan and I “decided” to follow her because the only two other options I could come up with were hiding and or fleeing, neither of which seemed very smart given that at that point I knew I would have to deal with judgment of others. I did not run, in order to try to not seem like I was pursuing her. I was still in underpants, just because my brain did not realized it, but on second thinking, I guess it helped to put myself in a level of vulnerability similar to hers, or at least not as menacing as if I was a fully clothed guy running after a naked girl.

It was around 5 am, I heard her knocking on my neighbor’s doors at the upper floor. As I went through the stair case I heard my neighbor open the door then the girl’s voice, but I did not understood a word, and then the door being slam closed. I stayed in front of the door for a few moments trying to hear what she was telling, but I was still unable to understand it. I slowly knocked and put my hands over my head.

After about a minute, my neighbor, a very nice black lady, opened her door. I had never met her before, talk about first impressions… As she said nothing I apologized for the inconvenience and as I had no idea what she had been told by the girl, I bluntly told her the truth. As she was still silent and that she still looked half asleep, I proposed to go fetch the girl clothes and belongings, she said ok and closed the door as I turned back.

Back to my place, I gathered the girl’s stuff and as I put my clothes on, I started to really get afraid about what was going to happened next. I was sure the cops were going to be called, that I would end up in jail, that it was the last time I was leaving my flat before a long time. I watered my plants, shut down the electricity, dropped the key in the mail box, and left.

Back to my neighbor’s door, I gave her the girl belongings, and she told me to wait here. I waited. I heard them talking, again, without getting the meaning of the words, certain that they were calling the cops. She came back a few minutes later and, surprisingly, told me to get in, to discuss and to try to settle down the matter. 

So I followed her into her place, we sat around the coffee table. The girl was here, silent, avoiding looking into my eyes. I think she kind of realized that she overreacted, but that she was committed at that point, and that given the situation it was futile to try to fix it up. My neighbor asked again what had happened. The girl said nothing but that she got afraid. I, again, told the truth, that she agreed to try bondage. My neighbor then said that “we” were not calling the police, I nearly smiled and jumped of relief and happiness but I managed to contain myself hiding my face with my palms.

She also said that she did not know what bondage was. Awkward moment for me, as I explained it to her, I saw her face gradually turn from sleepy to disgust. She told me that it was no way to treat a girl; I tried to argue that she was consenting; she said I should be ashamed, and willingly or not, that’s what I did. I felt ashamed. I still feel ashamed, and that’s seriously killing me. I nearly throw up typing this.

She then told me to call and give them money for a taxi, and that she would bring the girl back home. We left her place and they left the building, I have not heard of them since. 

I went back home, my legs crumbled as I closed my door. So did my mind as I cried as I never cried since my teenage years. I crawled to my bed, sobbing, and after a while, for the next 24h, felt asleep, or rather my brain turned off from the shock. 

As I woke up this morning, I wondered, hoped, that it was just a nightmare, but my rope on the floor and her perfume on my sheets left me no doubt. I threw up.

Now I’m trying to deal with this horrible feeling, guilt mixed with shame, the worst I’ve ever felt all my life. In the pas I’ve had about a dozen of bondage experiences, all consenting, some for their first time. I also had my lot of rejections. I know that when she said no it means no. But never someone did say yes only to flee as if I was to rape her, until now. Sure we had some drinks but we were far from being drunk. And as far as I know she did not deny being consenting. The only thing I heard her say is that I scared her.

Am I really guilty? Should I really be ashamed? Is there something wrong with my fetish? Is there something wrong with ME? What should I think? What should I do? 

Please Reddit, help me.

TL;DR: I proposed bondage to a girl, she said yes, then freaked out at seeing a rope, ran to my neighbor naked place, did not call the cops, but now I have to deal with this horrible feeling and social consequences.","TIFU: I'm into bondage. I met a girl in a club and she agreed to be tied-up, but when she saw the rope she ran out of my place, naked, and woke up my neighbor.",423
Alerion_,76,138,1o5d4v,383,"So my university's parking building is under renovation work. It's getting free/taken spot indicators and free spot counters per floor installed. So I parked in the specific floor which was getting work done today and I came back to see the back window destroyed because something fell on it.

The car is now on it's way to the dealer waiting for Nissan to import the new back window. Apparently it has to be manufactured somewhere because the car is 16 years old and they don't make it anymore.

Edit: This is Colombia, so please keep in mind things are quite different here than in the United States.",TIFU by parking my car in the university parking lot,521
awesomecanadian,58,118,1fqbl5,379,"This was actually a couple of years back when I was working as a security guard at a construction site.  There was nothing happening on Sundays but we still had to be there to make sure that nobody messed with the equipment or entered the site.  Anyway, I was bored with reading and started feeding the squirrels, tempting them with food in my hand to see how close I could get to them.  For some reason I decided that it might be fun to see if I could actually pet one.  The video link below shows the outcome...marked nsfw due to language.

http://www.youtube.com/watch?v=SlVKcStrWuA",Today I fucked up by poking a squirrel...,497
dyebhai,45,114,181ag1,381,"TIFU by misjudging my priorities...

So, I've been home sick all say.  Generally not feeling so hot.  Coughing, sore throat, general lethargy, and a bit of bowel distress.  

Anyway i tried to eat some supper, just soup and a sandwich.  Shortly after, I was informed that I would be vomiting.  I prostrated myself in homage to the porcelain god and upon the first heave also proceeded to soil myself.   Yes, reset the counter...",TIFU by misjudging my priorities,495
BIGkeith70,77,62,1017j1,382,"My friends gf caries pepper spray with her.  Me being your average 20 year old genius, had her spray my hand to see if it would do anything. Turns out that burns like a mofo.  To make things worse about ten minutes later I went to take a leak.  I had forgotten all about the pepper spray and grabbed hold. My friend heard my cries of pain and opened the door just in time to see me hosing my junk off in his sink.",TIFU and got pepper spray on my manhood,444
MySonStinks,151,59,12e7lw,380,"So my kid and I are roughhousing before he goes to bed. It's a hoot! Quality time for everyone. Happy memories all around. Until, in a moment of frantic, ticklish thrashing, he slams his face into the edge of the TV stand. It ripped his forehead open, and of course head wounds bleed like crazy so he was *incredibly* freaked out even though it wasn't that bad of a cut, all things considered. 

So instead of sending my cheerful son to bed I had to help him wash tears and blood off his face because I was too dumb to notice how close to the furniture we were. Now I'm at my overnight shift, sitting at my desk, feeling like a huge asshole and hoping he can wear his Halloween mask tonight without it hurting the big gash on his face.",TIFU and accidentally wounded my son's face,439
UCF_FINatic,187,144,11rvek,380,"As a professional student I don't get to go out and party that much. Last night, my roommates (also professional students) wanted to go out. We start pregaming at our place with Crown and some Beer (seperately). Fast forward until early this morning:

I wake up and my nostrils are greeted by the most horrific smell I have ever encountered. I look around me and there is literally shit on my bathroom floor, smeared on the toliet seat, between my ass cheeks, and on my hand somehow. Upon further inspection, I notice puke on the side of the toilet and other various places around the bathroom and tub.

What I think happened was that I was taking a dump, realized I was going to puke tried to change positions and then puked and shat everywhere. My bathroom looks like a war zone.

Don't worry it gets worse. After showering myself and crawling to bed I fall asleep for a couple more hours. The next time I wake up I can tell it is going to be a long day, as I am hungover as hell. I text my roommmates and beg them to make me food (I was too hungover to get out of bed). They bring me food and water and I begin eating and drinking to help with the hangover. I still feel nauseous. Then I can't tell if I have to burp or puke (again) and discover a little too late that it is the latter. I sprint to my bathroom but it was too late. I projectile vomit on the outside of my bathroom door and on the bathroom floor.


TLDR: Puke and shit everywhere; I'm not drinking for at least a month.

EDIT LINK ADDED (NSFW): [NSFW](http://imgur.com/a/d8T4N)",TIFU You think you had a shitty night?!?,524
UndercoverThetan,48,78,1ao68w,374,"*First I must tell you a few things; this happened over six years ago, I posted this as a comment in an /r/funny thread last night (It was too late and nobody saw it), and I figured it would be more appreciated and public in /r/TIFU. I am ready to confess.*
 

For me, every toilet is a foot flushing toilet. I will tell you a little tale of the moment I lost all sense of personal innocence (as told by thirteen year-old me).
 

Thirteen year-old me (six years ago) is on a family winter vacation to the upper Colonies, everything is pretty awesome and I am visiting New York City and shit. I go down to Boston Massachusetts with the family, and everything is pretty damn sweet. Got to play in some snow (Texas boy) and just diggin' Boston in general. Parents see good reviews for ""The Barking Crab"" along some sweet-ass river and we decide to go. We had been walking around all day and I had drunk a liter of Poland Springs, so I am busting at the seams. We sit down after a short wait and I wander around the shack to find the bathrooms. I find it, and it was like the Seven Cities of Gold to me at the time, I enter to the strange and pungent smell of a New England hobo. All stalls are full (no urinals if I remember correctly), and one is open and housing a shaking hobo. A gentlemen clad in Red Sox garb is leaving and ominously tells me with a strong Boston accent, ""that guy is cleaning the pipes, if you know what I mean (wink)"". I say, ""Of course"", pretending to know what he was talking about, and continue to stand outside of the open stall. It takes a few seconds for my distracted neurons (remember, I reallyy have to pee) to fire in the right order and inform me that the homeless man is jacking off into the toilet. Now this is where a normal human would leave (just as the man before me did), yet I find myself mesmerized by the unusual spectacle before me. His head jerks back and lets out a satisfied sigh, he then turns around and leaves without so much as a word and without washing his hands.
 

It dawns on me that I just watched a homeless man orgasm (from behind so no homo), but I have to piss like a racehorse so I soldier on and enter. I unbutton and unzip my pants and whip out my small pre-pubescent penis, and let loose as I release a noise, not too unlike that of the hobo who preceded me. After a couple of quality piss-shivers, I reached to pull the flush lever, then pulled back my hand with a layer of gelatinous creamy goo. I had watched a porn film before, I instantly knew what I had stumbled upon, hobo jizz. I act quickly and run to the sink. Mfw there is no soap. I scald my hands with hot water in an attempt to salvage whatever dignity I had left. After I gave up my futile efforts, I moped back to the family table and tried to act as if nothing had happened. They ordered crab, which we cracked with our hands. I was close to the platter, and repeatedly asked to pass legs and claws to the people I held dearest. My family may, or may not, have unknowingly eaten hobo semen.
 

*And that kids, is why you always flush public toilets with your foot.*","TIFU by using the bathroom at ""The Barking Crab"".",452
ThePlayfulPython,19,74,1n3k3p,379,"I woke up this morning to an abundance of rain.  

Oh well, the show must go on, so I do my hair and hope for the best.  My hair is an excess of frizz, fluff and curls.  A flat iron and products are my best friends.  

Finish up the coffee and am ready to head out the door (still pouring buckets) when I realize my umbrella is in the car.  Not a problem, I can fix this.  Go back to the bathroom and get one of those little bathroom sized trash bags, and proceed to put it on top of my head.  Hmm… there’s some hair still sticking out, so I pull it down further and poke out eye holes.  Success!  HA!  Fuck you mother nature – I win!

Go down to the car and the family across the street is getting their kids in the car.  I wave, knowing I look like an idiot.  They just stare at me – they don’t even wave back.  They just keep staring at me – even as I get in the car.  I don’t think much of it.  At that point I’m not thinking much of anything because my coffee hasn’t kicked in and I’m wondering if I can remember how to operate my car.

Anyway, I start driving to work and about halfway there I realize that I have indeed fucked up.  Mostly because the trash bag on my head was white, had a point at the top and eyeholes poked out, and that the family across the street is black.  

Tl;dr:  I wanted to keep my hair dry, and now my neighbors think I’m a member of the KKK.
",TIFU by wanting to keep my hair dry.,453
warpaint,216,243,1gxrj7,373,"Got super sick, can barely even move. 

I previously had a cold and couldn't really taste them, so I kept eating them.

Now I'm dying. 

EDIT: This is OP's friend. OP is currently in the hospital suffering from severe intestinal blockage. ",TIFU by eating doritos that were expired in 2005. FUCK MY LIFE.,616
iwasfuuckedup,135,125,111hqj,377,"Ok... Lemme first off say I WAS FUCKED UP! Super irritated and feeling great at the same time, i got to work on time. My party came early and my table wasn't prepared. The hostess and I hustled our asses off to set the table up while they waited. The party went off without a hitch! I was making them laugh and they tipped me $200 dollars. After the party the come-down was hitting me hard, but I was still smiling. My coworker told me that she was creeped out by me cause I was smiling like ""the joker"" the jitters were hitting me strong and everytime I grabbed a dirty plate from a table my hands were shaking like crazy! Noone asked me about my eyes (thank god) although my boss asked me why I was so damn happy... A simple ""i'm getting laid after work"" worked just fine. I told one coworker what happened to me and she kept poking fun at me all night saying "" i bet you need a blanket and a pacifier"" but by the end of the night I was super pissed at the whole world and i was snapping at everyone. All in all I made $450 all night and it, for the most part, went well. BUT I AM NEVER DOING THAT AGAIN!!!! FUCK ROLLING AT WORK! TERRIBLE IDEA!

and for those that don't think that was pure molly... It was pretty damn close (I'm familiar with the drug) 

I'm off to work again today to work a double, if you have any questions I will answer them on my smoke breaks.

Edit: I must add however that I drank A LOT of beer thursday night and my bowels were off the hook... About 9:30 last night I let out a fart that was more than a fart... Lets just say I worked the rest of the night without underwear.... TIL molly can make you shit yourself when you are running around for hours.
 

Edit 2: link  http://www.reddit.com/r/tifu/comments/1105va/tifu_by_taking_a_hefty_dose_of_pure_molly_mdma/ 
",TIFU UPDATE: I took molly and went to work last night.,502
caques,48,108,17ritg,375,"My friend was in town the other day who stays at the hotel directly across the street from my apartment. My girlfriend had come over and we went across to say hello and have some drinks. After closing down the bar, we went with my friend up to his room to continue to chat and have another drink considering this particular bar closes at around 11PM. After we decide to call it a night, we say bye to my friend and I tell my girlfriend that I found out that they don't lock the stairwell door leading up to the roof and we decide to sneak up. Sexy times occur, it starts raining and we do some naked rain dancing before deciding to head down. Having consumed a decent amount of alcohol at this point, my feet slip out from under me on my way down the stairs and I literally bust my ass. I get up, recover, and my girlfriend proceeds to fall and seriously bruise her foot. It's been a few days and I have a terrible hemorrhoid on my asshole, and my girlfriend's foot is still bruised and wrapped up for support. ",TIFU by sneaking onto a hotel rooftop with my girlfriend and then breaking my ass. ,483
inimtheTARDIS,97,80,1f7i83,376,"So I am a Senior in high school and today we are having our final check out for graduation, which is on thursday. So the counselor for my school pulls me aside and says ""Could you come by my office sometime today we have to talk about something."" Now Last year I went to summer school, and make up the credits that I had to. And this year I passed all my classes so here I am thinking I'm golden, on track to celebrate with all my friends. So anyways I go down to the counselors office and he pulls up my transcript and says you are missing some credits. Fuck. Long story short it turns out last year we didn't go over the other credits I have to make up before I can graduate, a grand total of 5 credits. Summer school only allows you to make up 3 credits in a summer. So I have to go to at least 2 different summer school programs, which may have to be at night. Also, I just got promoted at my job to a manager which I cannot just work in between the two summer schools so I will have to quit my job. Quitting my job means I will have to live at home next year instead of going to college and living in my own place. Also my parents have no idea so, I have to tell them when I get home. The worst part is it is all my fault and I have no one else to blame it on. Now I know this is not really a fuck up of today but, I wanted to share. So thanks.
tl:dr; Pass your Fucking classes.",TIFU by letting the past four years catch up to me.,456
shiggles3692,116,65,13ddow,374,"So, Reddit. I really fucked up today. I was texting this beautifully hot blonde girl and things started to get heated. I eventually send her some pictures. Then when i got to a picture of my dick, i accidentally sent it to my dad. Usually these pictures take forever to send so you can just say cancel message but For what ever reason it sent right away, the fastest sent picture in my life so i had no chance to cancel the picture... fortunately its just my dick and not me in the picture. I haven't heard back from him, so hopefully he doesn't do anything. Will post back what happens after. not sure if i should lie or tell him sending them to a hot girl. my phone is crashing really bad now after the said delivery. I am shaking right now. I don't want to tell the girl cause i really want this to happen again
The girl is still sending me the hottest shit and i am like trying to be sexy even if i am scared shitless of what my father might say... wow today i fucked up

**EDIT: thank you guys so much for all your help today! this is my first time being number one in any subreddit, or even close! so thanks for your advice and your help. So far after a whole day my dad never responded back to me and i believe it is safe to assume i am in the clear. So thanks for all your suggestion and your love to help me be able to laugh at this stupid thing**",TIFU by sending a dick picture to my father..,439
SOMUCHPOOP33,61,94,1c9szo,371,"I'm a 16 year old girl and I'm quite small. Like any lazy day I was just downing a total of two whole packs (12 in each pack) of these sugar-free mints called breathsavers. In about an hour I was getting that terrible gurgly sound from the deep depths of my stomache. Everyone has had this sound at least one time in their life and we all know that it is the universal have-to-shit calling. 
What happens next I will not go into great detail but it was the worst night of my life. From about 9pm to 3am I was sleeping on the bathroom floor and getting up about every ten minutes to let loose yet another rain of shit. 
Soon the pain subsided and after a little research I figured out the culprit was sorbitol. This artificial sugar alcohol is used in any ""sugar-free"" foods and apparently eating it in excess may cause ""explosive diarrhea."" So now here I am the next morning downing all the water I can because of the severe dehydration. Sorbitol not even once.
TL;DR: Ate lots of mints, had the shits of my life and pain I never want to relive.  ",TIFU by eating two packs of breathsavers.,465
HazardousCupcakes,65,111,1c4j3f,372,"(Technically this is more of a Three Years Ago I Fucked Up, but I digress...)

Back in the good old school days, we had Friday sport. This term, myself and a group of friends decided to join the Representative Touch Footy team, and we were waiting for the bus to take us to our semi final match.
My friend was sitting on the side of the grassy hill where we were waiting, and yelled ""Oi, come over here!"" and patted her lap.

So, naturally I went over and jumped into her lap, in a weak attempt to crush her legs. Much laughing ensued, which attracted the attention of our other friends. So, we ended up in a pile of about 10, resembling a pile of stacked-up chairs.

One of my teachers noticed, and walked over to us, shaking his head slightly. Of course, what is the most natural response to seeing a stack of people sitting in each others laps? Push the stack.
So, with eight people in front of me (with some pretty serious weight adding up there), we fell over sideways.

As the laughter increased tenfold, I heard a very faint clicking sound. Feeling my leg tense up, I looked down. Bad move.

About five centimetres to the right of my leg was my knee cap, hanging (or levitating as it appeared from my angle) in midair.

So, after a number of very unladylike expletives and a bit of yelling/screaming, people noticed that my knee cap had attempted to escape my leg and called an ambulance. 
Then the bus showed up.

So, while my friends went to sport and got their asses kicked by a fellow high school, I sat on the side of the hill with my fucked up leg.
The paramedics show up, and ask if they can try and put my knee cap back in place without pain killers. At this point, the extremely light spring breeze which is flowing feels like razor blades cutting into my tendons, so I wasn't exactly keen on this idea.

So, they picked up the end of my leg and pulled.

I think I punctured an eardrum, screaming. 

They realise that this might not be the best plan, so I'm bundled up onto a stretcher and head off to hospital. Driving in an ambulance with a dislocated knee cap was never on my bucket list, but at least I've crossed it off?

When I arrive at the hospital, I'm finally given the good pain killers (Nitrous oxide for the win, none of that ""Green Whistle"" shit) and the ER physio walks in. It took three people to stabilise me, while he pulled my foot and twisted. Behold, my knee cap FINALLY pops back in! They waited for me to come down of the high of the nitrous before fitting me in a knee brace and crutches.

Note for the wise - a knee brace which holds your leg completely straight, thus making one leg longer than the other, will fuck you over. Worst two weeks ever.

After a month, with crutches, a knee brace and some really pleasant taping, physiotherapy and an inability to climb stairs easily, my knee was finally released from its self-induced prison.

I've never sat in that friend's lap again. I also got an A in Geography from that teacher at the end of that term.

Edit: tl;dr: Sat in my friend's lap, douchebag teacher dislocates my knee, kneecap decides to stay locked to the side until I got to the hospital, drugs then two weeks on crutches.",TIFU by sitting in my friend's lap...,483
smellymckellykins,142,111,1nzhq3,375,"Last night before I went to bed I put Icy Hot on my neck, as to not get it on my bedding I placed a hand towel on my pillow, careful to not get the cold burning fury on my other pillows or sheets. Fast-forward 9 hours, I'm redditing and decide to take a fap break. After ""unloading"" I reach to my regular towel and accidentally grab the towel covered in Icy Hot to clean my manhood... Needless to say my balls feel like the surface of the sun, and my penis is swollen and wondering why I'm so damn stupid! 
TLTR: I used a rag full of Icy Hot to ""clean up"" fapping. ",TIFU by using a towel that had Icy Hot on it....,486
AlexMill,131,226,1b2qw4,366,"I have been dating my girlfriend, ex as of today, for over the past year. I do not have a Facebook and she does, I went onto my computer and her email was logged in with a bunch of posts between her and another guy, those little notifications you get as emails from Facebook about your posts. Well she has been seeing another guy for the past 3 months. Now here I am, heartbroken and kicking myself, clueless as to how I am going to move on.",TIFU by being to trusting,592
Marowak,38,82,x12cg,370,"Basically, my friend had her grandmother's old mobile phone because she had misplaced hers. It was a chunky grey brick with a really big number pad, a very bright screen, and an enormous red button on the back which was to be pressed if she ever fell down (or had any other medical emergency). My friend showed us this phone and we all had a good laugh calling her ""grandma"" and such. She then turned the phone and serious, saying ""and don't nobody ever be pressing this bigass red button because that automatically sends an ambulance to my nana's house"".

Naturally, we all pretended to reach for the button throughout the day. Sometimes we'd team up and perform the classic, ""Hey, look over there! YOINK"". Oh, what fun.

After many larks and good times, we went to a local park and sat on a bench. Naturally, being summer, there were many young ladies in this park; legal young ladies in almost illegal clothing. My granny-celled friend decides to hug me out of the blue and a piercing siren wailed from her handbag. 

""Shitfuckshitbollocksshitpissdamn"" gibbered my friend as she reached into her bag and read ""Stay calm. An ambulance is on its way"" off the screen. 

The grandmother was apparently very irritated when she had to leave her comfy armchair to greet paramedics who were about to break down her front door.",TIFU by calling an ambulance with my penis.,452
[deleted],36,108,1kq93g,369,"I had to welcome the chief guest in our uni function today, and instead of saying honorable guest, I said ""I welcome the horrible chief guest to today's gathering"". FML.
",TIFU by spelling honorable as horrible,477
ewall09,51,100,1kd8h1,369,"This happened several months ago, but I just learned about this subreddit from a friend so I figured I'd post my own TIFU...

I attend college and am part of a fraternity. Since it's the weekend, me and a few of my buddies decided to go to another frat house and have a beer or 10 and party. 

Eventually, as the night progresses and so does our lack of sobriety, we decide to leave and head back to our own house. As we are going to a door that leads us out, we try to open it and it gets (what we thought) stuck...it would open an inch or so and just wouldn't open any further. Not thinking to just go out another way 10 feet down the hall, my friend Spartan-kicks open the door. It opens....and just slams shut. Duhfuq?

We finally decided to go out the other door, and when we come out of the house we see a girl laying in the grass, knocked out and with her nose bleeding. A guy runs over and gets on top of her, yelling at her and shaking her. 

Chivalry kicks in....I'm not about to let this guy get on top of this girl and smack her around. So, (thinking I'm) protecting the girl, I rush over and punch him in the face and he falls over next to the girl and we leave before it causes a scene.

.... it turns out that the door wasn't opening because the girl was holding it closed with her foot, and the guy on top of her was her boyfriend making sure she was okay.

TL;DR: Spartan-kicked open a door, knocked a bitch out, punched out her boyfriend

TIL: Leave Spartan-kicking to the Spartans, and don't think everyone is a rapist.",TIFU by Knocking a girl out and punching her boyfriend,469
naypalm,63,98,13o88j,362,"
I was throwing sticks around and he said in a playful voice: Naypalm, stop throwing those sticks. I then said with a girly voice; ""I'm sorry daddy, please don't hit me again"". 

I immediatly realised what I had said and I wanted to hang myself on the spot. I saw it in his eyes that he knew I knew. It wasn't on purpose. Everyone around me looked at me with disgust. I deserved it.

He forgave me though. ","TIFU by yelling at a good friend of mine who just lost his (abusive) father 'Please daddy, don't hit me again'. ",460
RevenantCommunity,100,88,1lnboj,365,"I'll start by saying that my girlfriend's family are very old fashioned and conservative christians- they don't want her to do anything intimate before marriage, exceptionally strict, etc. She hasn't chosen that path.

Anyway; at her place, we tone down on the intimate stuff because her family doesn't let her lock her doors etc. They're horrific with it, privacy is nonexistent. Today I was enjoying teasing her by pulling her shorts' crotch (short shorts) and underwear with my hand and licking her exposed 'part' for a little bit before letting her pants go and returning to what I was doing. Eventually, we heard her mother coming so I let it go back and went back to what I was doing. Her mother's face was really shocked for some reason- had no idea why. Then realised my SO's pants and underwear were all bunched up and wedged firmly between her labia. The clothing may as well have not been there.

I'm sitting in here alone as they scream at each other, seems her mother caught on pretty much instantly. I definitely fucked up- needed to share.",TIFU by teasing my GF,453
marisunday,72,106,yk4zy,361,"I was applying for local jobs on Craig's List, whilst arguing with a friend about whether less sleep, or more sleep is better, so as it was I was only half paying attention.

When I apply for jobs, I open the Craig's List ad, read about it, and then I have several pre-made drafts saved in my gmail account, and I go to one, and fill in all the info, and hit send.  So all and all, I actually don't need a lot of attention while job hunting.  Or so I thought.

I saw an add for a Church Administrative Assistant.  I thought ""hey, fuck it, why the hell not"", which should have been a hint right there that it was not meant to be.  But I opened a new draft, and plugged in their email address.

This is when the debate with my friend over sleep got a little heated.  I decided to look online to see if I could back up my claim, which is less sleep is better than more sleep.  I could not.  That fucker was going to win.  So I decided I would punish him.

I opened a new gmail doc, and used the little link thing to hide the link for two girls one cup behind what looked like ""www.cnn.com/less_sleep_is_better.html"" or something equally dumb.  I hit send right away.  And then it hit me.

I hadn't opened a new document at all.  I had just hit send on that email to the church.  Along with my resume.

I sent these people the most vile porn I have ever seen.  (I'm sure there's worse, but I am a female, and that's about as rough as it gets for me.)  I am so completely horrified and embarrassed I feel like crying.  But don't get me wrong, the first thing I did was laugh so hard it hurt.

I didn't think I would hear anything back, but about half an hour ago, I got an email from someone on their staff saying they are reporting me to the police. :(",TIFU by sending 2 girls 1 cup to a church that I was trying to apply for a job at.,467
asnof,100,69,xz5qj,363,"Today I was at a safety meeting for work.  The topic came to txting and driving.  There was an accident that involved a semi and a corvette.  The boss said there was a very graphic image and she wanted it passed around.  Well here I am getting all giddy and then I see it.  Not a drop of blood just 1.5 vehicles, this made me laugh because it was so tame and now everyone I work with thinks I am a sociopath.

I have to give a shout out to the posters of /r/WTF for making this possible.","TIFU, I laughed at an inappropriate time",432
Casshole,133,75,tsvdb,369,"My mom always comes home at 6:00. ALWAYS. 
But, the one day I decide not to lock my door, she get's home early.
Oh, and that's not the best part. She caught me watching girl on girl (I'm bi) She freaked out, called my dad, and made me read out of the bible for two hours straight. Now I'm not allowed to have sleepovers with friends, or ever hang out with anyone outside of school, and summer's almost here.
*sighs* And that's not the worst part. Not only did she find out that I was bi, but that I also might have a bondage fetish.
Sorry if this TIFU is long, sorry if it's not. I just needed to rant.

*In reply to some comments wanting the link for ""science"" here it is: http://www.redtube.com/119704
*And in reply to other comments, I'm not atheist, I do believe in God. I just don't belong to religion in general, because I personally think that they're all fucked. Thanks for reading.

*Thank you guys so much. My friend convinced me to show my mom some of the comments on this post, and at first she got mad; but then she apologized. She cried and said that she didn't want me to go through what her step sister did when she came out. She still thinks that it's wrong, but she said that if I really am bi, that she'll try to be supportive in the best way she can. Me and her both cried, alot. I guess this experience was a good one for me and her, and now I think we're a bit closer. Thanks, Reddit!",TIFU: Got caught. Big time.  ,444
mshknglkmlk,57,59,1buw32,362,"My brother, who hasn't had much experience drinking was at an eighteenth birthday tonight (eighteen is the legal drinking age in Australia) and I offered to pick him up so that my parents could get to sleep at a reasonable hour.

He gets in my car, and is seemingly fine. We make small talk about how the party was and I jokingly tease him with ""are you dunk? you're drunk aren't you!?""

Not even two minutes later... vomit, vomit everywhere. Literally, it's on the front and side window, on the gearstick and handbreak.... EVERYWHERE.

I'm never being nice again.",TIFU by offering to pick my little brother up from a birthday party,421
DoomAndSuch,77,45,v7f4j,357,"It had been collecting dust in my drawer for a long time and he wanted it, so I just gave it to him without first thinking about all the pictures I had taken for my boyfriend on that phone. I guess I assumed that past me had been smart enough to immediately delete them.

Past me was not. We got a call from his grandma.",TIFU and gave the neighbor's kid a phone full of naked pictures of me.,402
Scratch_My_Balls,144,106,1oyfg0,358,"I had received free tickets to a football game yesterday.  None of my friends could go on such short notice so I asked a girl who worked for me since I knew she had the day off.  She's 7 years younger then me and I thought she was gay, being that I've heard her talking about breaking up with her girlfriend.  We go to the game, have a great time and come back to my place.  We have very similar taste in music so I throw on some concert vids and make her dinner.  I haven't had a date in a while and it was nice to hang out with a member of the opposite sex.  We eat and start drinking again (already had a few beers at the game).  Next thing I know, we're drunk and making out.  We stop for a minute and I ask ""I thought you liked girls?"".  She is bi.  We drink more, continue to make out and proceed to get naked.  We then have awkward drunken sex as I tell her how cool I think she is.  We stop after a while as I am so drunk I can barely stay hard and I knew I wouldn't be able to finish anyway.  We drink more and then pass out.  This morning I wake up with rock hard morning wood.  After a quick pee, we have sex again.  This time it's really good.  She's on top and I can feel myself reaching the point of no return.  I try to pull out but, she's grinding so hard I couldn't get it out in time and shot at least half a load into her.  She is not on birth control.  The worst part is as soon as I came I realized that even though I liked her I wasn't really interested in a relationship with her.  Now, I have about a day to convince her to take Plan-B.

Edit:  Update if anyone is interested (because I know redditors hate to be left hanging).  I got Plan B and gave it to her.  She said ""What's this?"", opened the bag, started laughing and thanked me.  I still haven't been able to have a talk to her about our intentions.",TIFU by having sex with an employee without a condom,464
trollpatro1,62,165,1l0ek6,357,"I (M 15) live about a mile away from wendys, and decided to spend my friday afternoon with my friends. So we agreed on going and having a snack at wendys. Started innocent enough right? So when we get there I get a classic, chocolate, frosty and and joking with my friends eat it with a plastic knife. We talked, laughed, and had a good time. Eventually we had enough and decided it was time to head back, and we throw away our trash.. all except my plastic knife. Now if you have ever tasted a plastic spoon you would know that for some reason that plastic lollipop is like candy! We were about halfway back, walking on the dirt path when I turn around for a second and to my surprise trip a bit. Woah that was close, i almost died. So stupid me thinks it would be a god idea to keep this knife in my mouth and test my luck again. Well you guessed it a couple feet later clumsy me trips in a random rock and down goes goodman. 1 hour later im at the hospital getting my torn up cheeck looked at. Turns out having a knife shoved through your cheek isnt a seriously injury but i can tell you it was pretty serious to me!

TL;DR Learned that all knifes are evil and i'm smart",TIFU by walking home from Wendy's with a plastic knife in my mouth,522
Weirfish,59,112,1e2e1x,355,"Today has not been a good day, and it's only 1:30.

As I slept, at 9:30, I was having a wonderful dream. I don't remember anything about it, other than it was really enjoyable.

Then, my alarm interrupted me.

Groaning, I sat up, looking blearily at the time, and muttered something offensive to alarm clocks. Reaching out, I grabbed my can of brand-non-specific cola soft drink from last night and gave it a shake. Awesome, still some in there, a nice pick-me-up to start the day. 

I take a sip, and frown. This isn't right. It's granular. Since when was coke granular. Spitting it out into my hand, I'm horrified to find ants. Dozens of them. Crying out in shock, I fling them off my hand, about the room, and begin to spit everywhere, trying to get the little buggers out of my mouth. Panting and heaving a little, I sit on my bed, surveying the formician carnage, and think, ""Fuck this, I'm taking a piss.""

So, I take a sojourn across to the bathroom, lift the seat and let loose the torrents. Unfortunately, I forgot that I had just woken up, and neglected to sit down, and part of me had been awake for quite some time. Inevitably, this lead to trouble aiming, and so there was some splashback, which proceeds to get all over my legs. Well, fuck.

It is now 9:40. I get a call from a recruiter asking me if I was on my way to a job interview I had scheduled for the day. Wait, what do you mean, am I on my way? I thought the interview was at 2pm! But no, it was at 10am, Bugger it all. Okay, so I rush around, coke- and piss-spattered, to clean up a little and put a suit on, phoning a taxi to pick me up (because busses are far too slow, and I don't have the money for a car), and it's that point that my body decides to inform me of having strained every usable muscle in my torso and right arm from playing tetherball with a housemate the day before. So I am now hobbling and groaning down the phone at a taxi company, trying to pull a suit over my aching body. However, godsend, the taxi arrives without incident and I get there in fairly good time.

10:15. Not too bad. 25 minutes late, by my standards (nice and early, nice and eager, after all). The interview begins, and suddenly I have no English. I can't remember what I'm qualified in, what experience I have, who I've worked for, where I grew up, my name, my age, nothing. All gone. Mind is blank. I struggle through the interview with a few prompts, and get out the other side 40 minutes later relatively unscathed, though my confidence on that position is shot. I decide to get a little retail therapy, and hop on over to my local MtG shop (shoutout to /r/magicTCG ).

While I'm there, I get a phone call from the recruiter, berating me for being late. Of course, he doesn't know about the rest of the morning, and I can hardly tell him, but that's not his problem. So, I kiss ass to get through that particular conversation, and arrange another meeting with them for another round of interviewing on monday. It is now noon. I have had enough of today already, and head home to type this saga up.

tl;dr TIFU by drinking ants, pissing on my own legs, destroying my body with a children's garden toy and almost fucking up a job interview, all before lunchtime.","TIFU with ants, piss, tetherball and a job interview.",467
Sir_Dude,52,73,17p6bx,356,"This actually happened about 10 years ago, but my parents keep reminding me about it, so I figure it is worth a post.

Back in 2002, I was taking a summer school class on sign language (I wear hearing aids). The class was offered at University of Wisconsin Milwukee and, for whatever reason, took place in a science classroom.

In this classroom they had outlets for natural gas (to power a bunsen burner), but some genious decided that the knob to turn on the gas should be located on a sink and that it should be colored light blue. Right next to the faucets for the water.

Well one day I needed to wash my hands, so I went to one of the sinks and turned the knob, but no water came out. So I left it as it was and went down the hall to the bathroom.

Yup, it was the knob for the gas and it was wide open, having a hearing problem, I never heard the hiss of gas escaping. They evacuated the whole 8 story building and called the fire department.",TIFU by causing a gas leak and an evacuation.,429
goal-icho,145,271,1nudt6,351,"This happened when I was in 2nd grade and I still cringe about it.

So it was the beginning of the year in 2nd grade and I had no friends. I saw this asian kid and decided to make friends with him. Having never made friends with an asian before I decided to think about all we had in common. I noticed he had small eyes. My eyes were small too but not as small as his. So I walk up to him, smile and say *""Hey look, I can make my eyes look just like yours""* Then I stretch my eyes with my fingers. I think the kid just walked away.

*cringe*

",TIFU by accidentally being racist.,622
BeardedEagle,80,102,1g87br,356,"So I'm at my dad's house and my brother is gone for the day. (We share a room at his house) I have the whole upstairs of the house to myself, and I feel like masturbating. I looked at the clock and saw that it was getting closer to the time we usually eat. I figured, hey, I have enough time. So I get my pants off and start whackin' it. I'm just about to finish when my dad opens the door to see if I want to come down and eat. He opened the door, took one look in and closed the door. Now I'm sitting here telling you this I have no idea what to do. I really fucked up here.

Edit: pulled one of my I's out.",TIFU by thinking I had enough time to masturbate,458
Fecesofwar,13,58,1due4t,351,"My friends and I have been pulling pranks on each other for a few months now. The rules are that 1) you can't break anything valuable and 2) you can't repeat a prank. 

So my buddy Hal pulls an upper decker on me at my place while we were drinking, and I didn't find it until the next morning. I woke to the smell of shit wafting ambiguously in the air, but didn't catch on until I started my morning constitution and flushed, discovering a horrible foul gravy had replaced my own work. I bought a couple bottles of bleach to undo Hal's work.

On Saturday night, we're now drinking at his place, and I'm plotting my revenge. He has a couple roommates but a private bathroom, so I figure I can safely retaliate in his restroom.

Uninspired, I go for the saran wrap on the toilet. I sneak it from the kitchen giggling, expecting to hear him swear when he gets piss on the floor. Having wrapped his present, I withdrew. I eventually lost track of time.

Hours later, more people have come and gone from Hal's party. I'm happily buzzed and I've completely forgotten my plot, when I receive a text message from my friend. My best friend. My female best friend:

""I need help, please come to Hal's bathroom.""

Patricia is a great friend; she helped me through a terrible breakup and stopped me from failing out of grad school. And I made her into a casualty of war.

I slip to Hal's bedroom and knock on the door; I can hear Patricia crying from inside the bathroom. Through a sob she says she needs a towel. I find one and pass it inside, and although the door was only open a few inches before swiftly closing, I smelled it. 

Shit. After talking yesterday, I learned Patricia had decided that #1 was coming with #2, and used Hal's bathroom to be discreet. She shat right into my trap. In shock and horror she botched her escape, and smeared herself her with business. Up her back. And after trying to wipe herself clean with a roll of toilet paper, flushed the entire disaster into the toilet.

Saran wrap wadded around feces does not agree with toilets full of toilet paper. I cracked the window as Patricia huddled under the towel. I helped her into the shower and then slipped out, but she asked me to tell others that she had just vomited a little and felt the need to clean up.

I told her what happened yesterday, and she managed to laugh despite the certain PTSD. She's a good friend. Sorry Patricia.

(No real names were used)",TIFU by escalating a prank war and destroying a civilian.,409
Potatofetish14,67,119,1ghm3l,355,"The other day I was dragged to the zoo by my family. I really don't care for the zoo but went anyway. I brought my cousin with me,who is around the same age as me, in hope that his company would bring a little more excitement to this so called adventure. After walking around for about an hour we found our way to the lion enclosure. Me and my cousin spot a hole in the fence and a wire, which I can now confirm to be an electric wire, in said hole. Being the common sense lacking 15 year old I am I decide to test if it is active. You wouldn't think that an electric wire would be within children's reach, so I decided I'd give it a go. I quickly tapped the wire with my finger or so I thought. But out of fear of being shocked I had closed my eyes doing so and touched part of the fence instead thinking it was the wire. So I tell my cousin that it is indeed not active as I proceed to wrap both hands around the actual electric wire. An electrical current pulsed through my body as I viciously lashed my hands up off of the wire. In doing this I had brought my arms up onto the hole in the fence causing the fence cut my arm into shreds. A family behind me started laughing there ass off at me for being a dumbass, while I was on my knees In shock.

TL;DR was shocked by a wire in a lion enclosure, got cuts all up my arm, and was ridiculed by a nearby family.",TIFU by touching an electric wire in a lion enclosure at the zoo,474
Numl0k,45,97,1mady7,356,"I got done running a few miles and didn't feel like cooking, so I ordered a pizza. Didn't change out of my workout clothes and went to smoke a bowl while waiting for my delicious 'za to arrive. As I'm finishing my bowl I hear the doorbell, so I ash out the bowl and stick it into the pocket of my shorts. I sign the receipt and receive my pizza. I stop the guy before he gets off the porch so I can give him a tip, but it takes me a few seconds to fish it out of my pocket. I see him look at me, and really quickly turn away with a strange look on his face. Not sure what it was all about at the time, but I hand him his tip and go back inside. I look down to realize that my pipe was laying in the pocket of my very-lightweight shorts, making it look distinctly like an erect dick. Perfect head outline and clear shaft pointing right towards my real (And quite flaccid, I assure you.) penis. It must have looked like I was going for *my* tip while I was going for *his* tip. 

Time to find a new pizza place, I guess. 

Edit: The pizza was delicious, by the way.",TIFU by paying the pizza guy after smoking a bowl.,453
Man_Shoes,203,193,1hc8vx,349,"Party tonight, yay. Having fun with cider and vodka shots, lots of metal music.yay. so when I get woozy and sit down for a while, a guy comes over and puts one of his legs over me (so his legs are apart) and arm round me. We talk, everyone is messing around with glow sticks in the dark and some got put down my top. This guy is extremely fit and is the lead singer of a band so I don't mind when he reaches down my top and into my mouth at the same time. Sexy times insue but it gets very heated so we get directed to a room upstairs, condom given to us. Yay. Things are great on the bed, until he asks me to suck his dick...

Being stupid, I agreed and sucked his dick. Pretty soon (apparently I'm good) he came in my mouth and he asked me to lick it all up. That's when I gagged. I tried to get it off but as soon as I put his penis back in my mouth I proceeded to throw up on his dick. And his jeans, and his top. There was no stomach hurling, it just came out like when you pour water out of a bottle.

Got home around 1 am, he's added me on Facebook and he is chatting to me normally apart from one suggestion that we should go to a party again and carry on where we left off..(without mixing drinks) really awkward situation :/ ",TIFU by throwing up on someones penis,542
Schtekarn,46,55,zq279,348,"I'm a foreign exchange student, and when I get nervous, I sometimes mix sentences up, so after a lecture we were talking about 9/11 and he mentioned how his birthday is today, so I look up at him and say ""Oh, your birthday is today? Happy 9/11!"" With a big smile on my face. No matter what I tried to say to save the situation, he won't look at me the same way ever again. ","TIFU by saying ""happy 9/11"" to my professor.",403
axelblaise,53,69,w8arz,345,"my dad hurt his back this morning so i had to fix the chimney myself, half way through my sister came up with some Gatorade for me i took it and opened it and i saw my sister off balance at the edge of the ladder so i lunged over to grab her and ended up over jumping it and tackling her off the edge 


UPDATE:* k the nurse finally let us see her she okay she only broke her leg she can come home tomorrow morning",TIFU by pushing my sister off my roof,414
lbkisawesome,267,131,1gpt08,354,"I'm currently working a temp job at McDonalds out here in the Bay area. The Bay area is EXTREMELY diverse, full of Asian, Indian, Mexican, Russian, etc immigrants. Hell, most of the customers don't speak perfect English. There are many Chinese people here, and I am a 19 year old Chinese American who speakers fluent Mandarin at the basic level. Sometimes, if an Asian looking customer is having trouble saying what they want, I ask them if they speak mandarin. For the ones that do, they seem ecstatic that they can communicate with one of their own in their native language. However, today, when one of these incidents occurred, a black lady asked me ""Why do you ask these customers if they can speak Mandarin?"" To which I reply ""uhhh, to help speed things along and to better help them communicate their order?"" Then she went on about how this is America and how i should speak English to ""honor our country"" or some shit and other stuff regarding "" 'merica"" that i didnt pay attention to. She turns and leaves, and this is where i fucked up. I said to my coworker across the counter ""what a racist"". She heard it, and starts fuming. I thought she was just gonna correct me and leave, but apparently while I was busy with the line she was having a little chat with the assistant manager, who is a Mexican American lady in her 50s. The manager calls me over to have a chat in the office, and she agrees that what this lady said to me was very racist, as many of the Mexican immigrants who come to this store speak extremely broken English and need to speak to a ""Espanol"" speaking employee to help communicate their order. America is a melting pot, especially the bay area. She tell me I am not in trouble, but just apologize to the lady, and she will dismiss this incident. We went together to speak with the lady, and boy does she let her anger out. She was angrier than a father whose teenage son had just drunkenly wrecked his brand new Cadillac. She claims that she is born and raised in good ole USA, has a degree in human resources, and her husband is Chinese, the whole time going off about ""HOW DARE YOU CALL ME A RACIST?!"". She starts bitching about how she is really thinking about taking my ass to the corporate office, but in the end tells me she's giving me a pass because im young. The whole time, I could only stare at her angry face and say how sorry I am for such a remark (i was, i'm sorry my impulsive mouth said something this stupid and embarrassed you in front of everyone). Then she stormed off to her car. I know i fucked up, but what kind of question was that lady? I want to help these people communicate better and quicker and make them feel more comfortable knowing that i can speak their native language, FUCK ME RIGHT?! This incident occurred yesterday, but the embarrassment and the lady's anger still burns at my conscience. Fuck me and my impulsive mouth, didn't have a moment nearly as shameful as this during my drunk nights in Freshman year. ",TIFU by calling a black lady racist (rant),485
buildthisnotthat,71,87,1l901b,350,"My girlfriend and I went out for happy hour and started drinking rather early to celebrate my cake day. Later in the evening after we were good and toasty we taxied back to the house. In the cab she whispered in my ear that she had something special for me when we got home. Instantly I'm interested. I had the biggest grin on my face for the next ten minutes. We walk into the living room, she sat me on the couch and told me not to move. She dimmed the lights, put on NERD and disappeared in the bedroom. 

When she reappeared a few minutes later she was wearing a long hooded cape, a see through lace nighty and super sexy high heals. Next thing I know she starts doing a strip tease, prancing around the living room looking sexy as hell. Immediately, I'm stoked and horny as fuck. This girl can dance, she is a professional ballerina. So grace, elegance and a body to die for is putting it mildly. Gorgeous is an understatement. 

Off comes the cape and she's getting down and dirty. She put a stool in the middle of the living room floor. She's straddling the stool, touching herself and giving me a proper show... I notice she is a bit wobbly in the heals because the wood floors are slippery and she's all kinds of drunk. But I don't give it much thought cause everything else she's doing has my undivided attention. 

This sexy solo dance goes on for a couple of songs and I'm enjoying every minute of it. Next thing I know she struts across the living room towards me and starts dancing up in my lap, rubbing her gorgeousness all over me. Putting her pussy up in my face. She is teasing me and it's totally working. I'm so horny I can't hardly stand it. Also, I'm drunk as shit so I'm slouched on the couch. Her back is to me and she's twerking her ass up and down in my face. 

Next thing I know, those slippery heals on the wood floor get the best of her. Her feet slip out from under her. A split second later her ass slammed down on me mid chest. She knocked the wind out of me for a good 30 seconds. I kinda noticed that my back felt jacked up but I brushed it off. She was totally apologetic and embarrassed. I didn't want her to feel bad so I made some joke about what happened and lightened the mood. We sat next to each other and laughed about what happened for a few minutes. But, I was so horny sex was consuming my mind. Less than ten minutes later we were fucking, having fun and feeling real good. 

Next morning I wake up rather early. First thing I notice is a sharp pain in my side when I'm laying in bed. I twist to get up and the pain is increasingly more sharp. I touch my side and now the pain is excruciating. Every deep breath I take there is stabbing pain. I wake her up. She touches my side and the pain is horrible. We go to the ER. I have two cracked ribs. ",TIFU by getting a lap dance (NSFW),437
littlestblue,93,105,1c52nx,349,"i got up all groggy n shit, was all like ""shit, i gotta pee. cool, i dont have a boner."" i sit down, with my good posture and a halfy goin on, i peed right through the gap and into my pajama pants. i didnt notice until my left foot started getting warmer than usual. that hasnt happened since i was in grade school. i would've gotten mad if i wasnt so tired.",TIFU by peeing with a chubby,454
oiledbathtub,67,47,167ljb,344,"I've had a pretty bad couple weeks. 

And today was a great day to just relax, so, naturally I took a long steamy shower and decided to masturbate.  Normally I'm a dry guy, but today I decide to try out the feels with some Olive Oil.   

That might have been the end of my fuck up there, because it was a bit difficult to clean up off of myself.   I got distracted and forgot to do anything about the rest of my shower space.


Fast forward about 30 minutes and my Roommate gets home from work, hops in the shower.  A few minutes pass and I hear a dull but ominous thud.   And then I hear screaming.

My roommate slipped on the oily surface of the shower floor and broke his fall with his face.


I finally convinced him to let me in the door (I was once an EMT and went straight to calm triage mode)

In the end my Roommate broke his nose and cracked his cheek bone, his face is enormous and he has raccoon eyes.

I've been afraid to masturbate for a few days....I still haven't told him why the shower was slick, or that it was my fault. 


edit: because of all the confusion, olive oil is great, it makes your skin feel great, it never gets too slick, and you smell nice, especially if it's infused and shit. 


ps.   i will forever bow down to the guy who shit his colon out. ",Today I fucked up my roommates face. ,391
ShirleyFunke482,90,66,w76fw,354,"I woke up early in the morning, the bag was on the counter and I ate one without thinking. Flash forward 3 hours, the anesthesiologist was about to put me under when my mom blurted out my mistake. He consulted the surgeon, and I was forced to wait around for another 4 hours. Although one of the nurses confessed to me that if it were her, she would've made it count and eaten the whole bag at that point ",TIFU by causing a huge delay in my surgery due to eating one m&amp;m,420
dmuns,91,31,rk8k7,349,"I perform chemical tests on creek water several times per week, and today I was out in the middle of the woods, ALONE for a change. It takes me about twenty minutes to get to the first test site along this creek on my mountain bike, so it's pretty secluded.  I hadn't flogged the dolphin in about a week because I've been so busy, not to mention that I live in a cramp dorm room.  So, I got a little aroused and looked up some porn on my phone.  Started going at it on the side of this trail.  All of my focus is on my phone's screen and wouldn't you know it, a female cross country team from the college across town sneaks right up on me.  I didn't notice them until they were about twenty meters away, so they caught a side view of what I was doing.  One of them called me a pervert while two others cat whistled at me.  Being as embarrassed as I was, I stepped down off the trail into the woods just to make sure they didn't see my face.

I waited for fifteen minutes or so in shame to let some distance grow in between myself and them, then hopped back on my bike and went towards the second test site (which is in the same direction they went).  I turned onto another trail before I caught them and was nearing the second test site when I saw my very first red squirrel.  Finished my testing at site two, and headed towards my truck.  On the way back, I run over a snake and nearly fall off of my bike because I didn't realize it was a snake until it was too late (I hate snakes).

Got back to the truck, drove over to the third testing site and went down next to the creek to gather some water samples.  I got close to the water on an already steep and slippery bank.  I realized I had not checked the area for snakes before I knealt down, and I freaked out and proceeded to slip right into the creek.  I climbed out as fast as I could to try and save my phone in my pocket, then, as I was pulling my phone out of my water-logged pocket, I slipped back in again.  

I pulled a Bill O'Reilly, and said ""FUCK IT, I'LL JUST GET THE FUCK OUT OF HERE. FUCK THE CREEK.""  I got back to my truck, and there were four turkeys pecking at their reflections on the passenger side.  Needless to say, I fucked up.","tifu: Got caught masturbating in the middle of nowhere, ran over a snake, AND fell into a creek... twice",380
yodel-at-my-balls,193,398,1mpkdv,347,"Yesterday night my girlfriend went home for her fathers birthday, so I was left alone to cook for myself. Last time she left for  a night I had a small accident with the freezer, which sliced [my hand](http://i.imgur.com/Q0IaBT6.jpg) and [wrist](http://i.imgur.com/MDuJghq.jpg).

She jokingly said that everytime she left me alone for a night, stuff like this would happen to me. Since she's a nurse, she usually can take care of it when she's home, but these things always happen when she's not.
That was a week ago.

Yesterday she left and jokingly said ""be carefull, don't hurt yourself""
I laughed.

Three hours later holding my hand under cold water, almost crying.

As I finished cooking my meal, I wanted to put some away for work, so I took a tupperware and wanted to put it on our ceramic stove, when I thought ""wait. It might still be hot since I just finished cooking! Better check first!""


The result: [Three cooked fingers](http://i.imgur.com/um7zpRg.jpg) and a bit later [Nice bandages with anti-burn cream](http://i.imgur.com/uES1sJU.jpg)

When I called my girlfriend to let her know. She just went silent and said ""...really? I'm not leaving you alone anymore.""

It still hurts like a bitch, especially when typing. And I work in IT.
",TIFU by winning a Darwin award. Now my girlfriend doesn't dare to leave me alone anymore.,745
prussianiron,105,100,10casq,349,"So my girlfriend and I got back together last week but haven't had sex yet (odd considering we are both sex addicts). However it's clear we're both horny. 

So we found a small grove that we were sitting in before we started kissing. One thing led to another, and she was on top of me and we were dry-humping. All our repressed sexual energy came out in the form of fast and hard dry humping (she was still mad and refused to have sex with me, but she enjoyed this a lot). 

Now I had realized at one point that my jeans and boxers were really starting to hurt my penis, but decided to shrug it off because this was the only semi-sexual thing I had done in weeks. But finally I told her it hurt too much and I had to stop. 

So far I didn't know just how bad it was. We hung out the rest of the day and I was mostly fine. But when I finally got home and actually got a look at it, a big strip on the underside, below the head, was red and raw and slightly bloody, and touching it stung like a bitch. Pretty much wherever I walk now I'm cringing while my dick stings from my pants.

TL;DR: Vigorous dry humping, dick rubbed raw, red and a bit bloody, have to live with it for a weekish now.",TIFU by rubbing my dick raw,449
HoboSailor,149,112,1f0bte,343,"Title says it all.  I have to be up early tomorrow for some volunteering shit with my girlfriend.  I had intended to take an adderall tomorrow morning because I also haveresearch to do afterwards.  Seeing as I have to get up early, I wanted to be well rested---so I went to take a Unisom sleeping tablet.  First, I went to grab the aderall to bring with me to my girlfriends so I wouldn't forget it.  Signals got crossed and I took the adderall.  About 15 minutes later, I realize my mistake.  Now I am staying home and praying that I can get a minute of sleep.

TLDR; meant to take sleeping drug, took amphetamine instead.",TIFU By accidentally taking an adderall when I meant to take a tylenol PM,455
Thelonius_Dunk,71,138,11t1md,343,"Me and this girl I work with decide to go to one of the bigger clubs in the city after the rest of our coworkers flaked on us. 

Once we get inside, we dance a bit on the first floor, then decide to go upstairs.

Usually its only $5 to go upstairs, but tonight it was $12. I just figured it was typical club bullshit........Then I saw the dancefloor.

HOLY. FUCKING. SHIT. I honestly thought I had walked onto the set of Drake video.  Ladies at the bar.  Ladies on the balcony. Ladies on the floor. Best of all they were dancing in more than just  a ""drunk best friends"" kind of way.

I hadnt even been in there 5 min before the bouncer pulled me aside and said ""What party are you with?""

My best drunk response: ""I didn't come here WITH a party, I came here TO Party."" He replied, ""Come with me"".  

SHIT!

I'm thinking I'm about to get kicked out the club because he pulls me over to the door and says "" Look bruh, I know this scene looks sexy as fuck to you, and you look pretty fucked up right now, but I want you take another look at all the dudes in the room""

So I did.  Then it clicked. Ohhhh

""Yea, those aren't dudes, this is an all lesbian party.  I have no idea how the hell you got in."" he replied.  ""I'll let them give you your money back because you'll have more fun on the lower floors, trust me.""

So yea, I left after that.

TL;DR- Thought I was at a club with an unbelievable guy:girl ratio.  Turns out to be an all lesbian party. Got politely kicked out.  Still got my money back",TIFU- Unintentionally invited myself to an all lesbian party last night.,481
DevilWorshipper,69,93,10ifxi,342,"I'm an introvert and an alcoholic. I go most days without uttering a single word to anyone with the possible exception of ""thank you"" to the liquor store clerk. Thanks to a DUI, I have to walk everywhere I go. Usually, if I see someone on the street coming toward me I cross the street or do some other maneuver that allows me to avoid them.

Today, I was walking to the store and there was someone walking, toward me, on both sides of the street, so I made the strategic decision to maintain my path. As the person in my path got closer, I got nervous and, suddenly, my legs stopped working properly. My knees would not bend. My feet refused to lift off of the ground. My upper body lurched forward with no support and I fell down due to my feet and legs not functioning properly. 

I tried to play it off that I tripped, but, when I got up, I **still** could not get my legs to work. The other person passed me without incident and I was, once again, alone in the street. It took a few seconds and a few wary baby steps, but, I soon learned how to walk again and made it to the store without falling down. And no, I was not drunk at the time. I just temporarily forgot how to walk.",TIFU: I forgot how to walk.,435
halloween_tifu,157,61,12bwy2,342,"My roommates and I are having a monster mash on Halloween. Lots of people will be coming. We all chipped in for candy. I think it was seventy bucks' worth at least but we no longer have the receipt (you'll soon find out why). My roommate Claire bought a shitload of awesome stuff: Reeses, Twix, Snickers, M&amp;Ms, you name it. Pretty much every popular chocolate bar in funsize form.

Well just past midnight I got the munchies, and decided I'd heat up a Stouffer's lasagna. I prefer to bake mine. So I preheated the oven and went back to the living room to watch Firefly.

THen I smell something horrible like burnt plastic and the smoke alarm starts screeching. We all run into the kitchen which is filled with smoke. I open the oven...

Guess where Claire temporarily stored the candy but then forgot about it?

**update**: i feel this could have been avoided if i had checked the oven. so we both fucked up. i had never heard of people using ovens for storage. claire moved in just last month. shes from england. she says this oven-storage concept is a british thing.

the oven is ruined... idk what exactly is wrong but our landlord said theres no point in getting it repaired and will probably replace with a new one. he is very angry and rightfully so....

we're still having our party but asking people to bring snacks",TIFU by preheating the oven.,403
somethingcleverer,82,59,10mtll,340,"So yeah... I was at the bar last night with some out of town friends. We weren't very drunk, just middling. I had probably 4 or five beers and a couple of shots over a three hour period. I was drunk, but by no means loaded. My buddy offers me a Unisom (over the counter sleeping pill) on the way out of the bar, which I take, thinking I'll conk out when I'm home instead of staying up all night. Problem is, I black out on the walk home. 

So I woke up this morning pantless, with no sheets on the bed. I immediately realize something is wrong. Then I see the carpet cleaner on the night stand and a picture starts to form in my mind. It isn't clear yet, but I know that its not going to be pretty. Then the texts from my wife come, and I realize, I'm a monster. 

You see, what had happened was, my wife woke to the sound of me casually peeing on the bed as if it were the bathroom. She screamed at me, got up and pulled the sheets off the bed and put them in the wash, and in my fugue state I just smiled, got on her side of the bed, went back to sleep and accused her of peeing in the bed. I'm an ass hat and she should divorce me.

tl;dr Don't take Unisom ",TIFU by pissing on my wife... Yeah,399
[deleted],44,61,zy8uj,340,"T(woyearsago)IFU: The ""violent beer shower"" post reminded me of something I did a couple years ago that taught me a hard lesson about household maintenance.

I used to work for my landlord as the property maintenance man. This involved going around the property every morning cleaning up litter, then spending the rest of the day responding to calls for broken appliances and busted plumbing. If you've never done it, it can be a blast. You learn everything about taking care of a house, so you'll never need to spend beaucoup bucks on a plumber or electrician, and you get to go into peoples' apartments when they aren't home and feel like a total creeper.

Anyway, when you change out a water heater element,

1. you turn off the power to the water heater, then

2. turn off the water to the apartment. Then

3. you use the hose spigot out back to drain all the water out of the water heater tank and apartment plumbing. If this doesn't work, you attach a hose to the water heater and run it out the back door. After the water is drained,

4. you use a big socket wrench to unscrew the water heater element, pull it out quickly to reduce spillage, and then

5. screw the new one in, and then

6. turn the water back on, and

7. once the water heater is at least mostly full, turn the power back on. You gotta wait until the tank has water in it so the element doesn't burn out trying to heat water that isn't there.

Anyway, I was in a rush one particularly busy day and forgot step 3. As soon as I unscrewed the element, the tank spat it out and [started blowing water into the apartment's kitchen](http://img.directindustry.com/images_di/photo-g/water-jet-cleaning-machine-16301-2577887.jpg) like a streetside fire hydrant, and I was sitting right next to it. I panicked, and no matter what I did, I simply could not get the element's thread to line back up so I could screw it back in. I didn't want to give up on trying to get the element back in, and it struck my reptilian brain as a Bad Thing to walk away from a 40-gallon tank blowing a deluge of water all over a tenant's kitchen table. Suddenly the only thought that popped into my mind was ""call for back up!""

I picked up my radio, keyed it, and said, ""Help! Come open the spigot on apartment &lt;number&gt;! I forgot to drain the tank and I can't get the element back in!""

Later my boss told me that when he heard me key the radio, he picked it up and all he heard was ""FFFFFFFSSSSKHKSKSHKHSKAPARTMENTSBBAGRLAGRLALRGALRBG, LGLABRARGBARBARGELEMENTBARGALGARBLFFFFSSSSHK""

He got a pretty good laugh out of it, at least.

tl;dr: FFFFFFFSSSSKHKSKSHKHSKLISTOFACTIONSSBBAGRLAGRLALRGALRBG, LGLABRARGBARBARGACCIDENTBARGALGARBLFFFFSSSSHK",TIFU: taking a cold 40-gallon shower in about thirty seconds,401
ohaiimchris,59,115,1n9qdw,346,"Alright, so a little backstory.  This girl in my history class is pretty cute and we've been flirting back and forth.  Well, today we had an exam, and so last night we studied!  And when I say ""studied"" I mean ""Sit in library for 45 minutes and decide to go get drunk"".  The night progresses and we finish a 1/5th of Admiral Nelson between three people.  (Me, my roommate Ian, and the girl Emily).  

Okay, now for the story.  As we're drinking, Emily and I are getting more and more flirty, and then we decide to go get more booze.  After doing some walking around, we finally are able to locate a liquor store and we buy some vodka.  We bring it back to my place and take a shot, which I accidentally chased with a mixed drink.  That's when I decided I was done drinking and Emily said she was tired so I walked her the 3 blocks back to her apartment.  We hug goodbye and I stumble my ass back home.  I start texting her and she tells me that she wants me to come back to her place and cuddle with her because she's lonely.  This was it, the moment I had been waiting for! So before I leave to go meet her, I take a screenshot of the conversation and create a new message and send it to my roommate Ian, because he was convinced nothing would happen.  The conversation was short, but it ended with him telling me to ""Destroy her vagina"".  

Fast forward 6 hours: I wake up in her bed and I reach over and check my phone.  
""One new message from Shannon"" 
Shannon is my 14 year old sister and so I thought ""Why the hell is Shannon texting me?"" 
So I open up the conversation and almost shit my pants. 
All it said was ""Chris, why is this relevant to me?"" 
Lo and behold, the aforementioned conversation that ended with ""Destroy her vagina"" that Ian and I had had before had been a group message with which I had included my little sister.  
I don't know how or why I included her in the conversation, but yeah.  
My 14 year old sister was included in the drunk conversation between one of my best friends and yeah.  

After dying on the inside from embarrassment, I quickly text her back and apologized.  

7 hours later and no response back from her.   

edit: just talked to her, she had a laugh over it and I feel like a proud big brother because she's at her first homecoming.  you go girl. 

edit #2: pic of the conversation.  http://imgur.com/lPUwegP   ",TIFU by drunk texting,461
greenbowl,193,104,188lg4,336,"Went out parting with a female friend. She brought her friend along and introduced me.

My friend told me this girl had a history of emotional issues that dealt with bad relationships and men using her for sex. But for some reason, I pushed that to the back of my mind and was really into dancing with her.

things go heavy, and she was feeling me up all over. So I fingered her on the dance floor, and she came in a few minutes.

Afterward, she avoided all contact with me and refused to even look at me. She might have started crying too. I'm pretty sure she felt used and what not. She and my friend left without saying a word to me or even picking up their phones.

I don't know what the fuck is going on, but pretty sure I fucked up.",TIFU: by fingering a mentally unstable girl on the dance floor,440
bibbleskit,22,24,rdg8y,338,"I drove my car into the giant puddles to make huge splashes. So I did. Didn't see the old lady. The force of the wave not only soaked her, but also made her disappear into a bush. She's ok though.","TIFU: rained hard and the sides of the streets are flooded, thought it would be fun if...",362
sebast91,239,110,1130tf,337,"Technically yesterday, but I just woke up and he's not here anymore, so anyways here's the gist of how the fuck I ended up doing this. 

It started out as one of those simple rather small parties where we invited some friends over - not much only 5 not that this matters but anyways it was a bit of a hang out I should actually call it. At first there wasn't any drinking, we were all just sitting and talking while watching tv, but then a couple of them brought up that they brought some beer over and asked us we wanted to ""loosen up"" - and of course I was thinking something like, fuck it it's a Saturday, why not and so as it got later I ended up consuming maybe 5 or 6 cans? I can't remember now but I was really fucking drunk last night. Now from this point on, I can only remember bits and pieces but I remember enough to feel really bad. So everybody had already gone home, leaving me and him of course and this is where the major part of my fuck up started. He had gone into his room to lay down and being the fucking drunk I was still I walked in after him. I said possibly molested because, at that time I felt like he wasn't resisting when we stripped and I started doing things and he didn't do anything when I started palming his dick either - but I also might have been too fucking drunk to know either way. I know more happened after that but I don't want to go into detail anymore. 

So as I've said; I just woke up about two hours ago in his bed but he isn't here anymore, I called him many times and when I texted him ""where are you"" he answered ""getting breakfast"", and I asked him if I did anything last night but he only answered with ""we need more orange juice do you want pulp or no"". His answer is just so regular I just don't know. I just feel like shit right now and I don't think I'm a homosexual, I really just don't know what to do. I want to believe that I just have some really realistic and fucked up dream but that wouldn't explain why the fuck I woke up in his room naked. It's already been over two hours since he's been/gone to wherever he's getting breakfast, I don't know what to reply to his text with and what to do when he gets back home. I just hope some of you have any advice for bad situations like this because I really can't think of what to do. 
",TIFU: I possibly molested my roommate. ,447
Treycoolis,138,85,14bg1g,338,"I woke up this morning in the best mood ever. I got dressed and headed to school, and as soon as I got to class and sat down, had the intense urge to shit. Usually I'm pretty good at holding my shits in, but oh no, this time. This time was bad. I was in agony for 30 minutes while being hit with people trying to socialize and multiple denied requests for a bathroom break by the teacher. I then realized what was causing this. Yesterday I got high as a kite and had the munchies. Well, the day before I went to the store and bought a LOT of...

Burritos.

Fucking burritos. I had the munchies and there was nothing in the freezer but burritos, and I felt the punishment in class.

I walked up to my teacher once more. I asked if I could go to the bathroom, and after an explanation filled with burritos, and seeing a hopeful look on this face, it happened. My bowels gave way. I have never felt more embarrassed in my life. Reddit, Today I Fucked Up.

**TL;DR: I looked my teacher in the eyes and shit on myself.**

EDIT: I got more feedback than I thought. Well I'm in class as I update this, and my teacher will NOT look me in the eyes. Also, just to fuck with him I asked to go to the bathroom. He said yes immediately! 

Thanks for the support guys!",TIFU By shitting myself in class.,423
floppycat,62,66,137ky9,336,"Gambled and lost. Here's a little backstory. For the last few days I've been battling a cold/flu, and taking a bunch of cough syrup and vitamin c and stuff that generally loosens your ass up haha. My girlfriend picked it up from me too, although today she woke up and had to puke. I didn't think it was really related to my own sickness until I got half way through my shift today. I work as a cashier at a food store and I was serving this nice old couple. I feel this rumble in my gut and think oh fuck, that means I'm gonna get the shits after work. I was wrong. I tried farting a minute later, expecting the gut rumblies to just be something I could worry about later today. I gambled and lost with that fart. 

Absolute horror must have struck my face; I had unleashed a fiery brown lava flow into my boxers as I stood serving the old couple. I could feel something squish in my pants and I carried on packing the customers groceries in a very hasty manner. I told a coworking I was going to go upstairs for a minute, and tried to not look like I was shuffling for the stairs. I looked behind in fear that there would be some sort of brown trail on the floor, but all was mostly okay. 

I spent the next 15 minutes shitting a horrid bubbly mess and attempted to clean my boxers. Luckily the poopjuice never made it to the edge of them. I heard them calling me back to cash on the intercom 3-4 times, after which I went back down and told them I was puking.

I ended up getting a ride home and my girlfriend questioned what had happened. I told her once we got back to the house, where she hovered outside the bathroom laughing at me.

**TLDR: So if you are sick, and you take too much vitamin C and benylin; they will loosen your sphincter and cause the worst greasiest shits, don't gamble on those farts at work either.**","TIFU By gambling on a fart, at work.",402
JA24,55,68,xi16d,336,"I'd been waiting on a couple of phone calls today, sure enough phone rings while I'm Redditing, I answer and what sounded exactly like my Dad spoke, I of course instinctively respond ""oh hey Dad, what's up?""...nope, wrong answer, it was my new boss, calling with the results of my interview, turns out he sounds just like my Dad over the phone...the most epic of facepalms were had that day.

Luckily I was still offered the job :)","TIFU by calling my new boss ""Dad""",404
Lolrama,51,300,1mx2oo,334,"Well, I'm cheating, as this happened last night, but whatever.

So I was reading /r/nosleep on my iPad at 3 AM when I heard my dad come up. I had headphones on and I heard a door close, so I assume he went to sleep. A couple minutes later, I see a hand appear on the screen of my iPad. Note, I was reading /r/nosleep, so I naturally freaked and smacked at the black outline which looked like a head of the monster with the iPad. Guess who it was? He's still mad at me.",TIFU by slapping my dad in the face,634
real-dreamer,131,173,1hp1qh,335,"For an example of, ""Today I fucked up..."" So, I thought I was getting paid this week. Not next. I ended up putting most of the rest of my check into my bills and food. So, I'm left with almost no money until next week. Dammit... I hate living check to check. 

Edit: to explain... I've paid one bill and got food and spent frivilous money on other stuff. I should have saved until next week so I could float from check to check. I'm the one out of my partner and I who have a job. So we don't have money for gas or rent. But, my credit card is now brought current. So yay!",TIFU I thought it was payweek this week.,508
suicidalbitcoinloser,154,171,1fcl93,340,"Actually it was yesterday. I wanted to put my paper wallet in the safe deposit box my family has. There is some gold, silver and documents in it, nothing big though. I wasn't feeling very well lately and had some stomach issues. It's a 2 hour train ride with about 10 stops. Usually I never use the toilet on the train. But yesterday I made the wrong decision. So my backpack was really full with stuff, like a lady handbag. I didn't put my paper wallet in my wallet, I put it with some other (unimportant) documents in my backpack. 

But then the incident happened.

I was about to shit my pants in public and so I left my 60k+ life savings unattended for a brief moment because I didn't had the time to search the paper wallet in my backpack and I didn't want to carry my backpack to the train toilet because they are really small and there is no place to put a big backpack. Of course my backpack was gone after I came back from the toilet.

About 40k were money I put into bitcoin the other 20k were gains, so I'm really fucked now. I took one of the most expensive shits in history and it wasn't even very pleasurable.

Shit happens. 
",TIFU by losing my life savings because I had to crap,511
kristafer825,65,54,1cng6o,334,"I am 5'2"". A lot of standard household activities involve standing on my tip toes, or at least getting a chair. I have always wished I was taller, but guys always tell me they prefer short over tall, so we'll go with that.

Now imagine little old me, just innocently making dinner for myself in the kitchen, dancing to some classic tunes in my socks. I'm mixing together my mac n cheese (yeah, it's Kraft - so what if I'm 24 and can't grow out of an old addiction?) while waiting for my green beans in the microwave to cook. Both of my dogs are at my feet, watching my every move hoping for the tiniest ground score. Then the microwave dings, signaling the moment of truth.

I stand on my tip toes to reach the microwave (because some genius thought it would be a good idea to put a microwave 5 feet off the ground) when all of a sudden my not so little Rottweiler / Lab mix gets excited about something he saw fall to the ground and bumps my leg. My foot slips out from underneath me and the movement causes the almost boiling water to spill out from the lip of the bowl, *right onto my boob*. 

I stand there for a moment, because I know the dogs are under me and I don't want to spill it on them as well, but I don't know what to do with the bowl. I have migrated to the middle of the kitchen in the chaos and for some reason I can't quite grasp the idea that I should put down the bowl and take care of myself. So I am standing there, letting the hot water soak into my clothes, through my bra, and onto my skin. It hurts pretty damn good. 

Eventually I get the brilliant idea to put the bowl down and get the hot water off my skin, so I take my shirt off to assess the damage. I can't see anything through my bra so I start to take it off when all of a sudden - in walks my roommate's boyfriend. Yeah, talk about the ultimate deer in the headlights moment. 

I quickly cover myself, running to my bedroom and cursing my stupidity all the while. My tit is blistering, I am in a lot of pain, and I probably won't live this one down for a while. ",TIFU by spilling boiling water on my boob,388
clockworkgirl21,14,71,1lg5kz,333,"A store near my house has a donation box for clothes and shoes type things for the Special Olympics. I threw a bag of clothes into the back of my car and drove over there. After I tossed the clothes in a saw a blanket sort of wadded up in my trunk and decided to throw that in too.

After I got home mom informed me she laid that blanket out in the back of my car to transport a goat to the fair. Afterwards she wadded it up and threw it in the trunk to deal with later.

I hope they don't think someone did that on purpose to be an asshole.",TIFU by donating goat shit to the Special Olympics.,404
korinthia,72,104,1h9khm,331,"This happened to me while I was in highschool.  Unbeknownst to me I had perforated my ear drum somehow.  In P.E. we were in the midst of the swimming unit. I have a long history of swimmers ear, so when I got out of the pool and couldnt get the water out of my ear it was no surprise. Ill just ask the swim coach for some rubbing alcohol, that always clears it right up, no big deal I thought. WRONG. The moment the alcohol met my eardrum i experienced bar none the most excruciating pain of my life. I literally was blinded. All i could see was white my brain was so everloaded with pain, I immediately lost all bodily control (didnt shit myself in front of all my friends thank god) and I found myself in the fetal position on the pool deck. The swim coach was so shocked he told the nurse to send me home.

Edit: PART 2
A month or so later I was supposed to go visit my sister at college. My sister went to school in the northeast, and my family lived in the midwest. So my parents dropped me off at the airport and to my gate I went thinking this would be the start to a fun weekend. NOPE. Cut to take off. Everythings going according to plans, I have some slight discomfort in my ears, but I think hey this is normal my ears are always a bit sensitive when i fly.  But as the plane keeps ascending it i start to get a little uneasy as its getting a progressively worse. And then my ear popped. Mother of [God](http://imgur.com/8QmIp) . This wasnt quite as blinding as the first time, but it also unlike the first time it didnt subside. Now Im a teenage boy wimpering curled up yet again in the fetal position on a plane seat alone. After she couldnt take it any longer the lady next to me asks me if Im okay. Im barely able to form there shortest response possible ""no"". She whips some pills out of her purse and says here take this. I think to my self sweet mother of jesus if this helps ill take the risk of joining the mile high club.  About 10 minutes later im out cold. Fortunately my pants stayed on, and she gave me a few extra to take with me on the way home. (turned out to just be psuedofed)

Edit2: Thanks for all the empathy, I guess i should be less surprised at how many people this is happened too, there ought to be some sort of PSA to warn people of the dangers of blinding ear pain",TIFU getting rubbing alcohol on perforated ear drum,435
kittensnomittens,52,55,140xy0,339,"Not even a throw-away.  Fuck it.  So, my genius brain was on /r/pettyrevenge and decided I absolutely HAD to have a few tools of the trade, namely some duct tape, rope, superglue, and an air valve stem tool. Those items would be handy to be kept in the car for some petty revenge and I thought it was a fine idea as sometimes my temper gets the best of me.  While I was at the store, I picked up a few other items I saw on sale (a crowbar) and got a new lock for my apartment, as there was sketchy activity in my neighborhood last night.  Anyway, apparently I was acting weird when I came in because I asked to use the bathroom (I had to poop- yes girls poop) and when I emerged I wandered a bit seeming lost (because I had never been to a hardware store before).  

I am socially awkward and that translates into ""murderous"" and ""threatening"" because after I left the employees sat around talking about for about an hour before calling the police to report my suspicious behavior.  

I found out about all of this when the police paid a visit to my ex-husband inquiring about the nature of our relationship and my mental stability.  He stated things were fantastic and initially misunderstood and assumed I had pissed someone off and the threat was on MY life.  He became extremely upset when he realized that they believed I was the one who threatened HIM.  

This was all brought to my attention while at work.  I tracked down the officer who was apparently leading the manhunt to find me before I ""killed"" someone and explained everything, down to the locks for the door and my ""strange"" behavior.  I am hearing impaired and need to wear hearing aids.  One of them is not functioning right now, making me have to concentrate even more intensely to understand what people are saying.  I guess that comes off as ""disturbed"".  The officer then explained what happened when I left the hardware store, which included one of the employees being ""scared"" and going home, presumably to pray for my lost soul.  

Thankfully, the investigating officer believes it was a misunderstanding coupled with some gossip and a few overly active imaginations.  

So, TIFU by going to the hardware store to buy a few items commonly used to kidnap and torture.  made a few bad jokes and then I got questioned by the police

TL;DR  Read it or I'll kidnap, torture and kill 

EDIT:  word",TIFU by going to the hardware store,394
livegoodtimes,13,93,1oh46a,339,"So I was drunk and trying to have some sexy FaceTime with my girl, but I accidentally facetimed one of my coworkers wife. I don't even know how I got her number. Then the coworker facetimed me to find out wtf is going on and I accept his FaceTime while I am completely naked. He was confused. I was confused. And today at work he told everyone he saw my man bits.",TIFU by drunk face timing.,432
spiderbrey13,109,98,1gbbug,329,I can't even move. I feel like my stomach is about to explode. It felt so right at first.....but it was so wrong.,TIFU by eating 2 whole pizzas by myself.,427
Oriva,78,106,1exx55,333,"Today I had a sexual experience that is comparable to a video on efuckt. I have never felt the need to throw up from being so embarrassed.It's going to be pretty long, just a heads up.

I should give you the preface; I have always had a taste for odd foods. I'll look at a menu and see something such as monkey toes or Bumble bee's urethra and my response 9 out of 10 times is ""hell yeah I want that weird ass shit"". Today was no different. A random new hippy -dippy store appeared this week , I was curious so I ordered something from a white dirty man with a beard like Mose called a ""power green house punch"" smoothie with some questionable ingredients. One sip and it felt like a MMA crack head punched me in the stomach, I made a mistake.

Fast forward a couple hours later, my stomach is feeling better and I'm on my way to see my boyfriend. We start discussing DOTA, which leads to the unavoidable sex. Everything is going great, until I received a mega man stroke that made arch my back and release my bowels. At first I didn't realize that I not only shit myself but also shit on boyfriend. Then the smell hit me and all I could think was ""Damn you hippies!"" 

At this point I'm trying to play it cool, with the hopes that maybe he doesn't know that I shit myself from his power fucking. To try and distract him from the poop running down my ass I start putting in double time, pulling out every move in the book. My thought process was that maybe the smell of good sex will overpower the smell of shit. Nope, wrong, so very wrong. The room smelt like two homeless people fucking with cat shit as lube, and to make things worse with every thrush, my boyfriend is being cover with more shit. 

I finally give up on trying to make it less awkward but I'm still in full panic mode and looking for a way to make this sticky situation into a better one.  For some reason, I though that giving him head would make him would make him feel better because at least he got off. Yeah, because sucking a dirty poop dick is sexy. My plan didn't work, the moment I put it in my mouth the smell and taste hit me and I was like a deer caught in headlights, expect instead of lights it was a dick that smells like shit in my mouth. I sat motionless with his dick in mouth for a few seconds. Then I apologized and left faster than a  fat guy chasing a wheel of cheese down a hill.


Looking back on all of this makes me cringe, I’m never leaving my bed  or eating from a dude name “Moon Dance” again.



TLDR: I trusted a hippie, which lead to me having shitty sex and a room that smelt like a homeless hooker shelter. I then try to suck the poop off his dick in order to make him cum. I don't make good decisions under stress.




 
Edit: Hey everyone, I'll clear up a few things and have a few things that I need to add to my ongoing increasingly awkward story. I'm glad my misfortune could make you guys laugh, hopefully if you are ever on my situation you do the complete opposite of what I did. 

First, I'm a girl. No doubt about that. Second, my boyfriend noticed for sure. It was the middle of the day with the sun jammin outside ,we were also doing it ""doggy"" style. Probably the worst position if you shit yourself. He just is a trooper and didn't want to make it more awkward.

After I left I went home and sat in my bed reconsidering my life choices and cringing as the smell of poop and sex still clung to my skin. Then I realized, I done fucked up I left all shit at his house. I considered just leaving it there and moving to the the furthest country away. I thought about it for a while until I came up with a brilliant idea. Maybe if I just pretend it didn't happen he'd think that maybe it dint happen. Plus its no big deal, I'm a grown ass woman sometimes adults shit themselves and it gets on other people, no shame in that. 


Eventually after practicing my lines, I worked up the courage to go to his house. I get there and no answer, so I do what anyone who wants to avoid the person you shit on. I sly cooper my ass into his room. I go into his room and fuck, the smell of shit ton of freezebrezze that mixed with shit and sex making the room smell like a tropical std . As  I started trying to get all my stuff I saw his dog, licking the bed, I went over to see if I got help him thinking maybe his toy was under the blanket. Sure enough, he was licking a shit stain that was on the bed. Fuck me. 

On my way out , my boyfriend comes out of the bathroom.  Like I said before I'm terrible at handleing stress so I start speed walking like its 1999 In hopes that he won't see me. Of course he does, so in my panic I proceed to ask him ""how was the sex?!"" . He must think I'm violently sick because all he did was ask me how I'm feeling. I just left without saying anything. If I ever see him again ill update you.  

P.s I went to the hippies to see why it made me shit and he informed me that ""its a totally detox for your mind and body"". Only thing that got detox is my butthole. Fuck you hippie and you delicious drinks.



Tldr: I went back to his house to find his dog licking the shit and then tried to act like nothing happen.  ","TIFU by eating ""hippie food"" that caused me to shit on my boyfriend and myself.",439
A_ciascuno_il_suo,47,80,1m5tx4,337,"A little bit of a backstory. My girlfriend and I have been in a relationship since April 2012 since we met at our university. Her family is from Mexico and her father is Catholic. I'm from an Italian-Jewish/Catholic background but I'm not religious in the least bit which immediately puts me at odds against her father. Because her father is very overbearing and she is afraid that he will take her away from her education should she have a boyfriend, we decided that only her siblings should know about the relationship. It's also important to know that her father can be immature. He will take away her phone randomly even though she pays the bills and is over the age of 20. Only during her last year of school (2014) were we going to inform her dad know about the relationship. At least that was the plan before I spectacularly fucked it all up.

Fast forward to tonight. My girlfriend has been back home in San Diego County for about three weeks. She has been helping family friends and her family with various chores and babysitting. Since we haven't seen each other for a while and she doesn't want to talk on the phone with me with her father around, we text quite a bit. We usual text a lot before she goes to bed. After our usual catching-up texts,  I decided to tell her about how much I miss having her with me like any good boyfriend would do. I also divulged, because we hadn't seen each other for a few weeks, that I was horny. We joked about it over the course of ten or so texts before I wished her good night.

After lying in bed for a few minutes, I get a text from my girlfriend but  it's not coming from her phone but from her email account instead. 

GF: my dad is reading the texts  
Me: what?  
GF: he took my phone  
Me: wow this is bad timing

it's important to note that the last text I sent to her phone instead of her email account. I guess I appropriately (albeit in an ironic fashion) sent it to her dad.

Now he is yelling at her when she should be sleeping. Instead of watching over children tomorrow, she'll be packing instead. I'll have to drive to San Diego to pick her up and bring her back to my place because his behavior will only get worse with time. I can't imagine meeting her father tomorrow will be a pleasant experience. Hopefully we won't get into a fight or a heated argument. I pretty much ruined the rest of my girlfriend's summer though because we were suppose to hang out with her family (obviously excluding her father) this Friday. I've also ruined any chance of making a positive first impression on her father, something that was already going to be difficult not just because I was with his youngest daughter but also because of my background.
___
**Update 1: Girlfriend didn't get her phone back. When I sent her a text message I got a message from Verizon saying that it failed to deliver. I only get this message when someone's phone service is discontinued.**

**Update 2: Girlfriend said she was the one who disconnecting her phone since her dad took the phone away from her when he left for work this morning. She said she will talk to her father when he gets back home from work. If anything goes bad I drive down there immediately.**

**Update 3: Nothing has happened for six hours or so except for my girlfriend telling me that her father is trying to reactivate the phone and might contact me. Should be fun.**

**Update 4: After speaking with her father and now he has had the time to accept that his little girl is actually a 21-year-old woman, he has calm down a little. Her phone is back in her possession and she is currently restarting service to it as we speak.**

**I am to meet her father in person now on Saturday before I take her back to her place near our school. I hope he'll act rationally because he has the capacity to. However it's also obvious he can act irrational because he has the capacity to. I'll try and remain cordial like some of you have suggested. My bravado might fail me because of the thought of meeting her dad finally, especially when it's not exactly on the terms I had originally planned.**

**Ironically I've driven down to meet some of her family a few weeks back when I dropped her off at home. I will have to pretend like I'm meeting them for the first time again because they also decided it was best if her father didn't know about her relationship. If that isn't an endorsement for how irrational people think her father *can* act, then I don't know what is.**

**Hopefully I will not have to write another TIFU because I spilled tequila on his clothing or something. If there is no update past this point, assume all went well or that her father murdered me and buried me somewhere in the desert.**
____
Another thing I'd like to write, I do understand that stealing somebody's phone is illegal. However, in cases like this, you do not wish to involve the police. This can make tense situations much worse. It is often just best to wait for a stubborn or irrational person to just calm down. It sucks my girlfriend didn't have her phone for a day, but at the end it is just a cell phone. You especially do not want to involve the police with Mexicans if you don't have to for many various yet obvious reasons. 
___
*I'd like to thank a lot of you for caring. It's actually kind of surprising. It went from a way for me to vent my frustrations of a fuck up (albeit a pretty hilarious one, I'm still laughing about it) to a learning experience. I've read all your wisdom and insight and although I might not agree with all of it, I still respect the words that were brought forth to me.*

*If I have anything to share with anybody is that if you or your boyfriend/girlfriend have a overprotective or otherwise stubborn parent, prepare on how you will eventually let them know about the relationship. A lot of fathers like these have made mistakes in the past with drugs, women, or bad decisions and often times they do not wish their daughters repeating mistakes with these kind of men. Lord knows if I had a daughter, I'd keep her on a reasonably tight leash... just not this tight of a leash. Also don't let things let these discourage you from loving a person. In the end it's situations like this that bond people closer together. If the meeting with her father goes well I'm sure we will all end up laughing about it eventually.*
",TIFU when I texted my girlfriend about how horny I was. I did not know that her father was in possession of her phone. He also had no idea I even existed before tonight.,417
TittiesOfTheBigKind,75,71,17grql,334,"I was sat having coffee with a friend when I heard gasps, a lady yelled ""Bring ice, the baby fell out the chair!"" Everyone stood up or turned around to see if the baby was okay and I just sat there laughing. I didn't think to hide it, and I couldn't stop. My friend is shocked at me laughing which made me worse. The lady on the next table heard and gave me the biggest glare. If looks could kill I would have been a red smudge. We decided to leave pretty soon after. The baby was fine, didn't really cry much. Even typing this is making me snigger and giggle. 

EDIT: Snigger is a variation of the word snicker. ",TIFU by laughing when a baby fell out a high chair in public,405
Solidbob,30,44,1agree,332,"Once, I was an avid runner. I had slowly worked my way up to 10k with a decent time and was proud. All throughout smoking half a pack of reds daily, drinking far too much cheap bourbon nightly and eating poorly because it all seemed to balance out. Well sometime last summer I injured my knee. The doctor's response was to have me not put unnecessary strain on it. I stopped running, but continued smoking, drinking and eating poorly. Today, a good six months later I decided to go out for a run. I dug out my warm woolen socks, homemade iPod armband, and the shiny new runners I had bought as a treat just before my injury. I began my old route and all was wonderful; the sun rising over the flats turned wildlife preserve where I had always ran, birds singing in the trees, The Raconteurs blasting in my ears... My viscera felt animated once again. At about 9k, I could tell something was wrong. I had felt a little funny earlier but chalked it up to the acidic Costa Rican coffee to which I woke. At 9.5 I was woozy and had to stop dead. I learned up on a telephone pole and felt as though a wave had just crashed against me. Not a pleasant warm Caribbean ocean wave. A bone chilling, gut wrenching, tidal bastard, hell-bent on tearing me to shreds. Somehow, and quite simultaneously, I managed to both vomit and shit myself. Luckily, being a quiet early morning Sunday in the suburbs, nobody was around to witness my fuck up, save the sheepdog who belonged to the yard I threw up in, and his judgmental eyes. The taste of the coffee's green apple acidity bursting up from my innards, down the telephone pole and onto my shiny new trainers will not be something I'll soon forget. I walked the last half K in shame, the runny unpleasantness contained loosely in my boxers, the stink of failure on my breath. 

Reset the counter.

**TL;DR ran 10k, puked, and shit myself.**",TIFU by going for a run.,376
glaedr,47,45,zk5lh,329,"So, I went for an interview at a university today, which went pretty well. The trouble started when me and my fellow interviewees were invited on a tour afterwards.

The building I had my interview in was this ultra-modern, glass-fronted beast which someone had decided to install a revolving door into (because fuck it, revolving things are modern). It's important to note here that this was no ordinary revolving door; it was a tiny, tiny revolving door divided into segments which were only large enough for one person.

So, I came out of my interview, and me and the other interviewees were filing through this revolving door. The guy in front of me walked into his compartment, and for some unbeknownst reason - I will forever regret this decision - I suddenly leapt into his compartment with him, just as the door was closing.

At this point, things were pretty awkward. I was pressed up against this guy pretty closely, who, in his haste to get away from the revolving-door-rapist, surged forward at an alarming speed, causing my bag to get caught in the door behind me. This effectively prevented the revolving door from revolving - the guy in front of me smashed into the glass in front of him, and I smashed into the back of him, only serving to compound his already uncomfortable position. 

The guy was furious and embarrassed (as was I). I freed my bag from the door, and me and my new friend had to awkardly shuffle around in our compartment to get out of the door (there was very limited leg room).

Just to make it a bit more humiliating, all the other interviewees and the next group of interviewees waiting outside the building saw this horrific event unfold and I was met with raucous laughter upon finally escaping the door.

Revolving doors.",TIFU by attempting to navigate a revolving door.,374
pabloe168,123,44,xb4fj,329,"I did research on craiglist for a weight sets for months. When I finally came across one  I could afford. I didn't lose my time and got it. The guy was nice enough to bring it to my place since I don't own a truck.

Amazing.. the barbell, the rack, the price, the weights. Cleaning it and brushing dust off I noticed weird [eggs](http://sciencedude.ocregister.com/files/2011/07/bwidoweggsvetter-300x300.jpg). Proceded to get rid of them and clean it as best as  I could. But I  did the job very very badly apparently.

Days later I noticed there were fucking spiders everywhere. And spiderwebs on the garage (where the machine is) every morning. And then I realized. The fucking eggs! did research and found these eggs belong to brown widows a less dangerous cousin of the black widow yet annoying and creepy as fuck. Been seen more eggs from that day which I continue to exterminate. Now there are spider webs everywhere. And yeah I hate spiders as much as anybody else around here. I don't dare to get close to my weights : (

Edit: [Pictures of the eggs I am finding all over the place](http://imgur.com/rc90E,TQKWx#1). I took photos to compare them with pictures online. And yeah there is no doubt about it.

Edit2: [Jesus christ.](http://www.youtube.com/watch?v=HhjCjte3BHE)",TIFU Infesting my home with brown widows.,373
ella1993,183,230,17pdc2,332,"[Update here](http://www.reddit.com/r/tifu/comments/17vta5/tifupdate_tifu_by_making_a_stupid_bet_with_a_guy/).

So there's this guy I'll call Roger who is a regular at a coffee shop I go to quite a bit. Roger is a really friendly guy and we've become sort of ""coffee shop friends"", which is to say we never see or interact with each outside of the shop, mainly because he's a lot older than me and we don't have a ton in common except for the fact we both enjoy sci-fi and fantasy books. Oh, and coffee. :P

ANYWAY one of the first times we talked at any length I was complaining about being harrassed outside of the shop by a guy passing out fliers for a ""naked maid service"". They were hiring, the annoying guy said, and he promised I could make a ton of money cleaning in the nude! No, no, there's nothing sketchy about it! All you do is get naked and sweep, vaccuum, etc. A lot of girls actually find it thrilling! Liberating! Almost artistic! Plus I could make $1,000 a week, honest! All his girls made at least that much!

Roger and I had a good laugh about it at the time. The flier was so ridiculous it was impossible not to dissect and ridicule everything about it. So it became sort of an inside joke: if I complain about work he'll say I could always fall back on my real passion: being a nude maid. Ha ha ha, etc.

Today I took my morning jog and decided to push myself to go all the way to the shop which is a bit longer than what I usually run. When I got there, Roger was there so I took a seat with him. I asked him what he'd been watching on his laptop and he said he was rewatching the TV show ""The West Wing"" because it's on Netflix now. I got really excited because I used to LOVE that show as a kid. We began to talk about the show, some of our favorite episodes, etc.

Here's where I fucked up big time: I told him that one of my favorite characters was the English diplomat character from earlier in the series. The one who was always drinking. The one played by Ian McKellen.

Roger laughed at me. He said that Ian McKellen had never been on The West Wing. He said he knew which character I was talking about but it was NOT played by Gandalf. But see, I was POSITIVE it was Ian McKellen. In my head I could see him drinking his scotch in the oval office, talking to Martin Sheen, etc. The fact that it's been years and years since I've seen that show didn't matter. Magneto was in the West Wing, I was absolutely certain.

After arguing about it for a minute Roger said, ""What do you want to bet?"" I told him I don't bet (history has taught me that nothing good comes from betting) so he started to look it up on his computer, shaking his head and saying ""That's because you know you're wrong.""

That pissed me off. I said ""WAIT!"" and he stopped typing. I then told him that I'd bet him $100 I was right. That's how sure I was.

He just shook his head. ""No, not money. If you're right, I'll shovel your driveway all this winter and mow your lawn all this summer.""

Now, that's another ongoing thing we've talked about before: the fact that my housemates (all male right now) insist that we trade off on shoveling/mowing responsibilities. Which I think is fair, even though that kind of work is usually done by men. I maintain I do a better job than the men do but I digress...

I said ""For just my turn, or everyone's turn?"" (referring to my roommmates)

He said ""Everyone. If it snows, I'll be there once it lets up. And then I'll mow once a week.""

Now I was giddy! What a hero I would be to my roommates! Free shoveling/lawn service for the rest of the year! I said ""Okay, and what if you're right?""

Roger looked me dead in the eye and said ""You have to clean my house from top to bottom.""

""How many times?""

""Just once,"" he said. ""Sometime in the next two weeks. I'll provide all the cleaning materials.""

I was even more happy at this point. I mean, so what? If I was wrong (and I **definitely** wasn't wrong) I'd have to clean his house once? Big deal!

""That's it?"" I asked.

Roger smiled. ""Like in your 'dream job', of course, you'll have to do it nude.""

That honestly made me laugh. I am so stupid I thought that the only reason he was making that a condition of the bet was because he was now sure he was wrong. No way he'd ask me to do that if he thought he was right. So I agreed to the terms of the bet, we shook on it, and then he went back to his computer.

He turned it toward me. My heart sank with each passing moment as I scoured link after link in the google search results. I went to IMDB eventually, refusing to accept defeat.

But defeated I was. Ian McKellen was never in the West Wing. The character I was thinking of was played by a guy who doesn't even look like him. 

So yeah, now I have to clean his house in the nude tomorrow. He offered to let me out of the bet but I refused: I have never welched on a bet. But I am definitely, definitely not looking forward to this.

**TLDR**: I bet an acquaintance of mine that Ian McKellen had been on the TV show ""The West Wing"". I lost and now I have to clean his house in the nude.

[Update here](http://www.reddit.com/r/tifu/comments/17vta5/tifupdate_tifu_by_making_a_stupid_bet_with_a_guy/).",TIFU by making a stupid bet with a guy I barely know and now I have to clean his apartment in the nude.,562
notfork,93,147,14zpca,330,"so things started like any other day then halfway threw my shift i get a text from the girl i have a mega crush on she wants to hang out so I am like fucking sweet.

Get to her place and we put on a movie then we get a little drunk and a lot high. 

well then things went really right she made the first move on me and things start to get hot and heavy, she then goes down on me and I don't know if its the crush or shes just really good but its the best blow job i have ever received then when I am about ready to blow I tell her like a gentleman she angels my penis up towards my stomach for me to finish but it came out with the force of a ten ton hammer and proceeded to fly all the way up to my face...

I guess you could say I got myself into a sticky situation. ",TIFU by giving my self a facial in front of my crush. ,477
ella1993,128,98,1dvjbc,330,"A few weeks ago I got pulled over for speeding and was issued a citation. Totally my fault, I was doing 17 over in a 40mph zone. But I decided to go to court for it anyway because I have friends who swear you can always get out of a ticket if you're willing to show up for the court date. This turned out to be BAD advice because the cop had only written me up for 5mph over the limit. I should have just paid the ticket online or something.

Instead I went to court. I was really nervous but started feeling better as the judge seemed to be very nice to everyone before me. She was lessening charges, dropping tickets entirely, etc. Then it was my turn.

She asked how I plead and I said ""guilty with explanation"" (it's one of the options on the ticket. Then she just stared at me for a good long moment and said ""Don't I know you? How do I know you, young lady?""

I had no clue so I said as such. Then she looked over the ticket and noted where I'd been pulled over. She asked for my explanation and I told her that I had just gotten off work and the road was empty because it was late and I was just in a rush and not thinking. All of that is true. Then she asked me where I worked. I told her the truth. That's when she got mad.

""That's how I know you"" she said. ""I'm a member of the [citizens for decency council]. You're familiar with us?""

I said yes. This council is sort of new but has been a pain for my employer: a local chain of ""gentlemen friendly"" restaurants (think the big US chain that pretends to be family friendly but all the waitresses where skimpy outfits and flirt with the customers; not a strip club!). Well this decency council has been staging protests in front of our restaurant, yelling at employees and shaming customers, for a few months now. They've also tried unsuccessfully to get the city council to rezone the area so that we can't operate there. 

So then this judge went on a tirade about how my restaurant had no place in an upscale suburban area like [city I work in/got ticketed in]. This is where I totally fucked up. I've seen too much TV I guess because I thought this would actually work. I said ""If you're a member of a group dedicated to shutting down where I work, shouldn't you recuse yourself from this case?""

Total Judge Judy mode: activated. She screamed at me for *daring* to question her impartiality. Who did I think she was? How dare I speak to her with such disrespect! That's when for some reason she asked me if I liked texting. Shaken now I told the truth, yes I did, I text all the time. She got super serious and asked if I'd been texting when I got pulled over. Again, thinking that watching TV made me a qualified lawyer, I asked her how that was relevant to the case (it wasn't: I had not been cited for texting while driving, which is illegal in my state. Also, I don't text and drive and had not been doing so that night).

For some reason she kept asking about texting. She asked the issuing officer (who had spoken before me) to get up and she demanded to know if there had been any evidence I'd been texting while driving. He said, ""No, your honor"" and she dropped it finally but not before telling me that she didn't believe for an instant that I hadn't been distracted by something.

I tried to explain again that I had been distracted by the thought of getting home, the empty road, etc. and she told me to shut up. Another fuck up here: I rolled my eyes because she was not letting me speak and I was getting really upset. She then threatened to cite me with contempt if I disprespected her one more time in her court.

Wisely now I just remained quiet until she issued her ruling. She gave me the maximum fine for the 17mph over the limit despite what the officer had written on the ticket (5mph). She then scolded me for another good minute about how girls like me meet early graves and that hopefully I had earned a lesson.

So now I owe 4x as much for the ticket than if I had just paid it online and I'm going to have a lot more points on my driving record. The judge was out of line I think but it was silly of me to try to correct her: IANAL. Trying to act like one made things worse. ",TIFU by trying to act like a lawyer at a court hearing for a speeding ticket... and for not handling an angry judge very well all around.,428
Skeet_n_retreat,65,59,1a3nz7,328,"TIFU, by using hand sanitizer after using the pen at my pharmacy. I got carried away and put way too much on my hands. I then proceeded to leave the pharmacy and light up a cigarette on the way to my car. I guess I got my lighter too close to the excess Germ-X, which caused it to catch on fire. The fire quickly covered my whole right hand, and scared the fuck out of me. I panicked, dropped the cigarette, and started to flail around trying to put the fire out. It went out pretty quickly,but I wasted a cigarette and looked like an idiot in front of a parking lot of strangers.","TIFU by using hand sanitizer, then having a smoke.",387
dndtweek89,60,85,15f806,329,"Merry Christmas TIFUers! Today as I was getting out of a taxi, i felt something fall on the floor. I assumed it was my glove, so I reached down to pick it up. I felt something, but then realized I had both gloves, so I just left it on the floor, and got out of the cab. Five seconds later, I realize what I just did, only to see the cab's taillights disappearing down the road. Tomorrow will be a fun day of trying to file a lost item report at the police station.

UPDATE: The cab driver tracked me down through my registration card. It's costing me a fistful of dollars, but I'm getting it back!",TIFU by losing my wallet. In a cab. In Korea.,414
schuppaloop,153,123,10o0oy,323,"I recently moved into my new apartment a week or two ago. Yesterday I decided I'd finish unpacking the remainder of my things and organize my room.

Since I do a lot of solo camping in remote areas, I have bear mace. This is no ordinary mace. It's ultra concentrated; I mean, the stuff would make Chuck Norris choke and tear up.

Anyway, as I was sorting through my property, I came across this bear mace.

I was sitting on the ground, directly in front of a chest of drawers, holding the bear mace, looking at it. I'd never sprayed it before and I wondered how it worked. Assuming there was some sort of safety, I saw the button on top and pushed it.

Immediately, there was the sound of compressed air rushing out of the can. I looked up to see a cloud of mist in front of me, and a large orange spot on my white cabinets (I'm assuming from the pepper concentrate they use to make this spray). Thank SCIENCE it was not pointed towards my face.

At this point, my girlfriend is already running out of my room, coughing. I'm also coughing, but it's not too unBEARable (get it? un-BEAR-able? eh?). I opened up a window for ventilation. Next, my eyes streaming with tears, I grabbed a towel and wiped off my cabinet. 

At this point, a vague memory came up in my head - someone once told me Firemen and Policemen used to put mace on their eggs in the morning, you know, to give them a little extra kick. Without remembering that bear mace is even more concentrated than traditional mace (and without thinking that particular story may be a myth), I immediately put the mace-soaked rag up to my mouth and licked it, timidly.

That timid lick was enough to set my world ablaze.

Reddit, today I fucked up.

**TL;DR I accidentally sprayed bear mace in my room, then decided to lick the rag I used to clean it up.**",TIFU. I sprayed bear spray (very powerful mace) all over my room and got it in my mouth because I was curious about what it tasted like.,446
mzbehavin,114,42,16bj0m,329,"This is EXACTLY why they have those warning labels all over the bottle of Ambien.  I had NO idea I had even called him until I looked at my phone this morning and made the horrifying discovery that I called 22 times between the hours of 2-4am!  WTF!?!  I was in denial until I got a call from him concerned that I had totally gone off the deep end and turned into the chick in Fatal Attraction.  Fortunately, he laughed once I explained.  Unfortunately, he shared the messages with ALL of his CO-WORKERS so they too could laugh!  Lesson learned.
UPDATE:  For those who have asked me about the content of the messages.....  Apparently, almost EVERYTHING I said was just jumbled and random nonsense.  The ONLY one that was clear was the worst one.  And that was the one he played back for everyone.  It was simply a 10 min. message of me singing my operatic rendition of ""Uncle f*cker"" from South Park.  Side Note:  There is a story behind that because South Park is one of his favorite shows and I was a Vocal Performance major so one night we were out at a bar with friends and I just made the opera version up for shits and giggles....   Anyways, back to my Ambien induced impromptu performance on the phone last night.  I don't think I will be picking up my phone for the next week at least.  Out of ALL of the embarrassing things I have ever done (and there are MANY) this is the only time that I really felt like it might be medically possible for me to die of embarrassment.  I just pray that he has some mercy on me and doesn't distribute it....
",TIFU - Called my ex and left MULTIPLE messages after taking Ambien last night,371
Poogri,28,100,1licu6,328,"My gf decided to come visit me (1 hr drive) after getting her **brand new car** less than a month ago. 
We hang out and drive around town, and then we realize that she is out of gas. 
At the gas station, she has trouble backing up into a vacant spot by the pump.
Being the macho man that I am, I offer to do it for her, and jump in the drivers seat while she stands by the car. 
I then proceed to somehow slam the fucking accelerator, backing up into a trashcan and then into the concrete partition, creating a quarter sized hole in the center of the metallic gash, complete with yellow paint from the partition as a finisher. 
GF looks in horror as I begin to shit my pants.

**TL;DR**: GF visits in brand new car, I fucked up by crashing it into concrete. 

**Update**: 
It was a honda civic, so it wasn't like some luxury vehicle but nevertheless it was brand new.

Initially it got complicated because the insurance company can't cover accidents that her asswipe boyfriend caused. She ended up telling her parents that she had a small accident, and left the marks on the car without fixing it to save money. After literally hours of profusely apologizing and offering to pay for the damages, my gf forgave me and to this day insists I don't have to pay for it. Doesnt matter though, I still feel like a jackass lol.

Btw i know this is a TIFU but this happened 2 years ago. We are still together",TIFU by crashing my gf's car,428
MadMikeLove,109,42,14rsus,324,"If anyone uses this browser, then you know it's very incompatible with a lot of websites, but the features are so useful that it keeps me using it.

So my online class's website is one of those sites that hate opera.

Throughout the whole semester i used google chrome to take the course because the radio buttons (little bubbles you click) won't work in Opera. Without thinking, i go into the final exam on opera, which is a one-sitting only 2 hour test, and quickly realize the mistake i made. The second i clicked on the first radio button, my browser locked up the page, and for 30 minutes i looked up possible real time fixes but nothing helped. I had no choice but to close the browser and tried opening the test in chrome. 

Nope.

0/100 on the final. due tonight at midnight. Possibly failed the class.

TIFU.

EDIT: I have tried to contact my professor, but all i can do now is play the waiting game.

2ND MAGNIFICENT EDIT: He's knocking 10 percent off the final and said I can retake it until midnight tonight. That is fair. I had a feeling that it would turned into a ""well it's your own fault"" kind of thing (don't get me wrong, it pretty much was my fault), but at that point I would've had to drive down to my school and start shoving library books in all the wrong places. Yes. That would've been my evil revenge plan.

3rd whatever the fuck edit: got a 97. Fuck yea. Which means I got an 87. cool I guess.",TIFU by taking an online final exam and using Opera internet broswer.,366
Mr_Gobble_Gobble,47,48,xjtxz,319,"So today my junk was aching to be massaged. The usual. Now when I was younger I had discovered that my step-mom had a secret drawer in her dresser full of pornos and toys. I only watched one dvd from her stash and it was a standard porn flick with the cheesy plot. Why I chose to venture through her porn  stash when I have a magical device that can browse the internet for infinite porn is beyond my understanding, but I did it. So I chose my dvd, titled '1' or 'I', inserted in my laptop, and dropped my pants. The video began and I instantly began rubbing it out. The young chick giving the guy head had marvelous tits and made the sexiest moans. I couldn't believe how great of a find this was. She finished giving him head and both the man and the woman drew their heads together for a kiss. That's when I fucking realized.. IT WAS MY DAD AND MY STEPMOM!

Fuck my orgasm, I wanted my dick soft - asap. Instantly I ejected the dvd and returned it to it's original place and that was that. My parents looked pretty young in the video (this must've taken place about a decade ago), so maybe that's why I didn't initially recognize them. Anyways, I'm never going in that fucking drawer again. Oh the regret

TLDR; I saw the homemade tape NO ONE ever wants to see. ",TIFU While Watching a Mysterious DVD,367
ARabidFly,72,59,1m9zm6,315,"I donated blood today because I like saving lives. They tell you after you are done giving not to do any heavy lifting, or and strenuous activity. Well a couple of hours had gone by since I donated and I had kinda forgotten about the whole thing. I was now at home when I started to get the urge to fap. Being a teenage boy I decided to go for it. Not 2 minutes into it and I get light headed. The next thing I know I am on the ground, cock in hand. I had passed out because all the blood when to my dick and I was low on blood to begin with.",TIFU by donating blood.,374
googie_g15,59,136,1l2dle,313,"/r/TIFU, today I come to you with my head bowed in shame, for I have truly fucked up. 

Last night, it was my friend's 24^th birthday so me and a bunch of friends were going bar hopping for the night. I decided that bar hopping would be much more fun if I was decently high as well so I proceeded to smoke a bowl before walking to the train and heading downtown. Well, I proceeded to take an extra hit so that my high would last through the night. This is the moment that I fucked up as I was easily at a [10] by the time that I got on the train. I sat down and just tried to enjoy my high while I traveled. At this point, I became so relaxed that I felt a fart coming on. 

After reading all of the stories you guys have about trusting a fart and shitting your pants I thought I could pull this off. I thought I was an expert. I thought I was invincible to trouser sharts. Oh, how wrong I was. 

As I was so relaxed, I tried to gently push this fart out and go on my merry way but I ended up realizing that this wasn't a fart a little too late. This was a full on turtle head poking out now and I had no way to go back. The deed was done so all I could do was pinch off this head and hope for the best. Luckily, this wasn't diarrhea and was a solid chunk. I hurried to the bathroom once getting off and cleaned myself up. Then I continued on my bar hopping adventure. 

This is where I fucked up a second time, /r/TIFU. Instead of going home and where I could shower and enjoy the rest of my high I continued to the bar hop. 

As many of you who have joined the Pants Shitting Club know, it's hard to really clean up after the deed unless you just shower and completely change. Well, I didn't do that and it ended up completely chaffing my asshole. After walking around to different bars all night I feel like I can't walk at all today without my asshole burning with the fury of a dying sun. It feels like the devil rubbed his dirty, hate-filled cum all over my whispering eye and marinated that shit for 8 hours. 

**TL;DR** I slew a brown demon and reaped the consequences. ",TIFU by shitting my pants while completely high on a public train,449
[deleted],44,52,10vrnl,311,"I am a background investigator and have to conduct national security/public trust interviews with people being considered for government jobs. This is usually done at a government/contractor office where the person was just hired, but in some cases they haven't started the job yet, so we have to do the interview at a library. Today I had an interview at a library I'd never been to before. It turns out the staff there would not agree to let me use the meeting room, so I had to run around looking for a place to sit in a quiet corner or something. The library was packed so when the person I had to interview finally showed up, I was standing by the only available table - a toddler table in the children's section. He's a little person. I didn't know. 

Once I saw the look he gave me and heard his exasperated ""Great,"" I realized IFU and we ended up wandering the library for another 10 minutes until we found a regular sized table. I know he thinks I did it intentionally, and I didn't even apologize because I was afraid that would be admitting fault that I deliberately chose the comically small seating area just for him.",TIFU by insulting a little person,363
bleedingumsmuffdive,87,76,149klx,320,"This is my first throwaway account, I'm fairly certain this story justifies it.

Okay, so I recently moved to the big city to start a brand new life after ending a two-year relationship and desperately needing a fresh start. In the first week of being here, I met a pretty young girl at the housewarming party me and my friends threw, and we spent the night together. We have been seeing each other on a few occasions over the last month, the sex is outstanding and it's great to rest assured that neither of us are looking for any serious commitment. We just get high, bang like animals, and get on with our separate lives. Hooray for that!

Now, over the last few days I've begun to notice my gums were hurting - I don't take the greatest care of my teeth and I've been drinking probably ten times more than usual since I moved here - but we were having an extended weekend in bed together as neither of us had plans and so the infrequent pain paled to insignificance in light of how much of a great time my penis was having. We had been making like the beast with two backs all day and it was pretty steamy. Nothing short of a gory disaster could have killed the mood.

Cue the gory disaster.

Things were getting hot and heavy for the (insert number) time that day, and I pushed her back onto the bed and began making my way down her body. I could taste something weird in my mouth, but I had experienced such a vibrant cocktail of fluids that day that I thought nothing of it. I get down to between her thighs and decide to aid the natural lubricative course of action, so she opens wide and I let a long thick strand of saliva cascade down from my lips. Not wasting any time to look, I dive in and go to work with my tongue. Okay, now I know *this* isn't supposed to taste like *this*. Not wanting to arouse suspicion, I gently tilt my head back to take a look, and I just see red. My gums were bleeding, I had drooled a thick amount of it onto this poor girl, and then proceeded to spread it all around sensually with my bloody tongue.

I gasp and recoil slightly in horror. She looks down at my face and her eyes widen in shock. I can't lie, I have to tell her. ""Oh my god, okay. Don't be alarmed. I have just bled on you."" To make matters worse, we had no toilet paper left in the house and so I had to clean her up very delicately using my boxers. She didn't look impressed. She was remarkably sporting about it in the end, but it's safe to say that the mood was sufficiently butchered by this point.

I proceeded to wash my mouth out with copious amounts of warm salt water, and the next day the dentist told me very sternly that I have a serious gum infection, bordering on gingivitis, and gave me a pretty strict warning that unless I want to lose all of my teeth, I need to take serious fucking care of them. He also said I have mild tooth decay and at least two teeth need to be removed through ""complex extraction"", before slapping me with a nice bill for his time and a big prescription of oral medicine that has left me with a mere £10 to my name, and my rent is due tomorrow, and I don't get paid until the 22nd. As you can imagine, these last few days have been an absolute scream for me. I dun fuckt up good, ladies and gentlemen.

**TL;DR - got a gum infection, drooled blood onto the snatch of a supple young fawn, cleaned it up with my underpants and then got financially and morally flogged by the dentist for being such a fucking idiot and not looking after my teeth. Take care of your teeth, kids. Take it from me.**",TIFU by spitting blood on a girl's chuff,396
[deleted],91,106,unxku,311,"I was sitting next to my friend in English class and I see he has his daily planner on his desk. I pick it up, flip to a random page, and draw (in pencil) a rudimentary penis. I show him and he laughs. He then takes the planner and (with pen) adds details such as hair and shading. It turns out to be quite impressive. We laugh, close the book, and promptly forget about until the end of class. We both get up to leave and I notice he left his planner on his desk. I note that he is leaving his planner and he says ""I thought that was your planner..."" We together realize in abject horror that we have drawn the master penis in our uber conservative ne-plus-ultra 60 YO English teacher's planner. 

ABORT. 

ABORT.

TLDR: A friend and I drew the master penis in a planner that turned out to be the English teacher's.

EDIT: Just to clarify, the teacher was female.",TIFU by drawing a penis,417
83kk4h,37,72,1iq9dc,316,"It was late at night and only my daughter and myself were awake. I was letting her stay up and watch shows on the Roku in the living room. I got her interested in a classic that I watched when I was a kid, Where the Red Fern Grows. 

Now, there are a few important points:

-I was using a smartphone app as a remote control for the Roku. It connects to the device via WiFi. 

-The Roku app has an option of streaming photographs from the phone to the television. You're always two clicks away from this option. The button for this option is right next to the button for the on-screen keyboard.

-I had food on my hands, so my daughter was controlling the phone.

I was trying to help her search for the show, and I reached down with my pinky to press the keyboard button for her. I pressed the wrong button. Somehow, by the gods that organize photos on cell phones, two pictures popped up on the phone. My husband's face and his dick, with matching red hair. In the dick pic it was pointing toward the camera, like something you might expect to come with 3d glasses. And the one that popped up on the television was the dick. 

Fuck.

She covered her face and gave me a stern, ""Mooooooommmm!"" I was so embarrassed that I immediately told my brother in-law and woke up my husband to tell him.

Honestly, it was hilarious, but I still feel bad.

tl;dr Showed my daughter her stepfather's dick in stunning 3d HD, on a 50 inch LED television. ",TIFU by showing my 10 year old daughter her stepfather's boner on a wide screen television,388
BrainChild95,91,145,18otev,317,"**TLDR; I got drunk... I don't remember much of anything but I hope I got a blowjob. I like blowjobs.** - **[Shotai](http://www.reddit.com/r/tifu/comments/18otev/tifu_by_possibly_sleeping_with_an_ex/c8gr5wb?context=3)**

So i just got back from holiday, (took a quick trip to Amsterdam to get away from london) and last night as it was my first day back i got black-out wankered with my mates at the pub

Now when i woke up this morning my heart sunk. I have a single bed with two mattresses on so when i have company i pull them out and make a double on the floor. Five star luxury i know...

So this morning i woke up on the floor, which was a sign that a girl was over but i had no clue who. I slowly roll over and see her, my ex. A girl who i actually hate. My mind starts racing a mile a minute. I jump out of bed and sit on a chair repeating in my head what the fuck have i done. 

I have no clue what i said to woo her into bed and im not even sure if i had sex with her. Interactions this morning were very awkward, with her acting somewhat normal and me trying to piece together what happened, while trying not to give away that i don't remember a thing. I just hope to god i didn't say anything i'll regret &amp; i don't want to ask because i have no clue what we did.

My memories always been shit, but to remember so little of a night is odd even for me

**Edit:** theres clumps of tear mixed mascara on my pillows so she must've been crying at some point

&amp; the last my friends saw of me i was walking home with her smashing the street up telling her to go home, she's the one girl who makes my blood boil. 

**more edits:** she just asked to come over and grab some shit she left, i told her ill take her for a drink later in the week and give her stuff back there. Should also say that this girl is completely in love with me

**FINAL EDIT:** she spoke to a mutual friend about the night and the same friend has filled me in on the details:

apparently she had nowhere to stay so i said she could kick back at mine, then on the walk back to mine she started crying saying she missed me was wrong to break up with me which got me angry and made me smash some shit up, luckily in my drunken state i was smart enough not to say that i missed her/loved her/ (which i dont) but i did say that nothing could happen between us unless it was purely sexual, &amp; i was done with emotions. 

When we finally got back to mine I gave her my classic neck kisses which resulted in a little bit of sex, but halfway through i dun goofed and admitted to shagging a friend of hers and now she thinks we have herpes and when she said this i rolled over and fell asleep leaving her up all night crying. But she did say the sex was some of the best shes had while it lasted. Also i was very persistent about getting a blow job, but she never said if she did or didnt, i hope i did i like blow jobs. 

She never needs to know that i don't remember the night, &amp; i don't plan on it happening again even if it is just sex. 

I dunno if this is still a fuck up anymore but this is only her side of the story and probably the only side we'll hear so dont interpret it as fact

",TIFU by possibly sleeping with an ex. ,462
ElPsyC,54,99,12z53u,311,"Well, I fucked up and may have killed a kitten. I was walking home from the park and saw a cute little cat. I tried calling it to get it to come closer but it just looked at me. So I walked towards it and it get up. I keep going and the cuter fucker runs away, jumping into a storm drain. And splash. That's all I heard. Not one meow. I stood there and now I'm feeling down. 
I hope it knew how to swim but it didn't look old enough.",TIFU by scaring a kitten,410
iamnotgoingtousethis,41,71,1fvp9d,314,"This morning before I left the house I pooped after I took a shower and then left for work because I was running a bit late. I live in Arizona where the weather is about 105 degrees right now and as a big guy, I suffer pretty heavily as a result of this. I park my car pretty far from work and walk about a mile or so to my actual office since parking there is a fucking nightmare. My stomach was weird this morning and I guess there was some leakage after I left the house this morning. As I walked to work, I felt the sweat and shit starting to combine and fester and I realized I had to get to work and wipe. The second I got to work, I basically ran into the restroom to do my business. I work in a small office so the bathroom is just a bathroom it's not stalls or anything like that. I pulled down my pants and bent over with my shitty sweaty ass facing the closed door behind me when someone walks in after I forgot to lock the door. I tried to tell her to close the door but all I got was this weird mumble whimper thing to come out. I'm now sitting at my desk embarrassed as fuck.

**TL;DR** Pooped, didn't wipe good enough, walked to work in heat, disgusting butt, didn't lock work restroom door when wiping, coworker saw.",TIFU by forgetting to lock the door,385
Pandumonium1,91,49,zu78z,310,"I started bicycling about a month ago and I ride about 4.5 to 7 miles a day its not much but its fun and its good for enjoying the weather now. So its raining today and I'm in my black pancho with the hood over my head and helmet on top of both. I must look like a complete idiot in the rain with this lopsided helmet and this black cape flowing behind me as I ride these country roads. Anyways I come up to a blind corner and I know to be careful for cars so I pull over and ride the shoulder. Insert tiny ass fucking black rock here. I was going maybe 15mph and alluva sudden my front wheel veers to the right my bike goes sideways and I flail my limbs in the air while doing a somersault down into the pavement. As soon as I get up I see that my bikes front tire was bent sideways and spokes were missing. So now I have to carry my bike home... in the rain with mud and dirt all over me and I'm in a black pancho with the tail flapping like a cape. About a mile down the road a man pulls up next to me and asks if I need a ride I told him no thanks that I was just a couple streets over and idea be home. He said suit yourself and as he drove off his pickup flung dirt and mud all over me. I get home and throw my bike beside my house cause I'm pissed and realize that I don't have my keys... they must have fallen out of my pocket when I failed. So now I'm typing this while the police show up because I opened a window and set off the alarm and don't remember the code.

Edit: TIFU by riding in the rain

EDIT: the rest of my day went better than expected thanks for all teh support Redditors btw this was my first actual post so I'm glad I didn't get shoved into the ground... again. ",TIFU by bicycling,359
splendid_splenda,78,61,103ahd,311,"So I'm sitting in the second to last row in lecture browsing Reddit because, well, I'm bored as fuck. So I click on the enlarge picture button of a particular front page post and **NSFW** [this] (http://i.imgur.com/H7SKd.jpg) *lovely* picture from r/pics pops up nice and big on my screen. Of course, there's no NSFW tag and I don't realize what I'm looking at until too late, and two girls from behind me ask ""splendid_splenda, what are you doing? Dude, not in class..."" So I turn around with face aghast as my one girl-friend shakes her head at me thinking I'm a pervert, and the *Christian fellowship* girl next to her laughs nervously and probably can't look at me the same. I wonder if they can see me type the story and understands it was a mistake. So here I am... bright in red in class still... typing onto an online forum...

**TL;DR pay attention in class so no one thinks you're a pervert**

Edit: NSFW tags",TIFU by making two girls in class behind me think I was looking up dirty pictures,372
PinkBootedBandit,158,194,1qb629,312,"this will be long and messy, sorry im on my 15 min break.

i took my gf (lets call her jessica) of 2 months to a party last night.  it happened that the party was in the same culdesac as her moms husband.  her mom was separated from her husband (not my gfs father) and lived with jessica in an apartment 15 miles away.  but now jessicas mom is moving back in with the husband and its only a matter of time till jessica is moving which means she will lose her job, she has no car.  

jessica already has problems with her mother, her mom assaulted her and constantly verbally abuses her.  they havent spoken in weeks, she abandoned jessica at 3 months of age in france and contacted her last year saying she wanted to make up for lost time.  

so replaying last night, jessica and i are leaving the party and we get in my car which is parked in the culdesac.  who drives by but her mom.  she even circled around to get a better look.  jessica told me to leave, so i did.  10 minutes later jessicas phone rings, she has a voicemail.  her mom is yelling at her acusing her of threatening her family and saying that if anything happens to her family or house she is telling the cops it was her and she wants the apartment key under her door tomorrow.  essentially shes kicking her out.  jessica is 24 and im 21.  she has no obligation to house her.  

after listening to the msg she starts crying hysterically and tells me the reasons why she cant go back to france (basically her dad who raised her wasnt her biological dad and told her to leave).  she cries all the way home and i tell her to grab her work clothes (we work at the same place) and can sleep with me tonight.  (i live with an aunt, my mom died 6 months ago and im finishing school.)

this morning when we woke to go to work she shows me an apartment nearby for 450$ 1 bedroom.  i have no idea what to say and told her we work part time and cant afford that.  i was thinking, ""we are together for 2months.  this is too fast"". 


so now i fear she will be homeless while im sleeping in my warm bed being selfish.  i didnt tell my aunt my gf was sleeping with me last night and i doubt she would be ok with it.  im knee deep in shit and dont know what to do.  i like her alot but i wouldnt say im in love.

tldr: toom gf to party, her crazy mom saw us and thought we were in the neighborhood to threaten her family.  kicking gf out of her house/life.  gf asks me to move in together.  im 21, not done with school and work part time.  she makes less than me.



edit: talked to her, she agreed that it wasnt a good idea to move in together. she starts looking for a full time job tomorrow.  as of now the locks on the appt havnt been changed.  thanks for the advice.  im not dumping her but i let her know im willing to help, but not to the point of it hurting me.

",TIFU by getting my gf kicked out of the house and now my life could be changed forever.,506
thirdeyepatch,30,58,1d2vlx,314,"So my dear mother has been in the hospital for a month now and my dad, sister and I take turns staying over with her. Tonight was my turn and since there are no beds available for guests at the moment, I fashioned one out of a bunch of chairs and a sleeping bag. At around 4 am I wake up with awful back pains from the damn chairs and decide to rearrange. Well, I took one of the many pillows that was piled on a chair, repositioned myself and rubbed my face into the deliciously comfortable hospital pillow. It was then that I got a huge whiff of urine and mom pubes and I realized it was one of the pillows that the nurses placed between her legs so her knees don't rub up against each other. 

:(

tl;dr: I cuddled with a a pillow with traces of my sick mother's urine. ",TIFU by burying my face in my mom's crotch pillow.,372
Messed_up_chick,56,134,1lbpxs,311,"So me and my male friend were in a video call. There's a lull in the conversation for a large period of time, while I'm just browsing the Internet. I began to pick my nose (he had muted his sound because his sister was watching TV in the same room) and afterwards I realized how sweaty I was (the room was really warm, ok?) so I sniffed my armpit. I tabbed back into the window accidentally, straight after, and then realized what I had just been doing. I had messages from him that for some reason I had not been alerted about where he was asking me what the hell I was doing. Fuck my life. I immediately told him I had to go and left the call.",TIFU by forgetting I was in a video call,445
Powerpython,63,55,175tld,308,"This happened a few nights ago, and I'm still trying to recuperate. So my friends and I had been planning this night several weeks prior and we were all really looking forward to it. But this night meant something more to me; the girl I've been interested in was coming and that was going to be the time for me to see if the feelings were mutual. I'll call her A.  

Fast forward to about 6:30, 1 and a half hours before the ballroom opens. I'm at Tacobell, eating more food than I should with a friend who's coming with me to the dancing. Afterwards we head back to my place, hang out for a bit, and then get dressed for the night. 

Right as I put on my slacks I know something is wrong. I haven't worn these in the longest time, and they completely constrict my lower intestine. I hear my gut gurgle, but despite my better judgement, I ignore it.

Fast forward, I'm at the ballroom and having a fun time, and it is packed with people. Having nothing in my bowels act up except for the slight discomfort of tight slacks, I decide it's now or never, and I go walk up to A. I ask her to dance and she gladly obliges. I've gone swing dancing before, so I begin to impress her with some of the dance moves I know. I then go to show her my favorite move, The Pretzel, which includes some twisting of the arms and body plus a dip at the end I like to include. Well, me being in the heat of the moment, I forget how tight the slacks are above my waist and I dip her. The dip then causes me to lean forward, causing the tight slacks to push immensely onto my lower intestine, causing 4 grande burritos worth of slimy shit to seep out my of ass and down my legs.

At this point I froze, still holding A in dipped position. She can tell something is wrong and asked ""Powerpython, what happened?"" Without thinking I drop her and quickly shuffle out of the ball room, leaving a trail of wet shit behind me. I hear her retch loudly over the music playing. I just drove home. I heard from my friends that they had to stop the dance and clean it up.

I'll never know if the feelings were mutual.

TL;DR I ate a lot of Tacobell, and ended up shitting myself while dancing with a girl I like.

",TIFU by eating Tacobell before swing dancing,363
spunkythoraway,122,73,18gbpf,308,"Here I was, minding my own business, watching the filthiest dirtiest smut I could find, because I'm just classy like that, and I really got more than I bargained for.

It starts off so innocently, as it always does. Me sitting here nude, contemplating my next honorable maiden, sifting through the garbage to find my golden angel.

And there she was, right there in front of me, shrieking like a banshee in heat, crying and begging for my thick cock. The internet truly is for porn.

So I'm going at it, edging like a madman, horny as hell, not even remembering the last time I spilled my spunk. Almost two hours go by, and the time for spillage is near. Now, I'm not one to boast, my average sized dick is average as you can imagine, but when the stars align properly, and the gods grant me favor, I can give Peter North a run for his money.

So here I am, leaning back as far as I can in my chair, deciding to lay a napkin on my stomach and commence spillage onto it. NOPE.

Spunk shot initiated, chambers are open, brace yourselves men, this is a one way trip from crotchville... aaaaand *liftoff* Mach 3 reached, sound barrier breached, **BOOM** headshot.

Dodging the napkin before me, I'm simultaniously caught off guard and forced to watch in slow motion, scumbag brain leaving my mouth agape in horror, as the spunkshot of the gods breaks the sound bearier and overshoots the target, landing straight down my face, making sure to not only splatter into my eyes, but also grace my stupidly open mouth, and work it's way up into a splatter of messy, sticky hair and beyond.

And this was just round one. The battle was lost, yes, but the war is still raging hard. Out spurts round two, only this time the initial shock of facialing myself caused me to lose grip of my ever vigilant man meat, which is now allowed to roam freely as my second blast shoots clear over my head and onto the wall behind me, and possibly on my rug, and I have to do something quickly to stop it, my stupid self thinks, so I hastily prevent it from further making a mess *by pointing it back down again*, which only proves to further destroy my vision as I blast one right into my eye, and another on my neck. But no, the fun doesn't stop here. With bravado that would impress even the energizer bunny, it keeps going and going and going, for nearly a dozen rapid fire bursts that make me realize that female and homosexual porn stars *really* couldn't get paid enough for what they put themselves through. It was a disaster zone, and my only consolation was that my barely scathed napkin was unharmed in the making of this mess, and was readily available to spit this fucking cum out of my mouth, and out of my eyes, and out of my hair, and off of my face, and off of the floor, and the wall, and my stomach, and the rug, and I'm starting to think a cumbox might be a good idea at this point.

Seriously.

tl;dr amateur performer finances the moneyshot and really pays for it",TIFU by misjudging the force of ejaculate.,381
nomanoid,189,83,14246s,303,"Turns out I had a problem in my toilet flush. It kindda looks like [this](http://www.alwin-bathware.com/wp-content/uploads/2011/10/CH070901148L11.jpg). The flush button had been jammed down by the cleaning lady and, of course, she happened to jam the one toilet that we *never* use (it's located in a spare empty bedroom that we have at home). Needless to say, the flush mecanism tried to refill itself over a period of nearly 30 days untill I finally realized there was a problem with it this morning. Now I'll probably have to pay about US$250,00 worth of water this month. And being the extremely lucky guy that I obviously am, I'm pretty sure mother nature will also find a way to retribute this any time soon. ",TIFU by wasting over 60.000 litres of water. ,386
punx_at_heart,68,59,1hw0al,301,"Its a summer day and being a 16 year old female enjoying the days of being home alone, I decide to put my favorite broadway soundtrack *Chicago* on. I hop in the shower to enjoy the jazzy tunes (because, who doesn't like to sing in the shower) and I don't bother to close the bathroom door because I'm home alone right? Getting out to dry off when my favorite, ""When your good to Mama"" is on. 
For those of you who don't know *Chicago* very well, ""When you're good to Mama"" is very sudctive if sang/danced right. So I feel hot when I sing this song and began to dry off in a senutal mannor, I put my leg up on the closed toilet seat and having a little sexy time in the mirror to see what I look like if I ever get a boyfriend and I do my little number when I turn my head to see-...
My Uncle, starting down the hallway. Gets a glance of my sexy-nakedness through the wide open door and my towel only covering one boob. He dives down the stairs and I grab my towel, turn off the music and shamefully dry myself off like a normal person, got dressed, and came out to the computer where I write my story of shame. 

TL;DR: Did a sexy towel dance in the mirror after my shower with the door wide open to the *Chicago* song ""When you're good to Mama"" thinking I was home alone, BUT, my uncle saw it all. ",TIFU by assuming I was home alone.,360
guitarded_joe,75,67,14nw7f,301,Title says it all.,"TIFU I had a dream I was having a piss, I was.",368
The_Velocilfaptor,41,78,1jj9ay,302,"This is a PSA, for all of you who think dancing with no dick restriction is a good idea. 
So I was just finished banging my lovely lady friend. We haven't gotten to do it in a while as she was on a vacation with her family for a wedding, so when she got back after almost 2 weeks we had some fun. I was so enthusiastic and happy that after I was done, I got up out if bed and decided to use my still semi-erect penis as a tool of entertainment to express my joy. I helicoptered like I have never helicoptered before and as my girlfriend giggled I began to lose the erection, but I guess because if the motion, it stayed heavy and long enough to have some serious momentum. Well she said something that made me lose rhythm and I swung down when I should've swung right and my meat club smashed into my low dangling fuzzy peaches, which were were swinging forward. I collapsed on the ground naked and held my funny bits cringing on the floor as my lady had the longest laugh of her life. 
So yes, TIL you can hit yourself in the balls with your dick, and it fucking hurts.
TL;DR: I danced too hard and smashed my fun pouch with my disco stick.",TIFU by helicopter dicking too hard,380
i_fucked_mustard,36,93,1l6x75,305,"I read a post on Reddit recently about a guy who fucked a jar of peanut butter and I thought about how awesome that would feel.

So earlier today when my housemates were all out and I had a bit of me time, I decided I'd try it out. I figured I'd just throw it away when I'm done and buy a new jar, no harm done. Unfortunately we didn't have any peanut butter in the house, but at the back of the cupboard I did find an old jar of hotdog relish that hadn't been used in about 9 months. I seem to recall it tasting pretty disgusting, but the chunky texture seemed perfect for my activities.

Little did I realise that this particular brand of hotdog relish contains mustard, and about 10 seconds into the activity my member started to feel a bit hot, and about 15 seconds in I was running to the cold tap because it felt like my cock had been stung by a swarm of angry japanese wasps.

**tl;dr** - I need a girlfriend that isn't condiment based",TIFU by fucking a jar of relish,398
motke_ganef,38,67,17wluv,295,"So there was this exam but I'm out of money but my buddies pay my beer.

After I drink the umpteenth glass I am out of my wits and my buddies advise I should really *go home*. Now I could have walked but walking makes me dizzy so I trod to bus stop, take the next bus to the train station,  take the next train. Vomit. Change trains. Vomit. Change trains. Vomit. Fall asleep. 

I'm thrown from the train because it isn't going anywhere anymore. Twaddle out right into a random pond. It's cold, but soon I somehow manage to swim and walk. I suddenly, somehow, am at home. My **home** is where my parents live. roughly 500 miles from campus. The next lecture starts in 4 hours",TIFU by the drunk decision to go home,362
tryingtoo,128,222,15uh4l,301,"1.  Go to the gym more often.  Went but lasted 10 mins.

2.  Eat healthy.  Ate pizza for breakfast.  

3.  Read more.  Ended up on reddit.  
",TIFU by breaking my new year's resolutions.  All of them.,523
orphdurph,146,39,w48zc,297,"So today I tried to prevent my hysterical, suicidally depressed ex-girlfriend from running into oncoming traffic by pepper-spraying her. According to the police officers who arrived, the only time it is appropriate to use pepper spray is on someone that is a danger to you; not themself. She cried and cried and cried and once it wore off, she ran again. What a fucking day. Fuck.      Fuck. ",TIFU by pepper-spraying my suicidal ex-girlfriend,336
krissee,88,74,1kbubp,298,"So this just happened a few minutes ago. It has been really hot here and when it get's hot my stomach acts up and gives me the Johnny Jogger's. Today was no different.

I was sitting on the computer as my husband watched some T.V when he disappeared. I told my friend with whom I had been talking to on Yahoo that I would ""brb... potty break"" I go down the hall to our one and only bathroom only to find it already occupied. UH OH! My cheeks were clenched as tight as i could make them as the oh so glorious sounds of my stomach gurgling and the pressure increased. My husband says he just sat down to do his nightly ritual and that it may be awhile as the heat was affecting him too. Cue drastic measures. I attempted to busy my mind with making the bed and just walking around. Guess what? IT DIDN'T WORK! As thoughts of me running out the door to ""commune with nature"" ran through my head I felt the pressure increase.

What could go wrong? I run out the door and into the tree line (I live in the country... thank God!) and as soon as my pants came down the molten hot lava erupted from my anus with the loudest most obnoxious sounds following with it.

Now may be the time that I should tell you that the piece of land i live on has 2 houses on it and while I thought my neighbor was out of town for work I will soon found out that i was mistaken.

He had just gotten home and was out in his yard and heard my grunts and other noises. Not knowing what it was he came thinking that an animal was hurt, ( I didn't know i sounded so pitiful), and as he came through the trees I released one last spurt of liquid shit hitting his legs and feet. I heard his exclaim of surprise, realized what had happened, pulled up my pants and, with crap still running down my leg, ran into the house. By the time I came back my husband came out and told me the bathroom was free.... To little too late. I am pretty sure I will never be able to show my face to my neighbor again. I showered up and came on here to reveal my misery and embarrassment to the Reddit world.

TL;DR didn't beat husband to bathroom while having diarrhea, went to tree line, neighbor comes out and i spew liquid shit all over his legs and feet... FML

",TIFU by not beating my husband to the bathroom.,372
Illpackallama,43,54,1e6bne,299,"So to start the story when I was a child I used to occasionally have dreams that were so intense that I couldn't tell if they were real or not. Tonight, I had one of those dreams again.

Going to bed tonight seemed like any other night. I bushed my teeth, cuddle time with the wife while reading, lights out. So at some point in the night I wake up having to pee really badly. I roll out of bed and stumble through the dark to the bathroom. As I begin to relieve myself something feels strange to me. I can see the stream of pee coming from me and hitting the water, but there's something wrong, like I'm holding back at the same time. It's at this point that I actually woke up.

I jumped awake and a moment of holy shit thoughts came over me. I realized that instead of actually getting up and using the toilet, I had dreamt it. I had, however, pissed all over my bed and self, with my wife right next to me. I quickly jumped out of bed and this time went to the bathroom and grabbed some towels. I came back into the room and quickly set about soaking up the pee.

As I'm mopping up the mess I realize that my towel keeps getting soaked. Now, normally since I have a king size mattress, I keep a cooling cover on it ( basically a really thin breatheable waterproof membrane, it helps keep it cool in the summer and protect the mattress from sweat stains), so I thought it would be a quick cleanup, since the piss would have just been on the sheets and not soaked into the mattress itself. After soaking two towels in a row I realize that something is not right. I stripped the sheets back from my side and upon doing so realized that the cooling cover had come undone, and my side of the mattress was completely unprotected. 

It was at this point that my wife woke up. I explained my embarrassment, so she gets up and starts helping me clean up. She says soap and water dabbed onto it will help pull and urine out so I go to the sink, get a soapy rag and start dabbing. Once I'd used up another towel I felt that it was pretty well clean, so I went to the cleaning closet, grabbed a bottle of Shout, and went back in and sprayed liberally, hoping that the Shout would kill any piss smell. It was at this point that I quickly realized that my wife, being pregnant, has a super sniffer. She immediately runs out of the room and I follow, realizing that the chemical just set her off. She gave in the hallway while I try to cover the scent with some air freshened. Big mistake. 

The combination of laundry cleaner and air freshener is too much for her, and without a word she stares a dagger or two my way, grabs her pillow and heads for the guest bedroom. I put the fan blowing on the mattress, grab my pillow and head for the couch. Which brings me to now, at 0430 am finishing typing this. I have to be up in 1.5 hours to start my day. Tonight I definitely fucked up.

tl;dr: Had a dream that I was peeing, pissed on $5000 king sized mattress, made pregnant wife almost puke from cleaning chemicals. ",TIFU by having a dream,353
Paars,60,55,z2ki3,297,"We were just laying on the couch with my legs over her lap watching TV at one moment I get the brilliant idea to tickle her so I commence operation Wiggle &amp; Giggle wish ended in great succes. Shortly thereafter however enemy ticklers arrived at my feet to avenge their fallen comrades of the Armpit Division seeing myself dangerous position I call for an immediate abandonment of the leg region resulting in me pulling my leg back lightning fast causing my knee to fly up hitting her right on her front teeth.

**TLDR: hit girlfriend in the face with my knee, front teeth abit lose, girlfriend needs braces again for 1 year to fix caused damage**",TIFU by hitting my GF in the face with my knee,352
adamh95,63,79,1mmmxu,299,"this is a late post, but I have been cleaning the mess and I was too embaressed to post this at first but oh well, here goes. 

So this weekend I went out to a friend's house to drink. We were having a good time and I had quiet a bit to drink. In total maybe 5 beers, 3 shots of tequila, and a screwdriver. Since I live round the  corner they walk me back to my residence hall. I go in and wait get my stuff, because I promised my other friend's I'd stay over at their dorm room. (We are college students). My roomate ensures I get to the bus safe and I get on. Fast forward to their room, where I make it safe no problem. They make me go take a shower and ready myself for bed. I stumble around and leave clothes all over their floor, but other than that I showered and got ready fine by myself. 

At this point I should tell you that they live in a triple, and one of them was not present. He is a good friend of mine and he is gay, his name is anthony

So I sleep in Anthony's bed and pass out instantly no problem. Apparantley, according to his roomates who are also real good frineds of mine, I woke up and pissed in his desk. They told me that they were awoken to the sound of running water. 

Here is how it was told to me.

""I woke up to the sound of running water and I saw you in front of Anthony's desk, with your pants down. It's like six in the morning so I hope to God I'm dreaming. 

'Adam please tell me that is a waterbottle'

'It is don't worry about it'

'Adam let me see it.'

'Don't worry about it go back to bed.'

You then finished walked back to his bed and then stopped looked at me and said. 

'Don't worry, Anthony likes to play with penis juice anyway.'""

I was upsetto find out this was true so I spent my whole evening cleaning out his desk and airing out their room. I also had to dry out all the stuff that got wet. It was an extensive 6-8 hours of cleaning up. Luckily he forgave me, but I still feel like a major dickbag. ",TIFU by pissing in a desk,378
thebornotaku,58,205,15nwfk,296,"So, My girlfriend was on the bed behind me, drunk, and playing around with her iPod. She was having a conversation with Siri, and asked what a penis was.

Naturally, I (also drunk) turned around and whipped my cock out.

She works her way over to me and starts playing with my junk. She's on her knees on the bed, and I'm standing. She starts blowing me.

After a minute or two, she rolls back and lies down on the bed. I decide I want more so I get down on my knees next to her on the bed and she starts going at it again. She's holding her iPod and I get a brilliant thought: ""*Man, this would be hot if I got a picture*"".

So I grab her iPod, open the camera and get a shot of her with my cock in her mouth. Her eyes were closed before. They open, she looks me in the eyes, my cock drops out of her mouth and she says ""That goes straight to the cloud, you dickhole.""

**tl;dr: Took a picture of my girlfriend with my cock in her mouth, learned that iPods upload images directly on to the internet.**

^^and ^^before ^^anybody ^^asks, ^^the ^^picture ^^was ^^deleted ^^immediately",TIFU by taking a picture of my girlfriend. (NSFW),501
nike215,32,71,1pwjkk,297,"So on Halloween we had a fake graveyard with funny names/sayings on them like Anna Rexic and etc. It took a little while to set up but it came out pretty nice. The day after Halloween I decided to leave them in my lawn, as I didn't feel like putting them away and it looked nice and I figured why bother. This continued for the past couple of days as I was extraordinarily lazy. Fast forward to today.

My neighbor across the street was a nice older man. He was around 80 years old and had lived in that house for as long as I could remember. He would yell at us for playing street hockey, but only because he was always taking care of his bed-ridden wife of around 50 years, and she was sensitive to sounds. We always respected him and did whatever he needed us to do. He still gave out candy on Halloween, but you could tell he wasn't looking very good as of late.

 If you hadn't figured out already, I have to talk about my neighbor in the past tense, as he died early this morning. It was pretty sad. He fell down and died, pretty gruesomely. He broke his neck and his arm he used to brace his fall ended up being ripped to shreds, as his skin was so weak from his age. A very scarring event.

As I was leaving the house this morning, I felt a pretty strong wind, so I decided to go back inside to get a windbreaker. When I went back outside I began walking to my car, but  I noticed something on my old neighbor's front lawn. Curious, I wondered over. The closer I got to the object the more my heart started to race. I pick it up and I could not believe what I saw. It was one of my tombstones that got blown over to his house by the wind. Not just any tombstone however. The tombstone that ended up on his lawn was that of Humpty Dumpty, with the phrase ""I was pushed!"" I was horrified. I quickly picked up the tombstone and brought it back to my house. Now I believe the reason he left his house was to pick the decoration up off of his lawn, which lead to him falling. The irony, the horror. Today I Fucked Up.

tl;dr Didn't put Halloween decorations away, neighbor falls and dies, ironic tombstone already there.",TIFU by not putting my Halloween decorations away,368
hohuho,39,41,zuvbm,296,"I'm male, in a 30 person class that discusses gender and sexuality in Asian countries, and I fucked up big time.

In the middle of our lecture, we began discussing a short story we had read, and our professor told us to get up and walk to different parts of the room that she had designated to represent various opinions we had about it. My opinion sent me to the opposite side of the room, so instead of bringing all of my stuff with me, I put my laptop down in my chair, facing away from most of the class, and I walked over.

As I'm standing around, and we're discussing our views on everything, I notice that my TA and two of my classmates are taking glances at my computer, giggling hard and turning red for over a minute. I put two and two together and rush over to my desk, but nobody really takes notice. It turns out that my disc drive began playing a DVD of Japanese porn that my friend bought for me while he was in Japan, that I had forgotten to take out. In the middle of a gender and sexuality class focusing on Asian countries. At least the sound was off.

As soon as I noticed this, I slammed my laptop lid shut, and played it off as cool as I could, saying something along the lines of ""sorry friends, I don't know how that got there!"" It's not the end of the world, but it's still fucking embarrassing. Oh well, life goes on.",TIFU in a gender and sexuality class,337
tcpdrangon,62,150,1q11g7,293,"So, I asked two teachers for a recommendation letter for college. Both of the teachers knew me the best, and the schools I'm applying to all allow two letters, few allow three, but they all require two. 

Anyway, one of the teachers still hasn't written me a recommendation letter, even though I asked her two months ago and reminded her. Now, I can't apply early anywhere, and I will miss out on at least two scholarship opportunities.

*EDIT:* to everyone who keeps reminding me that it is my fault, I know it is. That's why I submitted it to today *I* fucked up. The wording makes it seem like I'm blaming her, but rest assured, it's mostly my fault.

*EDIT:* My teacher finished the recommendation letter, and I was able to submit my Princeton and my scholarships on time!",Tifu by relying on a teacher for a recommendation letter,443
Deja_Entendu92,63,67,17xjyu,294,"First all, for those of you that don't know what headsooth is, it is a chapstick like device which you apply to your forehead when you have a headache, it gives a deep cold/burning sensation which isn't pleasant and the best of times.
 
So there we were, pre-drinking before a night out, having a right old laugh ect. When my mate pipes up to my other mate ""Hey man, I dare you to put headsooth on your dick"" which he understandably refused. Then an intoxicated me chirps in, ""I'll do it if you do"". The alcohol takes over and he agrees, putting the headsooth down his jeans. He then throws it to me, and as not one to back down from an agreement, I lathered that shit on. Really pasted it. I finish and give it to the original 'darer', who is curious and gives it a go. 

Next thing I know, the first guy screams 'FUCK THAT' and runs upstairs.. No longer than 20 seconds later the slight tingling in my balls turned to a furious burning sensation, to which I ran upstairs in agony. I run to the nearest sink and pull out my manhood, and what do I see? My balls, shining like a beacon, red as a London bus. I hear a scream from downstairs, and the last guy runs upstairs screaming. So there we are, three guys, luckily with three sinks in separate rooms, washing our balls. The pain was unbearable, I thought I was going to pass out. It was a hybrid of burning/aching/stinging in the most sensitive of areas. I felt like I needed to piss, shit and just die all at once. So I walk out into the hall, the water on my balls doing nothing, and keel over half screaming and half laughing at the other two's screams. They're vigorously washing their balls and having as much luck as I am.

Next thing I know my girlfriend and another mate come up stairs, he briskly takes a snapshot of my firey balls and decides to send them via whatsapp to everyone we know. I couldn't close my legs for a good hour after that.

TL;DR Put headsooth on balls, searing pain followed

Edit: Here's my balls http://i.imgur.com/IsvYBcM. NSFW, obviously. It's my fucking balls.",TIFU by putting 'headsooth' on my balls,361
im_tw1g,82,108,13aof7,297,"Well, Nofap November caught my eye. I had read about the supposed benefits of it so I though I would give it a try.

I personally did not see the benefits, and so on my 17th night (from Halloween) I ended my streak. A little too enthusiastically.

I didn't really anticipate that 17 nights of buildup would go all over my shirt. Or my iPod. That's right, I'm typing this over a thin layer of badly wiped semen. Wearing a shirt splattered with potential babies.

I'll go get changed.",TIFU. Fucking No Fap.,405
Workacc1,85,50,1hg2y9,291,"This is probably the stupidest thing I think I have ever done. At least I feel like it.

A little background, I had a great weekend which didn't include a lot of sleep, so that is a factor. I also drive a standard (stick), which will also come into play.

Anyways, going into work this morning and stopping at 7-11 for a coffee. The grade of the parking lot is maybe 1%, probably less heading back into the road. Pull up in front of the store, grab a coffee and a clif bar as I skipped breakfast for the sake of sleep. Got up to the counter, made my purchase, and turn to head out side. I notice my car going backward, about halfway through the parking lot now. First thing I think is ""someone is seriously stealing my car right now"", but wait, there's no one in the driver seat. As I'm running out to grab my car it dawns on me that I failed to get the car in gear to stop it from rolling. And yes, no e-brake was on either.

The situation on the road was blocked cars waiting for the light to turn green. At the halfway point where my car was at, light turns green, cars in my car's path get out of the way... barely. The cars behind those, thankfully, saw my moving vehicle, and were honking with no response...

Until they see me running into the road, hop in my car and drive back into the 7-11. And after about .5 seconds of me comprehending everything, I promptly left the 7-11 to probably never return. I have never felt so stupid.

tl;dr: Didn't leave my car in gear when I went to get coffee, car rolled into the road, but caused no major damage other than my pride.","TIFU, ""Why is my car traveling across traffic while I'm getting coffee""?",341
RaptorGoRawr,70,34,10yccs,290,"So I work the overnight shift doing tech support and got off work this morning and decided to take care of some needs before going to sleep. 
I use a Hitachi Magic Wand that plugs into the wall (who needs batteries?) and did the deed then rolled over and went to sleep.

At some point I must have rolled onto the wand weird and the next thing you know I hear a ""POP!"" and feek a burning sensation on my arm, which needless to say woke me up. There I am, almost naked watching sparks shoot out of the wand where it connects to the cord and also the wall socket. 

I quickly throw the damn thing off the bed and pull it out of the wall socket but I can see small flames starting in the wall socket. I quickly stumble into the kitchen (right next to my room) and grab the baking soda and dump it in/on the wall socket which luckily puts it out.

I then discover however that this has fried the electrical stuff in the laundry room and my bedroom and bathroom. No amount of flipping the breaker is going to fix this one so now I get to come up with some story to explain to my landlord why I need an electrician out there. 

TIFU",TIFU by setting my house on fire with my vibrator.,324
DickPringle,42,64,1gt64r,289,"So I have a weird cat that eats literally everything he can get his hands on. (avocados, sweet potatoes, chips, eggs, almonds, dog bones, you name it). As I was eating the steak the lil' fucker was watching and begging for a piece for the duration of meal. He's still somewhat of a kitten and he likes to stand on his back legs to inspect and beg for stuff. Well in my infinite wisdom I decided to dangle a long piece (four inches) of left over gristle out of my mouth for him. I've done this many times before with him but never with steak. Well as soon as I put it in my mouth and dangled it above him he leapt way higher than I had anticipated and sunk his teeth into my top lip and the steak all at the same time. Right away I knew he got me good and blood started pouring everywhere. I have a beard so it was hard to tell right away but it probably could've used a few stitches but I Just superglued it shut instead. I was more worried about infection so I scrubbed the shit out of it first and got some antibiotics just in case. I'm going to a wedding tomorrow and I'm just going to tell people a hooker bit me because that sounds more reasonable. 

Here's the lil' fucker pretending he's not a violent bastard: http://imgur.com/ngkUNll",TIFU by trying to let my cat eat a piece of gristle hanging out of my mouth.,353
[deleted],42,40,169655,293,"I'm wearing gym shorts today, as I just woke up and wore them to bed. On these shorts there is a drawstring that hangs out over the front. For some reason this one is oddly long. It hangs perfectly to the very end of my cock tip.

My cat is still a baby and her claws have just fully grown in and are extremely sharp, I'm talking if you tap the point of these things with your finger you'll more than likely get a tiny puncture.

My cat likes to play with things that hang. So she got a little hyped up and was standing on top of a table so I took the drawstring from my shorts and started twirling it in front of her face and she'd playfully swing at it, and roll over and try and bite it and it was all fun and cute, no harm done.

Until....

I had stopped playing with her, for well over an hour, and was making myself a cup of coffee. My cat walked over while i was mixing in the cream and sugar. She rubbed herself against my leg and i thought nothing of it. Until I felt a horrible horrible pain. My cat, in the blink of an eye, stood on her hind legs,  and took one big swing at the drawstring on my shorts. She got the drawstring, but she also got a pawful of something I don't think me or her were ever bargaining for. Her claws came out obviously, and (I am almost positive) each claw on her paw punctured straight into my dick. A few on the shaft, at least two on my actual dickhead. She had gone through my shorts, through my boxers and into my dick. Her claws not only got stuck in all the fabric, but also in my penis. By natural instinct, this caused me to pull my hands away from the coffee I was mixing to grab the cat off. In doing so i knocked the coffee over directly onto my stomach, cocknballs, and cat.

I was now twirling around my kitchen, with a cat stuck to my dick and scrotum by her claws, and we are both dripping in hot coffee. She went even more crazy once the coffee hit her and began jerking and twisting her body violently to release herself from my cock and shorts, which in turn made everything worse because she didn't get unstuck so easily, causing her claws to puncture my dick a good 4 or 5 times repeatedly. Eventually, within at least 10 seconds she unhooked herself and ran away. But it literally felt and seemed like a lifetime. I'm pretty sure my dick is okay aside from a few obvious scratches and small wounds, and I walked away with minimal injuries as did my cat, we both just need a good bath.

The sounds she made while stuck to my cock by one paw as we danced circles around my kitchen will literally haunt me for months.



",TIFU and got the worst handjob ever from my cat.,333
FlyingMonkey420,69,52,10giac,287,"The worst part is it's over a dumb driving charge. Now is looking like I might spend a few days in jail and lose my job that I got just 2 days ago

[UPDATE] After a long day in jail I am finally home in bed I will re-update in the morning after some rest","TIFU by thinking that my court was at 1 pm when it was at 8 am, now I think i am waiting to be arrested",339
markwarren_18,105,135,158zga,285,"So today was the last day of school before vacation.  In my second to last period class, we all did a secret santa.  I received a nerf gun, and i was excited to live out my inner child.  

In my last class,  a bunch of us were hanging out in the choir room, since we just got back from caroling around the school.  I went to get my backpack and took out my new aquired nerf gun and decided to say ""This is a stick up!"" Pretty loudly.  In my mind, i was pretending to be a bank robber.  The others thought I was mocking the recent elementary school shooting, which I didn't realize until it was pointed out to me.  Needless to say, i felt like an asshole.  The girl I like was in there, so I hope she doesn't think badly about me.",TIFU by pretending to start a school shooting,420
SuperNinKenDo,91,97,11mly8,289,"Had a shit of a day, but headed to the pub with some mates to lift my spirits. Darren was there, a mate I really like. Great guy, bit sensitive and shouty, and a bit of a misfit. He was rather flirtatious and I reckon he had it in the bag with this rather saucy Maori chick from town.

We leave the pub after being basically chucked out, and head down the road, me, Darren, Carl and Jess (Kiwi). Anyway, Darren has his arm around her and everrything, and as he begins to walk her home, me and Carl are teasin' them a little.

Anyway, I guess we took it a bit far, because Darren got sent back to us.

This is a guy that gets a little too much of the piss taken out of him, and I've always made it a point to not be like that. When he got sent back, he was seriously pissed and would barely talk to me, and I realised then that I had legitimately cock-blocked him for sure. Before that it was just a bit of teasing, but I realise now that he was definitely ""in"".

Anyway, I feel like shit about it.

It's not a funny story, but for me, it's a major fuck-up and something I'll actually feel bad about for a long time probably.

I really, sincerely apologised repeatedly, but it didn't matter, he was upset at me.

I feel awful.

Sorry to share such an unfunny story with you all, but God damn do I feel like a cunt right now.",TIFU and cockblocked a mate.,386
LSU-QT,49,51,1j11lf,285,"Yesterday I decided to clean the office coffee pot with vinegar. I am not a coffee drinker myself, so I didn't know you were supposed to run a bunch of pots of water to flush it. My boss had just finished chewing out a guy for something he messed up, and was furious. He walked over to the pot, fixed him a cup of coffee, took a sip, and began to throw up. I saw him throwing up, and was asking if he was ok. He proceeded to ask me if I cleaned it with vinegar. I replied with yes. He asked if I flushed it. I told him no I didn't know I was supposed to. I went to the pot and could smell the vinegar reeking from it. 

To make matters worse- It's my boss's birthday today. ",TIFU by making my boss vinegar coffee.,336
no_control80,41,38,171ald,283,"Throwaway account 'cause ... yeah.

I was printing out some documents at home when a familiar urge plowed headlong against my anus.  I have bowel issues, so when I have to go, I HAVE to go.

Bowels: ""Gotta poo, NOW.""

So, I grabbed my smartphone (poop surfing) and headed to the bathroom.  We have a baby gate at the upstairs guest bathroom door, because the dog likes to wander in and eat at the litterbox buffet.  So gross.

Anyhow, I tried to do my usual hoppity over the gate, but we have a houseguest, and there was shower water on the floor.  Not realizing this I put my full weight on the hop-leg, and it goes RIGHT OUT from under me.  ZIP.

I fell, wrenching my left hip and knee.  Fucking ow, man.

The worst part?  As soon as my ass hit the ground I immediately heard a ""PLURFLURBLE"" and felt a damp heaviness in my pants.  I don't know if it was the urgency or the pain or the shock, but at that moment, my asshole just Gave The Fuck Up.

Dammit.

The houseguest rushed in and offered me a hand up.  ""NO I'M OKAY THANKS,"" I say a bit too eagerly.

""Are you sure?""

""YES I'M FINE THANKS,"" I said quickly, still stunned at the cacophony of buttmud in my jeans.

He left and I shut the door quickly, hopped in the tub, and assessed the damage.  Yep.  Pooped ALL the things.  Underwear, jeans, the whole nine.

Did I mention I'm a girl?  Whee.  You know, certain men can rail against pube hair all they want, but I'm telling you, my moderate little nest kept the worst of the unholy hell from reaching my inner lady-parts.

Nevertheless, I thoroughly washed down there twice, drew a shallow bath, soaked my vagoo, then washed and rinsed it again.

My houseguest thought it was HILARIOUS.

I'm sure my husband will too.  Fuck.

EDIT:  Told the husband.  He had to sit down on the staircase because he was laughing too hard to stand.",TIFU by slipping on the floor and shitting myself.,321
mikhail_harel,48,56,1g3kl2,285,"Today I was on my way to a session with a sub of mine, and the following happened:

I'm visually impaired and can't drive, so I'm stuck taking the bus.  There was half an hour before my bus came, and I was kind of hungry, so I decided to make a trip to the local grocery store.  I just wanted a sandwich, so I didn't bother with a cart going in.

Well, I ended up buying more than I anticipated; some of my favorite desserts were on sale, and because I didn't get a cart, I put them in my bag with my toys.

I went to check out, and because I still made it under the '15 items or less' limit, I used that stand.  Without conveyor belts.

So I go up, we exchange pleasantries, and I unpack my own stuff.

&gt;Cashier: Oh, you brought your own bag?  I'll give you your bag credit, then.

&gt;Me: Er, bag credit?

&gt;C: Yeah, it's our new program.  You get ten cents off your total for each of your own bags you bring in.  Which brings your total to [total].

I turn my attention to the pay pad, swiping my card, entering my pin, etc.  

And it didn't really register in my mind until just as it was happening: the cashier was reaching for my bag to put my groceries in.  

Now, my toys were clean.  They didn't smell, they didn't have any cum or anything on them, but put yourself in the position of this poor woman: You're just trying to get through your day (given the time it was, she had either just started or was just about to leave), and you have a seemingly 'normal' customer with a bag of BDSM toys.

&gt;Cashier: Oh.  Um.  Do you want me to bag your groceries for you?

&gt;Me: *ohgodohgodohgodohgod* Um...no...I've got it...*frantic rush to pay, take my receipt, and get the hell out*

I take my stuff, sit down to check my email to make sure my sub was still meeting me, and who comes by but the manager of the store.

&gt;Manager: Um, sir?  Can you maybe close your bag so it's not open for the entire public to see?

In my rush to sit down in the cafe, I didn't realize that my bag was in the middle of the isle, open for any passerby who happened to look down to see.  I sheepishly reach down, tie the bag shut (It was one of those reusable bags; it didn't have any sort of clasp), and get back to my email.

Not only is my sub not meeting me, I'm now known as 'the creep that carries sex toys everywhere' at my favorite grocery store.  I just wanted a sandwich, god damn it.

TL;DR: I just wanted a sandwich...

**EDIT**: Oh god now they're disinfecting the whole area where I was sitting...that's just unnecessary",TIFU by taking my sex toys to the grocery store,341
thejayman41,70,160,10d7rj,285,"I was sitting in my room when my mom yelled that everyone would be grocery shopping and that i would be home alone. I waited for them to leave and then I got to business (wandering around my house naked) it was maybe an hour later when i was exiting my room again when, suddenly, my mom burst through the front door. i immediately slammed my door shut out of reflex. the entire earth could probably hear the sound of me screaming as my penis was viciously slammed in the door.",TIFU shutting my door,445
ThrownAway956,50,84,1j98mg,284,"Hey Reddit. You know the way when, whenever you cum... you get really tired after?

Yeah. So I made the mistake of masturbating. In bed. Late at Night. While tired. Here is what transpired.

You see, I have weird fetishes. I'm the first to admit that. Transformation? Fuck yeah. Hyperendowment? Hell yeah motherfucker! Lactation? Gimme that! Multibreast? Why the fuck not! Furry? I'd *cuddle* that if you know what I mean. Pretty much anything you can think of, bar scat, watersports and Brazillian fart porn.

My mother might just know about this now. Fuck, my, life.

Because you see Reddit, I found a wonderful thing called Flexible Survival, by Nuku Valente. It is interactive, textual porn. It has a lot of things I like in it. I came, many, many times.

Unfortunately... I fell asleep after cumming. During a really intense, really detailed sex scene.

And what do I awake to?

My mother. Perched at the side of my bed. Holding my laptop. Staring at the screen. She turns to me.

""Throwaway956..."" My life flashes before my eyes. My heart pounds. I think I'm having a heart attack. I might have just evacuated my bowels. I could die right now. I wish I was. ""Your laptop..."" FUCKSTICKS. ""Is very hot."" I do not feel relief. I do not. Because she's logged in to my account. Which, last I knew, had said kinky detailed intense sex scene on it involving me, a woman with six lactating breasts, with the body and face of an anthropomorphic dog, and a dick that could more appropriately be called a third leg, pounding and being pounded by various very kinky creatures, and being transformed as a result of said fornication.

She hasn't said a word about it. But I have noted a large rise in 'joking' ""Sure you aren't gay?"" quips from both parents. I can not look either parent in the eyes, despite the fact I'm a legal adult who has a pretty much legal right to look at porn.

**TODAY. I. FUCKED. UP.**


And, link for the interested, to Flexible Survival: http://blog.flexiblesurvival.com/

And, also, this shall be a public throwaway, for all you nice people. The password is ""throwaway"". I hope I spelt it right while I was typing it into the register screen.

Edit: Yup, he spelt the password right!

Edit 2: Changed the password-I'm not a nice person. Well, no one's going to start screwing up this post, I won't say the new password!",TIFU by falling asleep with really kinky interactive porn on my Computer Screen,368
[deleted],121,120,143kct,279,"My mom was cleaning the tea stains off of a cup, so she rinsed it with a small amount of bleach. However, she didn't do a very good job of washing it out, and placed it with the clean ones. 
I got a glass of ice water, and filled it, and chugged most of it. Then I noticed the smell and taste. For the next 3 hours I felt absolutely awful. I drank a lot of water (from a different glass), and eventually I started to feel okay.


So yes, TIFU and drank bleach water. Even Amanda Todd would have made fun of me.


edit: For all you naysayers, Yes, I realize I shouldn't freak out. But I didn't, I posted on TIFU and that's about it. And yes, something did happen, I felt sick. I didn't need emergency medical services, I didn't need my stomach pumped, but I basically huffed bleach (and swallowed some negligible amount of it). Afterwords, for about 2-3 hours, I felt nauseous and had to lay down.",TIFU and accidentally poisoned myself...,399
saladblaster,124,86,13ik9y,282,"Actually it was last Friday, but in a very drunken episode decided before going to bed to take a handful of probably 16 Motrin and the last one of my Tylenol 3's. The next day I felt groggy as hell but figured that was the worst of it. Over the past couple days my kidneys have been in severe pain. The only reason I haven't went to a doctor is I figure if I made it this far there probably isn't much more they can do for me, so why waste their time. It's not like I can puke it up anymore.

That was probably the stupidest fucking thing I could have done.

**Edit** Well, at least now I know what's up. Doctor said chances are my stomach would feel shitty for a few days (which it has) but other than that there should be no permanent harm done. He prescribed an anti-inflammatory because when I showed him where it hurt he said it definitely was inflamed but he didn't think it was because of that, he thought because I maybe slipped and jarred something in that part of my back. He said to just keep drinking a ton of water, what was ingested has likely already all been flushed out. I'm not a doctor so whatever, all I know is I hope I can get more than a couple hours of sleep tonight. At least I know my kidneys aren't going to explode.

**Edit 2** Thank you hivemind for pushing me to actually go, even if a huge portion of the response was ""you fucking moron!"" (which I don't deny). I definitely wouldn't have otherwise. ",TIFU and probably destroyed my kidneys.,368
Mellowmyjello,35,70,1as4we,283,"Let's start off with the fact that this technically happened a few weeks ago, but the best fuck ups are the late ones. So as the title implies I somehow screwed up taking a shower. I had woken up extra early to cram in some study time for upcoming midterms, so I wake up and don't REALLY wake up so I decide to take a shower. I hop in, everything's normal, apply shampoo, Some body wash- wait a minute. I look down and to my horror in my hand was a bottle of ""Extra strong"" bathroom cleaner. I stayed home the rest of the day attempting not to scratch my skin off. So remember kids, keep bathroom cleaning supplies away from your body wash!",TIFU by taking a shower,353
[deleted],39,82,188s7x,280,"First mistake is I love candy. And February to April just so happens to be my favorite candy season. Why? Mofuckin jelly beans. Best candy ever.

I tore open my first bag of the season and had a field day. Wake up a few hours later feeling miserable. It is cold as fuck in my house so I put on my fleece socks and I head to the bathroom. ""Shit! I can't shit."" So I stand up and face the toilet. It's coming.

Instinct takes over. My body rapidly throws its head downward towards toilet. ""HHHWUUUUAAAAA.."" Still coming out. I spread my legs slightly to get even lower. This is where I go full fuck up. My cozy socks slip on the tile floor. I go straight into the splits and land directly on my tailbone. Throw up comes right down with me and gets all over my body and everywhere except the toilet. Blood curdling screams were heard.

I still feel sick. And I now have to put ice in between my legs, right next to my balls.

TL;DR: **hHHWWAAUUUAAAA.OUHHH OH AHHHH MY GOD FUCK ME.. FUCK ME!!! MOTHERFUCKER SHIT!!** 
",TIFU by wearing my thermal socks while sick,362
Wheyffles,58,120,1qgy9s,282,"Okay so posting this doesn't make it any fucking better since I'm in essence telling EVEN MORE people. But at least Reddit doesn't broadcast my few posts to my immediate family and people I wish wouldn't know anything about my life.

**Context**: I had a one night stand with an old acquaintance because hey, she wanted the D and I wanted to give it to her. Simple stuff.

**How I fucked up**: During sex we were getting a bit rough towards the end and somehow I get my boner an arc-second too high up and heard and felt a ""pop"" in my shaft. Both of us had a minor case of the giggles but none the less we continued, however it turns out that I was unable to cum before both of us were ready to give up out out of pure exhaustion and satisfaction on her part.

Now I am also part of a facebook group with some gaming friends of mine because hey why the fuck not. We post silly shit to each other all the time there and basically I proceed to assume no one else has access to it. Turns out I was wrong because I am as dumb as a sack of bricks.

Not only did I post a short summary of my escapades, dick bending included, but I was not aware of it until exactly five minutes ago (so about five hours after posting it) when my dad gave the stereotypical ""You know you should watch what you post to facebook"" as I made a quick jaunt to the fridge for some juice. Sadly, he was correct.

UPDATE: Yuuuupp, EVERYONE who was online in the timespan the post was up during saw it basically. Fuck my life.",TIFU by basically telling the world I almost bent my boner during sex,402
HaydenTheFox,32,75,1fmvch,280,"Reddit, I come to you today to (gingerly) recount the events that made me realize I am one dumb motherfucker. This happened about an hour ago and I am still in immense amounts of pain because of my fuckup (like, breaking my arm doesn't even hold a candle to this).

So, after working all day (at a nursery no less - lots of heavy lifting, using your hands for hard tasks, etc) I decided to meet my friends at a local restaurant for a burger. I met them, we had dinner, got some frozen yogurt, and went back to my house so I could give them some things I made for them (I'm into ceramics). We decided to go hang out in my backyard which still bears a few mementos from my childhood. One of these is a plywood-disc style rope swing, with a single rope running through the center of it. I normally don't use it as it's too low for me, but I guess my younger sister and mother had decided to raise it up a bit. This of course caught my friend's attention (and mine in turn). We start fucking around on the swing while his girlfriend laughs at us from the hammock. At one point I'm standing up on the swing, and decide it's a good idea to start climbing the rope.

Now let me take a moment to tell you about this fucking rope. When we needed a replacement, my father contacted his brother (an arborist) to get some rope. What my uncle gave us was one of his old ""bull ropes"" (the kind of 50,000lb test rope they use to guide falling trees). These ropes are slick and have nylon fibers braided into them. Long story short, these ropes will give you blisters if you so much as look at them funny.

Back to the story. So at this point my feet are about 6 feet off the ground. I'm not struggling to hang on but I've had my fun, so I go to get back down. Well instead of slowly working my way down, or jumping off like a smart person, I decide to hand-over-hand my way down. Now, I'm a big guy. 6'3"" and 258lb kinda big, but I have a great grip. What I underestimated was just **how slippery** the rope is. Instead of maintaining a solid grip, I slide all the way back down. 

As soon as I let go, I could feel it. Rope burn. But not any ordinary rope burn - oh no, this was searing agony the likes of which I have never felt before. This was rope burn on an unprecedented scale. I'm talking jagged burned holes on the side of my fingertips, blisters on 90% of the tips. I'm-surprised-my-hands-didn't-catch-on-fire kind of rope burn. 

So here I sit listening to Zac Brown's ""Jump Right In,"" hoping the mellow music will melt the pain away. My fingers are gauzed and bandaged up and I feel like I gave Satan himself a dry handjob.

Reddit, **I am one dumb motherfucker.**",TIFU by cooking the skin off of my fingers.,355
MrFahrenheit200,85,59,10tg9l,279,"This morning, I proceeded with my normal routine. Except I did ONE thing differently. This ONE thing caused me hell for what I assume will be the rest of the day. 



I decided to wash behind my ears. 



After my girlfriend left for class, it was just me alone in the house with my cat (who is in heat). After my shower, I thought ""Damn, I really need to wash behind my ears"" so I grabbed a towel and proceeded. I thought I heard someone pulling into my driveway which 
was odd since the girlfriend just left. 



Being the inquisitive type, I decided to observe. Our bathroom does not have any windows, but the room next to it has two overlooking the driveway. Here's the problem: The door in this room ONLY opens from the outside. 



Wearing just my boxers, I entered the room and my cat tried to dart in after me. I did not feel like fighting her to get her out of the room so I slammed the door shut behind me. **WRONG. FUCKING. MOVE.** 



Immediately, I realized that I fucked up. I didn't have my cell phone, in fact it was sitting downstairs on the dining room table. 



I live in a duplex on a city street that is not particularly busy, but I was in the back of the house AND all of my neighbors seemed to be gone. 



I went as far as trying to use a DVD to open the door, didn't work at all but I was desperate. TUG. SLAM. TUG. SLAM. I tried (half-hearted) to force the door open to no avail. I realized a simple fact: It was going to have to be the window. 



The only window without a mesh screen cover hangs directly over the stairs and the thick roots of a large pecan tree. Unfortunately, there were no branches low enough to try to climb. Jumping from that window seemed like it would guarantee a broken leg or my face hitting the concrete stairs (if not both). 



I decided that was not a good path. Just outside of the window next to it, there is a metallic awning (covering the roof of the laundry room). I decided it would be wise to climb to that, but I'm too much of a pansy. The very edge of it wasn't supported by anything. I climbed back in. 



Being the genius that I am, I tried to drop my few comforting resources out of the window to break my landing when I had to drop. That consists of a blanket and a few seat covers. **Fuck.** THAT'S NOT GOING TO HELP SHIT! 



Ultimately, I gave up and ripped the window screen on the window directly over the awning. 



I wrapped myself up in a king size blanket and sat there for quite some time telling myself it would be ok. *""It's not even that high,"" ""People have jumped from higher than this,"" ""If you can jump from this, you really can do anything,"" ""Once you get down from here, the problem is over. You might have to deal with new issues, but this problem is solved"", ""better to be down there and unable to move then trapped up here naked,""* 



Eventually, I said fuck it and I jumped. It took me literally FOREVER to convince myself that it was alright. I had a strategy of land in a squat, and fall forward immediately. Guess what, guys. **you fall fucking quickly.** My squat and fall strategy didn't work at all. I was on the awning/roof, there was pain, and then there was me on the ground (with my blanket). 



Worst pain I have experienced in quite some time. I was disoriented as shit, but somehow didn't manage to hit my head at all. I crawled towards the back door over the pile of crap I tried to jump out of the window to cushion my landing. Barely stood to open the door, fall in and then run to the living room/couch. 



By that time, it was 8:41, I was supposed to be in at work at 8:00. Had I waited 20 more minutes, my boss would have come by to check on me since I am typically on time and lateness (especially without notice) is extremely out of character. 



Now I am at work. Later, I'll have to go to class. My ankles kind of hurt, but it's whatever. I'm not trapped in that fucking room anymore.


Tl;dr I locked myself in a room while I was getting ready for work. Only one way down without assistance.

Edit: DeDutchess who posted some comments lives with me.

I am done with work and class now and the impact has caught up to me. Will be going to the doctor tomorrow.

Roof/windows

http://i.imgur.com/ZLUuL.jpg

There is a dent showing where I made my jump/dive from. Not standing, more of a sit/thrust (propelled by arm strength so my feet could land more easily)

I will try better pics tomorrow and measure actual height

Edit 2: MOAR PICS! These are the views from each window (safely inside, thanks!) and one of the ground right below the awning showing why a jump seemed better than a drop

http://i.imgur.com/MT7kq.jpg
http://i.imgur.com/kAOI6.jpg
http://i.imgur.com/2YAcV.jpg
",TIFU and had to jump out of a second story window.,338
thesementaster,127,195,1ekawg,286,"I've been a virgin for so fucking long. Too long. I don't want to give numbers but, much longer than any of my friends. So naturally, when the opportunity came to have intercourse, I over thought things to a grave and dark extent.

So I was talking to this girl I've been casually flirting with for the last few months, and things were going good. She started making fun of my car, and I couldn't think because I had a raging erection and was trying to fix it by giving myself a [Canadian Belt Buckle](http://www.urbandictionary.com/define.php?term=canadian%20beltbuckle) through my pants pockets (an impossible task to say the least), so I just responded with ""Blow me."" off the top of my head. She smiled and said ""Well your birthday is coming up this weekend..."" Fuck yes. Go time. 

I got home that night and shaved the dark jungle that had developed from my tangled pubes and practically jizzed from the excitement of trimming the bush for the first time. I couldn't even hardly sleep that night, I just kept masterbating, over and over, until I was pretty sure I was shooting air out of my dick because my balls were so sucked dry.
The next day, being the internet addict that most of us are, I researched for hours the proper blowjob etiquette, and somewhere along my research, I read that pineapple can make your semen taste sweet.I thought *well I'll be damned if I don't have the sweetest cum in the western hemisphere by this weekend.* 

I drove to the store, bought 5 gallons of pineapple juice and 6 raw pineapples. I had 4 days to prepare my testicles. Over a gallon and around 1 and a half pineapples every day. Then, I had this thought. This fucking horrible thought. *What if it's not sweet, I have to know, I have to taste it.* I couldn't get the thought out of my head. I had talked myself into it after an hour. 

The next morning, I jumped in the shower with my mind set on what I was about to do. It probably took me around forty minutes to finish, because I was so disgusted with myself on what was about to go down. I turned off the shower. I had to make this quick before I can stop myself. Finish in my left hand, pumping harder than I should have with my right. Cramp up in my right quad. *Don't give up.* I shoved my left palm in my mouth and licked quickly but efficiently. **WHAT THE FUCK HAVE I JUST DONE** I vomitted all over my shower immediately. I ran out of the shower without even cleaning any of the mess up and sprinted towards the mouthwash in my medicine cabinet. I rinsed with mouthwash probably seven times. Nothing can ever get that flavor out of my memory. Let me tell you something- *It's not fucking sweet*

tl;dr- Semen is uncomfortably warm on the tongue.

",TIFU by tasting my own ManMilk [NSFW],481
[deleted],41,57,18n6kl,277,"So this happened last week but yada yada yada you know the story. 

I recently got a pocket-pussy type thing (not the actual fleshlight). It looks like [this](http://www.shopinprivate.com/real-feel-male-masturbator.html) NSFW obviously. 

I was rather drunk and decided to use it because of reasons. After I was finished I went to the bathroom as I usually do to wash it out and everything and clean myself up, as the lube is pretty sticky and I am generally a hygienic person. 

In my drunken stupor I apparently cleaned myself off, used the bathroom, and left the pocket pussy in my sink. I went off to bed and woke up to realize that I had left it in the bathroom. 

My grandma is in town and sleeping over at our house. She is never here, so it was kind of a big deal. Apparently she found it in the bathroom and cleaned it off and left it in a plastic baggie outside my door. 

IFU",TIFU by getting wasted and leaving my dirty fleshlight in the bathroom sink while my grandma was staying at our house. ,334
adwarakanath,31,39,ziq4q,280,"I had shaved just a couple of hours before. I decided to cook an Indian chickpea soup. I ran out of hot chilli powder last week and had to improvise. We have whole dried red chillies in our spice rack in our flatshare so I took a handful and crushed them by hand, finger to finger.

While walking to my room, I caught a glimpse of myself in the mirror and began to run my fingers along my smooth jaw and upper lip to admire the close shave.

And now, my face is on fucking fire. I've washed it with milk, ran a stick of butter over it, ice...everything. Doesn't fucking work. Oh holy crap.",TIFU: Shaving and chillies do NOT go together,319
Brisaster,104,41,uibar,281,"This happened about an hour ago. The setting is my grandma's house(and she has a disdain for me). I was Skyping this guy and things got a little hot and heavy. I was showing off my lady bits and he was jacking off. The house was quiet and I had assumed she had gone to bed. All of a sudden the door burst open and well, I'm shirtless. She's a very conservative woman and she didn't buy the ""I was hot"" excuse. She figured it out pretty swift but just gave me a lecture(thank the gods). She didn't see the screen though because I was moving it around(which just made her more suspicious) It's going to be a very awkward breakfast in the AM.

EDIT/UPDATE: It was indeed an awkward breakfast. She had made pancakes and she serves them to everyone but me. She looks at me and says ""Troie non si ottiene la prima colazione."" She's Italian but I've never heard her actually SPEAK it.. let alone an entire phrase. If you're wondering that translates into ""Sluts don't get breakfast."" I looked it up because I was confused, speaking none of it myself. Now, she's making roast beef later and says I can have some... I think she's trying to make a statement... Hey, at least I get to eat at all!",TIFU: Caught sex skyping by grandma...,322
anglegrinder9,59,59,18fdpe,280,"Doing a buddy read of Mockingjay (third Hunger Games) with a good friend. I keep complaining about how much it's like Catching Fire (the second Hunger Games book). My friend keeps mentioning plot details don't seem to have happened in my book yet. I keep getting angrier and more frustrated at how I must just suck at reading. Finally peel the dust cover off in a rage, a week later, and six chapters in. Turns out I am pretty bad at reading. And also bad at ordering books from Amazon. Whoever sold this to me: I hope that $8.54 was worth it, you scumbag.

http://i.imgur.com/0PYybnN.jpg?1

","TIFU by reading along with a friend with the wrong book, for over a week.",339
[deleted],90,60,117n94,279,My taco's gone spicy and it smarts :-/,"TIFU by touching Scotch Bonnet chilli seeds, then changing my sanitary protection",339
PhysicsIsMyMistress,22,41,10jsgo,277,"I was bored at work and my current task was boring. So I decided to try my kindle's text-to-voice. I put on my headphones and it played The Robots of Dawn by Isaac Asimov. Now everything was fine and dandy up until it reached the section where this woman explains how her robot sexually pleased her. In a bit of detail.

That was when the kindle decided to be an asshole and not register that my headphones were attached. Everyone nearby got to hear about the woman's first time with the robot.

....",TIFU at work because my kindle is an asshole,318
MrShartyPants,113,62,107svj,277,"So, I was scheduled to go see a client on-site today.  Before the appointment, I met a friend of mine at a local BBQ place.  Afterwards, I'm sitting in my car, about to leave when I suddenly have a seemingly normal urge to fart.

I'm now sitting in my car with a pants load of Dinty Moore beef stew.

Make me feel better by telling me stories of how you, as an adult, have accidentally shit your pants.",TIFU and trusted a fart that I shouldn't have.,339
cometpaste,69,34,w9aci,276,"Decided to make super spicy chicken wings that require habaneros, jalapenos and some thai chili peppers. So i proceeded to chop them and placed them aside while i prepared the chicken for frying. Few minutes later put the chicken in the fryer when i suddenly felt the urge to piss. So i went with some sense of urgency so i could keep an eye on the chicken. Did my business and there i was back with the chicken when i started feeling this tingly sensation on my dick which soon escalated to a burning sensation. Started panicking and ran to the shower. tried to wash with cold water helped a little but not much. Anyway numerous methods to try  and ease the burning later i found myself in the kitchen with my dick in a glass of milk.",TIFU by chopping habaneros and forgetting to wash my hands before i went piss.,310
Spearhead90,38,87,1q2mh2,274,"Its been a long night, I'm 16, on a Wednesday night, doing some chores after the lady-friend had left, and I grabbed some Kool-Aid (because I'm 5 on the inside.). I had one glass at first. Then another. Then another. Then another, and I think I got up to 13 glasses of Kool-Aid by around 7:30. So, naturally, around 8:15, I REALLY have to piss... 

My brother was in the main bathroom however, and my mother was in hers. So I had to hold it. And I waited... For what seems like an *eternity*. I eventually got to the point where I couldn't hold it any longer. So I ran to the main bathroom door, and it's one that can be unlocked from the outside, so I quickly unlock it, and I step halfway in to see my brother, bent over the toilet, Johnson in one hand, laptop on the counter, crankin' his shank. He sees me, loudly yells ""Fucker!"", tries to run and jump into the shower, only ending up in him slipping on a towel on the floor, and smashing his face on the side of the bathtub. 

I start laughing **HYSTERICALLY**. Completely oblivious to the fact that I still had to piss like a motherfucker. I'm rolling on the floor, laughing, when my bladder can't handle it anymore, and just releases.

So now, I'm writing this, after I've thrown my favorite shirt and pants into the wash, smelling like piss, while trying not to think of the image of my brother jerkin' his gherkin. And yes, he was fine, probably gonna have a nice black eye though.

TL;DR: Had to piss bad, walked in on my brother masturbating, he freaks out, trips and hits his face off the bathtub, I laugh, then piss myself. 

**Edit:** Answers to a couple questions.

1. I didn't pee outside because I live in Maine, and at night, it gets cold, cold enough that my golden stream would freeze as soon as it left my piping. 

2. I never thought of peeing in a bottle... I shoulda done that... But then this all wouldn't have unfolded as it did, and it wouldn't be as funny.

3. I am of the male gender.

4. My brother is 14. Makes it a little worse, doesn't it?","TIFU by walking in on my brother masturbating, falling, hitting his face off the bathtub, and me pissing myself.",361
A_Cave_Man,55,39,18apkg,276,"I was drinking on my lawn, when I noticed that there is more bees than usual.  I look around for a while and realize that the reason there is so darn many bees, is that there is a nest of bees right by my front door! [Exhibit A](http://i.imgur.com/tlk95QL.jpg).  Well, being right next to fourth of July, I know I must blow up their hive.  [Exhibit B](http://i.imgur.com/dpAlJMr.jpg).  I light the fuse, place the explosives as close as possible to the nest, and take off running as soon as it starts blowing up.

I'm quite pleased with my self at this point.  I check back later to make sure they have abandoned their nest... they didn't.  [Exhibit C](http://i.imgur.com/nzC1V25.jpg).  They did do a fair bit of damage as shown in [Exhibit D](http://i.imgur.com/G3OQb43.jpg).  

My next great plan was to cut the nest out, using that arm cutter thing, I cut the branch and run.  Drats, it falls down, and now it's even hard to get at.  [Picture Q](http://i.imgur.com/QaEtm8Q.jpg).  Logical next step is to knock the nest out of the tree so I can put it in a bucket and drive it out to the woods or something. This is how I end up with several golf clubs lodged into the tree. [Exhibit d](http://i.imgur.com/pRhUVdE.jpg)

Clearly these aren't working...  Back to the fireworks plan.  I carefully open the screen door window enough to place a pipe out of it.  I then seal the rest of the window with duct tape to keep teh bees out, and crab a wine cork to keep them from coming up the pipe.  I carefully lay down newspaper on teh carpet to prevent the sparks from catching the carpet on fire.  Bottle rocket 1 away... It lodges in bee hive and blows up!  FIRE 2!!! it zings down the tube, and goes right through the hole that is already there and blows up in the lawn.  

Here is where I make a grave mistake.

I go back to the stash of illicit fireworks, and grab a 10 shot roman candle!  My thinking is these will light that fuckin beehive on fire!  Shot 1 shoots down the tube, and instantly starts the hive on fire!! SUCCESS!!!  OH SHIT!!!! THE NEWSPAPER IS ON FIRE!!  

I jerk back almost forgetting to hold the roman candle to the pipe.  As I'm stomping out the newspaper, shot 2 zings down the pipe.  When I was stomping out the fire, I accidently moved the pipe, and it's no longer in the beehive.  Shot 2 bounces off beehive, falls into the bottom of the tree, and instantly starts all the dry dead needly things on fire!!!  8 shots later, and I'm now dealing with a full on tree fire in a tree connected to the house.  

I grab a bucket of water, and with the will usually only seen in Greek mythology, I sprint towards the now very angry bees and douse the tree. Bee hive goes out, but tree is still very much on fire.  I notice a car driving by staring confusedly at me.  I realize later that the fire was mostly in the middle dry part of the tree, not on the outer visible needles, and well, you can't see bees from very far away.  

I spring to the garage, and grab the hose.  I then realize the out side hose connection is broken and my only hope is to use the kitchen sink.  BAM hose is slightly too short.  So there I am lobbing water at a tree that is just starting to noticeably smoke while flailing my arms in a frantic attempt to keep the VERY angry and wet bees from attacking this most admirable foe!  [hose](http://i.imgur.com/VgFbMRx.jpg)

Finally I get the fire out, the tree looking only slightly worse for wear.  [Tree](http://i.imgur.com/whIPdGj.jpg)  At this point, my neighbor stops by to see what all the running and dancing is about.  After a very humble explanation, he lets loose a most vocal bout of laughter and walks back to his house.  He comes back with a can of bee killer, I kill the damn beasts, and inspect the house to find that the siding (TAHNK GOD) is not melted/warped.  The tree isn't so good, a few days later, the needles are falling off at a rapid rate, and I decide it's best to just dig it out and mark 1 win for nature.

Hope you all enjoyed my little life adventure!","TIFU by trying to take care of a pesky bees nest,",315
ISayStevieNicks,95,59,zfa7e,276,"I am on a medication (Zoloft) which causes fapping to take a loooong time to...complete. After much too much time, I realized I had broken the skin on my dong and, oh, the bleeding. All day I have been walking around like a 80 year old man. So painful.",TIFU by fapping too vigorously.,335
joshuad80,53,65,157pdo,276,"We tend to get a bit rough and wrestle when we're getting it on. We had just cleared the bed and I climbed up on my side and said 'come to me.'  She replied with 'no, you come to me', and I complied, but went all the way to the edge so that she wouldn't be able to get on with me. I mentioned the predicament, and she took it as a personal challenge.  She started pushing me, but I'm a fuckin rock (heh.... rock) when I want to be, and she couldn't move me. So, she decided to just climb me instead. Getting hot, right?

Well, like an avalanche, the tides turned from a nude romp in the bed to a few moments of horrifying free fall, with me coming down on top of her, right onto a TV dinner table, directly toward two knitting needles that were pointing right at her. I was too far away from the wall, and my legs were a bit stuck so I couldn't stop any of my momentum from landing with all my weight right on top of her. She screamed in pain and as soon as I could, I got up and off her, but the damage was done. 

I looked at her back, and it was already bruised, so I was convinced she had broken ribs or something. I couldn't assess how bad it was, and I was getting ready to call 911, and explain this whole situation, and have to let the EMTs in to see us, in all our nude glory, with my dying wife on the ground. 

Luckily, it wasn't all that bad. She had the breath knocked out of her, and a significant bump on her back where she struck the table, which we immediately iced. I think she'll be good and sore tomorrow, but tonight, she's ok. 

Regardless, this whole thing put an end to sexy time for tonight. :(

Tl;dr: tried to have sex and it almost killed my wife. 

edir... ediy.... edit. ",TIFU and almost killed (seriously) my wife during foreplay (NSFW story?),341
Chilaxbro,93,62,1oz8wa,270,"I have working with a certain company down here in Alabama who does electronic recycling, and they also sell products like computers, servers, switches, and a whole lot of other business equipment. They also have a small store which is set to close at the end of the year. They offer computer repair on the side, but it isn't very big and they only have someone work on computers 6 hours a week at most. I used to work at both locations, and I used to do full time computer repair for the store until they moved me to the main location, and put me in a customer service position for our eBay department. Well, I love computer repair, and they completely removed me from being able to preform computer repair at work, so I posted an ad on craigslist to repair computers on my own time after work. My boss didn't like this, and terminated me on the spot because he says it competes with our store. No warning. No suspension. Just straight up termination. I have worked with this company for about 2 years and 3 months with no write ups or really any disciplinary action, and the next day I am just completely terminated. 

TL;DR: Posted a computer repair ad because I love working on computers on my own time. Boss saw it as competition and fired me after 2 years of employment. ",TIFU by posting a computer repair ad and getting fired from my job of 2 years.,332
WeskerFare,69,93,1no4xr,272,"For some context, I was on duty, and i had the duty phone. If you're on duty, you must stay within five minutes distance. Also, you have to sign the phone off to someone 48 hours in advance if you are to pass it to someone else. Anyways, I was on duty with some co workers and i got a call from a friend that said they found a party to go to. I was immediately like, fuck i'm on duty, so I can't. A coworker of mine heard my convo and offered to hold the phone for me. (Mistake 1) I told him it was a bad idea, but then I thought about it and told myself the ever infamous saying of ""What could really go wrong?"" I left and met up with them and got to the party. I went in, and I shit you not, not 10 seconds later did i leave because of the extreme odor of weed that smacked me in the face the second I walked in. I had a friend come pick me up and realize how terrible of an idea it was, and I got back to campus and finished my rounds for the night. During my hall meeting that following week, apparently someone told my boss about it (I think I know who it was) and we had a meeting with her boss as well. I was fired and now I have to move away from the freshman area and begin compensating for all the financial benefits I was awarded. I've never felt like such a screw up to my future, my friends and my family. 

TL;DR I'm an RA, was on duty, left to go to a party, realized how dumb it was, came back, finished the night, got fired the next week cuz someone told on me. 

EDIT: Hm. I guess I type like a girl. ",By leaving duty (as an RA) and going to a house party.,365
TheHydrogenator,33,169,1n6gym,278,"My fuck up happened a couple hours ago. My great grandfather is 94, really ill and close to dying. I drove across the US to see him yesterday and all night, haven't slept since Monday night. So I'm feeling pretty fucking tired.

I'm standing in the hall outside his room in front of the nurse's desk and I tell my wife ""I feel like death"". Her jaw drops at my stupidity, and the nurses shoot me the dirtiest looks.

TL;DR drove all day and night to see a dying grandparent. Got to the hospital tired as shit and blurted out ""I feel like death"" in front of the nurses.

Edit: Cleaned up some grammar.",TIFU at the hospital,447
raunchy_malanche,16,90,1jg1sn,272,"Was supposed to get up, go for a run, meet for coffee, and go to a baseball game. I ended up getting baked, watching judges give death sentences on YouTube, essentially creating synthetic sorrow and depression until eventually I had to poop. You make a large self-realization when a tear runs down your cheek while you are holding your phone with one hand and wiping your ass with the other.",TIFU making plans for the day,362
star_gazer13,147,54,wlg4o,270,"She just brought it up, felt my face going the same colour as a beetroot. I don't even know how.. I swear I used my own memory card when my camera was broken. WHY OH WHY.",TIFU by forgetting to delete naked pictures of myself after borrowing my mothers camera...,324
Aldairion,56,51,1314ct,270,"Technically yesterday, but today is when I actually noticed the issue.

I don't like having chest hair. I really don't. I think it looks ugly and unhygenic on me, plus I'm Indian so it comes in thick and dark. I'm not barrel-chested and broad-shouldered enough to make it look good either. I've shaved it before but that's incredibly time-consuming and uncomfortable, not to mention how pricey razorblade cartridges are. 

Anyway, as I was doing some grocery shopping, I came across [Nair Shower Power](http://www.beautystat.com/site/wp-content/uploads/2011/02/Nair2.jpg). Spread the stuff on and scrub the hair off with a little sponge that comes along with it. Showering my unwanted hair off? Fantastic!

I guess I should've paid closer attention to the instructions because I just indiscriminately slathered it all over my chest. It tingled a little bit after I had finished but I thought this was just part of the process, sort of like that ""fresh"" tingly feeling you get from certain facial scrubs. 

I guess I left it in that one area for a little too long because goddamn my nipple still hurts. It doesn't look so bad, but it's always ""up"" and it feels like someone is constantly ripping duct tape from it and it's ultra sensitive to anything that it touches, be it shirts, blankets, contact from hugs, light breezes, etc. I guess I'll have to find another solution...or just learn to embrace my masculine coat. Oh well, nipple aside I feel pretty good and at least the other one is okay.

**EDIT: [Of course you guys would ask for a picture, haha](http://i.imgur.com/Vss4T.jpg). You can't really see much aside from some little scabs in the middle, however when I took it I noticed the real icing on this fuck-up cake. I got a little on my chin too. It must've rubbed off during my twisting, turning, body-scrubbing routine, and [now I have a nice little void in my beard](http://i.imgur.com/vwtY1.jpg). I think this is the real fuck-up here. Thanks for the advice guys. Apparently Nair is the source of many fuck-ups here.**",TIFU by chemically burning my left nipple. ,321
paper_weights,42,33,u2mxv,272,Consequence: Ow ow fuckity ow. ,"TIFU: I got dirt in my eye, and promptly stuck a bleach-covered finger in there to get it out.",305
MyBigDirtySecret,89,69,1q002a,269,"For those of you not familiar with the gay community, there is this app called Grindr that is used for ""dating"".

I met this kid on there who said he was 18, gave his birthday (and he was 18 and 1/2 according to that), and after talking to him for about 3 weeks, decided to meet up with him to fuck.

Now, he doesn't have a license, but in the city, that's not uncommon for most people. So I go pick him up, and since he lives like 30 min from me, I asked him where is a good place to go. He suggests a parking lot.

We get there, we're making out, he's giving me head, then I slip a condom on and I'm balls deep in his ass when 2 cops roll up. They ask for ID's (of course he doesn't have one). I give them mine. He gave them his name, address, phone number, etc, and they look up his info.

Turns out, he lied about his age on the app, lied about his birthdate when I asked him when it was, and he was only 17. I'm 24. That's outside of my states ""4 year rule"".

The cops told me that they couldn't say anything to me about what would happen, but they weren't arresting me then, and they are going to talk to the DA. Since he lied about his age, and I could prove he claimed to be 18, even gave a birthdate (though he lied about it), that the DA might decide not to press charges. But if the DA does press charges, I'm fucked... I'll know in a few days what will happen...

****EDIT****: GOOD NEWS! Cop just called. He spoke to the DA and since the kid lied, and I had done all I reasonably could to verify his age (since the kid didn't have an ID), then I had ""reasonable belief"" to believe he was over 18, and so that combined with the fact that he is 17 1/2, so very close to 18 and so even visually it's hard to tell the difference, the DA has decided not to prosecute anything. But, he did say next time, get a room and get an ID.

That being said, it's not a risk I plan to ever take again. If you are 18, give me an ID or we ain't doin' nothin'",TIFU by having sex with a minor,338
TIFURACIST,28,40,19dlrf,269,"This happened a month or so ago.


It was about 10pm and I drove up to a taco truck to get a burrito. I lined up because there was a bunch of other people also and this guy asked to wash my windshield for money. He said that he's not going to beg for money and that he's willing to work for it. I ignored him at first, but I decided that since he seemed like a nice guy, I was going to get something for him. He was wandering around the line and I called him over to me. I asked him what he wanted. He told me and I placed the order for him. 


This is the first time I've bought food for a homeless so I was kind of nervous. When his food got called out, I grabbed it, turned around hastily, handed it to him, told him to have a good night and walked to my car. He said thanks and walked away. As I was backing out of the driveway, I noticed something odd. When I handed him the food, he wasn't holding the windex spray as he was earlier. Then it hit me. I gave the food to the wrong guy. I saw him still holding the windex spray waiting for the food and he looked at me. There was nothing I could do and I was too afraid to go back. I never went back there in fear of running into him again. They were both unfortunately black which doesn't make things any better. 


TLDR; I got so nervous that I gave the food to the wrong person and I'm racist.

",TIFU Trying to give food to a homeless.,309
[deleted],177,114,18qts1,271,"Well let me start by saying I don't like going much to bars but this particular one I only go to because they make a great long island ice tea and thus I have zero interest in flirting or playing these lame ass games of ""staring and going in for the kill"" or w/e.

Anyway, as I'm finishing my second and final drink a girl comes over from a table full of I think 4-5 girls who are all looking in my direction and here goes the conversation (I start getting a bad feeling already now):-

Her: Hey there

Me: Hi

Her: So you alone or waiting for someone

Me: Yeah, just about to finish and head home

Her: Isn't that sad sitting here alone drinking like that? 

Me: Not really, I love the long island here... not really here for all that.

Her: How about you change that by buying me a drink and we go from there to my apartment.

*(Now I'm getting a bit annoyed and starting to feel irritated because she isn't going and not to mention I don't do ONS. Not to mention getting stared at by a bunch of girls is disconcerting. So I get to the point... and troll my way out)*

Me: Okay here's the thing. If you're age is on the clock, you're too young for the cock. 

*she looks at me weirdly* 

Her:..... the fuck? I'm 22 asshole, not some kid.

Me: I meant the 24 hour clock. 

*and point to my digital watch with as straight a face as possible while laughing in my mind.*

But then I see a blur in the corner of my eye and I end up on the table by getting smacked on the face hard by that girl and I hear laughs from her table while she returns back there.

I laugh it off a bit, finish my drink and my bartender says to me: ""Duuuuuude....."" and I'm like ""Shut up or I won't tip you"" after which he just laughs and I pay him and head home.


**TL;DR:** Girl tries to flirt, I'm in no mood. Turn her down, get slapped.


**Edit:**

Seems you guys are making me turn out to be the bad guy but just so you all know the girl was clearly putting on a show for her fellow friends and trying to wave her ""alpha bitch"" status. You know the one... the girl who thinks her beauty can get her everything. Her failing in front of her friends was clearly making her more annoying and desperate so I paid in kind to put a stop to it. 

My only failing was to have bailed out as soon as I said that and avoided that slap from her.",TIFU at the bar by not flirting back and getting slapped for it,385
throwaway6421511,122,64,xzaka,270,"So, today my Aunt Jen took my brother Trey, my grandmom, and I to the beach for the day. I had an English Muffin for breakfast, and it made my stomach upset. I tried to go to the bathroom before we left, but it just wasn't working. The beach is probably about an hour away, so I figured if I had to go, I would be able to make it. WRONG. I was wearing my favorite white bikini in the car when my stomach started to feel upset. It went away after a few minutes, so I thought I would be alright. WRONG, WRONG, WRONG. It came back about 15 minutes later. **I needed to take a dump NOW.** I told my aunt, and she tried to get to an exit. After a few minutes, I couldn't hold it. **I pooped my pants.** When I told my aunt, she tried to find the nearest bathroom. We eventually found a Burger King, and my grandmom took me into the bathroom so I could clean myself up. Luckily, my grandmom brought paper towels to the beach, so she was wetting them for me in the sink and passing them to me under the door. I wasn't thinking straight, for I put the paper towels into the toilet. **When I tried to flush, it wasn't going down. I then had to reach into this public toilet inside of Burger King with my bare hands to take out the paper towels and put them into the trash can that was also in the stall** (Now, why didn't I simply think of this trash can? Because today, life decided to troll me). After I was walking out of the stall, **my grandmom saw a couple spots of poop that fell on the ground** when I was taking my pants off. I then had to wipe up the Burger King bathroom floor because I dropped my poop on it. After we left Burger King, we had to find a shop near the boardwalk that sold bathing suits. We found a white bikini bottom that didn't exactly match my top, but it would do. We get to the counter, and **JUST the bottoms costed $50** (They call that price a sale). My aunt ends up buying it for me, even at the ridiculous price. We get to the beach house my other family was staying at, and I run to the bathroom to change. I then went outside to put on a lot of sunscreen, just so nobody would notice I probably smelled like shit. My bathing suit bottoms were ruined because they were white (and are now in the trashcan of a Burger King bathroom, along with a favorite pair of  shorts). Luckily, I brought a change of clothes so that when we were leaving, I would be alright. Life decided to troll me again, **I FORGOT UNDERWEAR** . My aunt, coming to my rescue again, gave me her pair of underwear. I was glad for this until I realized.. **My aunt gave me a blue thong with black lace** . Talk about AWKWARD. I had never worn a thong because I thought they would be uncomfortable, and I was fucking right. **Imagine sitting in a car with something constantly up your butt crack.** Not cool. When I finally get home, I go to the bathroom, take off the thong, throw it away, and take a nice, long shower. I still haven't told my mom what happened.

**TL;DR** *Shit my pants on car ride to the beach, Stopped up a Burger King bathroom causing me to have to reach into the toilet and remove the paper towels, Cost my aunt $50 for a new bikini bottom, and Had to wear an uncomfortable thong riding up my ass the whole ride home.*

**EDIT:** fixed a grammar error.","TIFU by Shitting My Pants in Car, Stopping up Burger King Toilet, Dropping Poop on the Floor, and Costing my Aunt $50",334
meiswhoiam,38,64,x3hqv,269,"So I was helping cut, chop, and split wood at my grandpa's house today and he likes to supervise, since he can't really do anything any more.  So I was throwing wood onto the trailer after it was cut, my cousin was there helping, and one piece was a tad lighter than the others. This piece made a jump over that trailer like you'd see in an action movie, in slowmo, with epic music in the background.  It went all the way over, and landed right on my old grandfather's foot.  Though this seems really bad, these were his exact words, ""Meh, I've had worse in the war."", this was said while he was doubled over in pain. All in all, it was fine, but I felt fucking terrible.

Tl;dr  Bad-ass Grandpa took a hit like a boss.",TIFU by hitting my grandfather with a log...,333
tzivje,35,41,1iz7r1,268,"I'm helping my Mom move out of her house. There was an air conditioner window unit in her office on the second floor, looking out over the driveway. I am the muscle in the family, so I offered to take the a/c downstairs. Well, the window wouldn't open, so I pried at it for several, minutes before it flew open. The big, anvil-weight a/c unit luckily didn't fall forward and smash my feet. It fell the opposite direction, and was caught, fully intact, by my sister's not so intact car roof.
It seems she will be taking the bus for the next few weeks.",TIFU by dropping the window a/c unit on top of my sister's car,309
thezamboniguy,38,38,136o1z,268,"For all those unaware of what Tim Hortons is, its the equivalent of a country wide crack dealer (that serves coffee in Canada) 

So this morning I go get myself a coffee, come home and sit down to browse some reddit. Now over the last week or so I have had a pretty brutal chest cold. Yesterday I had left my Tim Hortons cup on my desk which had a very little bit of coffee left. After hacking up some green phlegm I spit it in to the coffee cup and forgot about. Well guess who just grabbed the wrong cup and took a nice big swig of cold coffee and phlegm? It hit the back of my throat and stuck there for a minute...that is until I puked it all up on the floor. 

I know it isn't the best TIFU but seriously this shit just ruined my day.",TIFU by grabbing the wrong Tim Hortons cup,306
balance13,104,50,ws3a0,269,"While having sex with my girlfriend, I was on top, I was pulling out to finish and my girlfriend was coming towards me to kiss me. My one hand slipped and my head fell forward, resulting in my forhead smashing into her nose... so much blood everywhere... and a broken nose.

TL;DR I headbutted girlfriends nose While having sex and broke it.",TIFU by headbutting my girlfriend during sex,319
laz303,45,54,11bond,271,"The cats brought fleas into the house, so everybody has been itching for a little while...   Finally got a day when the wife and kids were going to be out of the house for a few hours so I could use the flea bombs we got..  set them off on the 1st and 2nd floor and am in the process of taping the door to the basement where my office space is when it hits me.. 

Where are the Cats?

RIP the tape off the door, start opening ALL the windows and turn on the huge attic fan to flush out the air inside..  Fortunately one cat was outside already, but the other who NEVER goes outside took some coaxing out from under a bed.  Get her into the basement with me, quick trip to the pet store for more bombs and off we go..",TIFU by trying to kill our pets..,325
[deleted],152,69,1cui7j,266,"She was berating him in front of other people, and I politely told her, ""Don't talk to him like that."" Shouldn't have done it because it's not like it changed her view or made her apologetic, and it resulted in an angry woman screaming in my face how much of a disrespectful bitch I am for an hour and throwing things around my boyfriend's room.

It wasn't thought-out at all, just a reaction to hearing someone talk to him like that. Bad fucking idea.

Lesson learned.",TIFU by defending my boyfriend against his mother.,335
tifu_broken_bones,99,36,14j24z,267,"I'm an orthopedic surgeon. I have a female roommate, and she's not good with gore. Sometimes I tease her by telling her horror stories from work. Sometimes she drops by work and we'll get coffee, lunch, or dinner. We had had plans for her to drop by work and to get dinner before heading home. She showed up 20 minutes early.

A teenager came in whose hand was at a 90 degree angle from his arm. Usually she waits for me in the waiting room. But someone had directed her over to me... and she was horrified. I tried to cover it up as quick as I could and told the nurse to get her out. I asked for someone to go check on her and get her a cup of tea. After I was finished with the kid and off the clock I headed out to see her. She was white as a sheet and in shock. I talked to her for a little bit, and with my help she stood up and we started walking toward the exit. She was a little uneasy so I had my arm around her waist supporting her. As we were leaving, one of the nurses said, ""Goodbye, Dr. _____, and it was nice meeting your girlfriend."" I responded with ""Oh, she's not my girlfriend, she's my wife.""

It was an honest slip of the tongue, but it was awkward. When we got home it was still awkward, and I'm not known for handling awkward situations well. She was trying to make it less awkward by making a green card joke- she's originally from Sweden. I tried to bounce off of it by making a ""Let's go and get married!"" joke. It didn't land as well as I thought it would, and she was awkward giggling, so I tried to make it less awkward. I did that by getting down on one knee and proposing to her. Like a ""Full Name, will you marry me?""  I don't know why. My mind just rushes and I do stupid things. She gave me a weird look, then laughed, said ""Yeah right, I hope you love disappointment"" and went up to bed. Honestly, I have no idea what she meant by that.

Yeah, I think I'm just going to ignore it until it goes away.","TIFU by accidentally calling my roommate my wife, then accidentally proposing",303
[deleted],66,91,17c2zk,260,"My boyfriend's mother's phone went off after receiving a text message today on our way to drop off my boyfriend at his Saturday college class. Due to the fact that she was driving, she asked me to unlock her phone and see who it was as well as what the message said. Upon unlocking her phone I noticed her browser was still up and that it was refreshing the page she had opened before locking her phone. What did it refresh, you ask? Well, it refreshed an image of her bound and gagged laying flat on her stomach, buck-ass naked. Apparently she forgot to close her ""FetLife"" acct after checking a comment on the picture or whatever... IDFK. 

Suddenly, this moment has become the most awkward thing I've ever experienced. Instead of letting her know I saw the picture, I quickly closed the browser and read her the text message she had received as if nothing had happened. 

I hope to fucking God my boyfriend, who was sitting behind her at the time, didn't see the picture. 

edit : How did I fuck up? I fucked up by doing a nice thing. Normally, I stay away from lookin' at anyone's phone after what I saw on a friend of mine's phone... I should have just told her to wait to check it herself at a red light or something. but nope. ",TIFU by checking a text for my boyfriend's mother,351
Epicus2011,28,57,1mo8bf,263,"I seriously kinda fucked up today, even tough it was freaking hilarious.

So my friend is taking a graphic design class which he absolutely hates and asked me to create a banner for him. He jokingly said, ""Do anything you want with it, even midget porn. Just make sure it looks good"". I was bored that day and kinda good at graphic design, so that's what I did. However, I really didn't really take it seriously and tried to recreate the world's worst banner in Photoshop and all of that in less than 3 minutes.

I succeeded, and sent him the link to the picture. However, I didn't tell him that it was a joke. As it turns out, he didn't even look at the banner and just immediately saved the link. So today in class he was asked to present his creation and my beautiful piece of work with midget porn, Comic Sans, and rainbow colors was presented to his 42-year old graphic design teacher and the rest of the class.

Yep, he's pissed.

The banner in question: http://i.imgur.com/kKPQ0iX.png [NSWF-ish]

**TL;DR:** Made a banner for my friend picturing midget porn and Comic Sans, only to find out he didn't look at it and presented it in class",TIFU by making my friend show midget porn in his class [NSFW],320
QueefingCreampie,55,99,1hb0sw,262,"Okay, new boyfriend, everything is wonderful, I'm at his parent's house with him in the games room and things are getting steamy. The games room is at the back of the house and his parents are in the front room watching TV.  
Being the young risk takers we are, we start going at it doggy-style on the floor. Having requested for him not to fap for a few days to make his orgasm really powerful, he gets into it pretty intensely and in the heat of the moment gives me my first creampie.  
He cums buckets in me, pulls out and puts everything away just in case we get walked in on. I lean back, pull my pants up, sit down and begin to do the largest, longest queef I have ever heard. It sounds like a diarrhoea fart of the worst kind and last about 30 seconds. There's no way his parents can't hear it. The fluid is sputtering out of my cavity like a waterfall accompanied by all the air that'd been pounded in there from the shenanigans. He's laughing, I'm laughing, which is only making me queef more, and all the while his load is spilling out of me through my underwear *and* trousers. I get up from the event, still sputtering, and he points out a huge wet stripe down the back of my trousers.

Needless to say the walk of shame up the stairs to the bathroom was not an easy one. 

TL;DR: Got creampied by my OH, soggy queef of the year follows, parents only a few metres away.",TIFU By queefing out my first creampie through my trousers.,361
IManageTacoBell,72,23,u1esk,260,"I work in the media industry.

Had been with the company for 3+ years when I sent along a thread to our customer where we were complaining about them.  Had a great salary, excellent benefits and a career on the rise.  Had no major incidents during my time there and never had less than an above average review.

The customer was very important to us, and someone's head had to roll.  Now I'm out of a job.  I fucked up.

**UPDATE**
After spending the summer off, I found a better job with another software company.  Bigger salary, better opportunity and less travel.  I am happy to finally bury this in the past, but I thought I'd update TIFU with the good news. I'll be more careful this time....","TIFU: emailed an important company client a thread where four co workers and myself mocked their team members on our project, got fired.",283
D14BL0,13,46,1g3vgo,261,"This was actually last night, but I just now realized I should share.

I normally only shave when my facial hair gets so long that I start to get beard in my food. I'd try to style it somehow, but it's unruly and grows in sorta patchy, despite growing in a decent length. 

Whenever I do shave, I always make it a habit to jokingly give myself a Hitler mustache. Because, y'know. Sometimes I wanna know what I'd look like as the tyrant of the early 1940's. Also, when I shave, I use disposable razors. Shaving is a rare occurrence for me (once every few months or so), so I don't spend a lot on expensive razors. Usually the cheapest tri-blade throw-away works for me.

I was on my last razor.

So I shaved everything but the Hitler 'stache, and went about to fixing up the rest of my face. I got most of it, save for a few patches that needed cleaning up. This is when I noticed that the blades were getting really dull. So dull that they were no longer cutting at all (hence the patches). Oh well, I'll just go into the medicine cabinet and get another razor.

BUT HARK! There are no more razors! This was the last one. And it's too dull to shave with at all. And here I am, with a patch of hair on the left side of my jaw, and a quite obvious Hitler mustache.

I need to fix this. I have work in the morning. But I have nothing to fix this with. I can NOT go to work like this. 

I decide that the best option, at this point, is to go to the gas station and pick up a cheap pack of razors. I can't just leave it like this. But this means that I definitely have to go into public and be seen like this.

So as I'm walking to the gas station, I'm hoping to all that is holy that the sweet, old Jewish lady who usually works nights isn't there. Oh, fucking please don't let it be her. She's so sweet, and old enough that she probably knows people who were in the Holocaust. 

I get there, and luckily, it's not the old Jewish lady. Instead, it's a big black dude who always has a really loud, booming voice and is rather intimidating sometimes. I walk in, and he immediately sees me and my 'stache. I expect him to go into some rant about my racist ass walking into his store worshiping Hitler or something. Instead, he just busts up laughing immediately.

I pick up a four-pack of razors, and get a Nazi salute as I head out the door, and ran home to shave off the last little bit of hair from my lip.

It was a rough night.",TIFU by giving myself a Hitler mustache,307
DreamOfTheArcher,163,53,14bxvc,266,"As stated Today I fucked up by agreeing to help my Dad upload his pictures from his old phone onto the family PC, somehow either by fault of my own or him not deleting his cookies from his mobile browser every saved or stocked image view on his phone was also uploaded. I don't think there is enough liquor and therapy in the world to undo what has been done to me and I will never view my very christian and conservative father in the same light ever again. Today I really fucked up...",TIFU: Today I agreed to upload the pictures from my father's old phone to the family PC and discovered he's into sicker porn than I am... ,319
coolestguy1234,117,59,yupbe,265,"This actually happened about 2 weeks ago, but the story finally came to an end yesterday.  I was staying at my friends house for a month and I plugged in a set of her speakers and the tip got stuck in my headphone jack.  The only way I could find a way to extract the piece of using super glue on a tip of a toothpick.  The jack tip was now super glued in my mac book.  

Few days go by, I'm drunk, I decided to shove a pick inside the headphone jack to try and break the jack off the motherboard.  Now the motherboard is shorted out, my mac doesn't work, apple won't touch it at all, it will most likely cost me 1100+ to fix the 2300 mac book.  

I was finally in a position where I was receiving alot of money that I was going to save and now I have to by a new mac book because I am a retard.  ",TIFU by using super glue in attempt to pull out a broken headphone tip from my macbook headphone jack and continued fucking up by totally breaking my macbook and ruining the warranty.,324
preesisters,20,51,1g5v2g,263,Source: I work at a UPS store. They were both in express packages and I accidentally swapped the labels before affixing them.,TIFU by next day mailing a birthday card to a lawyer on the other side of the country and legal documents to a little girl who just turned 8.,314
Forrest__Dump,20,38,1flpk4,260,"(Throwaway in an attempt to preserve the last scraps of my dignity.) This happened to me last last week, but I still think it ought to be shared. Me and some old college buddies go on a camping trip every Memorial day weekend to catch up with one another. On this particular trip, I got the bright idea to take an hour-long hike during our first day. Everyone seemed game for it, so we ate a big lunch and set off. 

We were about three quarters of the way down the trail, when I realized it was time to drop a butt-nugget. I nonchalantly excused myself from the group, walked about 10 feet away, dropped my trousers, and squatted down. On a wasp nest.

I won't describe in detail the events that took place next, but my ass and balls got covered in stings, and my friends saw me hopping around with my pants around my ankles, screaming like a girl. Then we had to hike all the way back to the campsite. Within several hours, my privates had swollen sickeningly and I was thus forced to pack up my camping gear and admit myself to an emergency room. 

It's been a week, and I still cannot sit down without extreme pain. And the itchiness is unbearable. I'm fairly certain that I will never live this down in my entire life.",TIFU by shitting in the wilderness.,298
olithraz,71,48,13m1jy,258,"I was cleaning the toilet and filled the bowl with a bleach based cleaner and let it sit. Then I sprayed the rim and seats with an ammonia based cleaner. 

As I was wiping it down, my nose felt like it suddenly caught fire and I could barely breathe. At that point I realized my mistake and left the bathroom. 4 hours later, I can almost smell again. 


Unfortunately, there were no crystals afterwards. :(",TIFU: mixed bleach and ammonia ,306
BlimeyChaps,40,79,13l02a,257,"Today I went on a university visit with a program that my Sixth Form put me on (I'm seventeen) to try out how I'd find doing English Literature as a course in University. Anyhow, after a lecture on Young Goodman Brown by Nathaniel Hawthorne we were to attend a seminar to discuss what we've read, as a way of demonstrating what English Lit students get up to. Anyhow, after the seminar the girl sitting on my right asked if I enjoyed the seminar, and we sort of just started talking. We were just telling jokes and discussing the story. It was time to leave the class where we had our seminar and she got up and started walking towards the door, which I was holding open for her (I am a gentleman of course). She was sort of dragging one of her legs on the floor. Jokingly, of course, I asked why she's walking like a zombie while smiling and being my god damn charming as fuck self. She just looked at me, let out an awkward laugh and said ""Oh, I just have a disorder with my leg"". I just froze and the smile was wiped off of my face, I immediately went ""Oh my fucking god, I'm so sorry about that, I was just joking, I didn't mean-"" then she was just like ""It's fine"", but not that bitchy kind of ""It's fine"" that girls say when things clearly aren't fine. 

She accepted my apology and realised it was a joke though, so it was all okay.

TL,DR; Asked a disabled girl why she walks like a zombie.",TIFU and asked a girl with a disorder why she walks like a zombie.,336
Anotherfuckwit,31,46,zjqei,259,"So I'm out with my mates having a drink at a bar after footie (soccer) training. On the screen the team I support in a european qualification match. I go to the bar as its my round and another friend comes to help carry drinks. whilst we are there he sees a girl he knew and they get chatting. I'm in one of those state of mind places where I'm vaguely aware of their conversation and being polite by smiling and pretending to be following but predominantly focussed on the TV screen behind.

My team Score a goal in the final minute and I jump up and shout ""YEAH!! GET IN THERE!!"" just before my latent brain picks up on the last words the girl said to my friend ""... buried my mum today.""

It might have been ok if I'd carried on cheering as I would clearly have not been listening but because I did hear, albeit registering a fraction of a second later, I then proceeded to say ""Oh, I'm really sorry to hear that..."" before thinking 'shit get out of this.' and leaving her stood at the bar with my mate staring at me aghast.

My mate eventually return and tells the group what a fuckwit I've been. In typical English bloke style they all start giggling and thinking it's funny. I just keep getting glared at from the crowd on the other side of the room. I knew I'd come across as a dick but I couldn't stop myself from giggling along with them.",TIFU: by watching soccer in a bar.,305
mmm_leftboob,65,43,vyduc,263,"In the 33 years since I stopped wearing diapers, I have experienced this feeling 4 times.  It's a sudden but moderate pain in the intestinal area accompanied by the distinctive gurgling of loose matter through the *demesnes that there adjacent lie*.   This is a warning from that body that says: ""(1) If you're in or near a building you have access to, get to the bathroom now!  (2) If you're not...you will soon own one less pair of underwear.""   I was not.


I was .8 miles away from my apartment, taking two very big dogs on an extended neighborhood walk in the early evening.  (I know the milage because I'm trying to lose weight and keeping track of my exercise with a GPS app.)  This was a thickly settled neighborhood, so popping into the woods was not an option; there weren't any.   Also, one of the dogs with me lunges at children on sight, and the other hates unknown dogs, so I wasn't about to go knocking on doors to ask for a bathroom.  The only option I saw was to head straight home, hope for the best, and accept whatever fate may stream down my leg and soak into my white fucking gym sock.


Well, I live in an apartment complex where everyone has their own entrance, and the dozen buildings therein contain 24 units each, all laid out in a horseshoe shape.  Of course, my door is right in the middle of the furthest part of the horseshoe, and the majority of my multitude of neighbors have just gotten home from work and were now walking their dog, checking their mail, or maybe just patrolling the area to see if any of their fellow urban professionals were trying to slink by with a steaming load in their pants.    


I lost the battle of clenched butt-cheeks about 110 feet before I got to the entrance of the horseshoe, at which time about 1 to 2 ounces of hot liquid evil infiltrated my vastly inadequate boxer briefs, and began to slowly splat out the right leg of my shorts.   ""It's mud"" I thought, ""if anyone sees it at all, they'll think it's mud!""   I ran in to six individuals who asked me how my day was, and passed many others as I walked the desperate length of the horseshoe.  ""Just great! Thanks!"", I'd announce, hoping not to interest anyone enough to make them turn and look at the rear side of me.  I don't know how many did, nor do I know if enough ""mud"" splashed out to effectively mark a trail to my door.   Either way, I'm never going outside again.


TL;DNR Fat guy eats fatty foods and shits himself outdoors, does a 1/2 mile waddle of shame back home; everyone sees.",TIFU and walked more than 100 yards away from my home.  So I shat myself. ,306
iCerulean,56,80,1q62ml,258,"My SO's brother and I are good friends and we like to call each other, ""yo bitch"", ""Mah nigga"", and so on. We are not black, but we are not racist in any degree whatsoever. We all go to a school with few white people and we just kind of picked up on the words of others. No one really cared or minded.

Anyway, I was over at my SO's house and I thought I heard Jonathan, his brother, coming upstairs. So in our usual greeting I say, ""Sup, nigga? Comin' to join us upstairs?"" And I looked over at him. Only it wasn't him. It was his mother.

And she was pissed.

Adding the fact I'm spooning my boyfriend, her son, on the couch, didn't make things any better as she is a very conservative woman who doesn't like any displays of affection. 

She started yelling at me so my boyfriend ended up taking me home and staying with me for dinner and a movie. Needless to say I try to go over only when she isn't home now.

Jonathan thought it was the funniest shit ever and he will never let me live it down.","TIFU by accidentally telling my SO's mother, ""Sup, nigga?""",338
I_Am_TheEggman,89,89,xaauz,256,"I was a party tonight and started hooking up with a girl who had too much to drink. Before proceeding further I made sure she was okay and offered her water/something to eat. She said she was time and sexy time commenced- neither of us had a condom so she started going down on me. After a couple of wonderful minutes she began projectile vommiting all over the place- including on my shorts and ""the family jewels."" Having throw up on your member is not a very pleasant experience. She ended up okay though but TIFU",TIFU by getting a blow job from a drunk girl,345
ProBread,40,129,1lnogb,262,"Ok so just got out of class. For the past few classes this 8/10 has sat across the lecture hall from me. I was reading a post on r/4chan, link below, when all of a sudden I realized she sat next to me today. I’m reading this post about anon fucking up with a girl when she comments about him playing pokemon. Out of no where the girl said, “ah i love 4chan” Did not know how to react and kept reading only to burst out laughing at the post but she thought it was at her, told me if i didn’t want her to sit next to me i could have said so and walked to the other side of the class. 

In the end I know this isn’t crazy but I feel like such a dumbass.


r/4chan post: http://i.imgur.com/o3HE8ZK.png

TL;DR Hot girl approached, didn’t know if real life, just read exact scenario on 4chan and ended up pretty much reenacting it 


**UPDATE** Got to class, sat down a bit nervously but much to my surprise a second later she sat next to me again. After a bit of silence, we start talking about 4chan, random class happenings, and the campus of which I took as the opportunity to apologize for the last class and ask if I could buy her coffee to make up for it. Plus I added in so that we could talk more since I couldnt stay around after class. With out hesitation she said yes. Was actually caught off guard, in a good way this time, by how smoothly it went. Thankyou MarbledNightmare, BearBak, shdfkhskfefe, and everyone else for the advice! ",TIFU with a girl by turning 4chan into real life,391
IAMTHEBATMAN123,52,48,11lbl4,259,"So...I'm on the train and it's waiting at the station for a bit  longer than usual. The driver comes on the intercom and says the train ahead of us is disabled, but we should be up and running in about five minutes. I decide to throw my Pepsi can in the trash can on the platform. I thought I would be safe to leave my bag in my seat, since I thought it would take like thirty seconds. Well, no sooner had the can hit the bottom of the trash, the train closed its doors and drove off. With my bag on it. With my cellphone in it. I really fucked up, huh?



-UPDATE- I've cancelled my Apple  account. I also have bought a Galaxy S III. It is better than the iPhone 4. -END OF UPDATE- ",TIFU.... By not wanting to litter. ,307
MissRippit,192,41,uvyos,259,"I feel so awful. I also realise that for gamers, this is a floggable offence and I was hoping you lovely peeps on Reddit may have an idea as to how I could make it up to him in any small way. The problem is there isn't really the infrastructure in a modern city for a full on flogging, and I'm not going to volunteer to be hung, drawn and quartered. Any other suggestions?",TIFU and accidentally deleted my friend's Skyrim character (he was level 54),300
Menziesii,38,43,1llcy7,252,"Last night was very muggy, and sleeping on the top floor of my house, my room was a sauna. So I figured it would help to open the window and sleep in the nude. Well this morning I wake up and things are sore and ichy around my nether regions. I look down and one labia is easily twice the size of the other and itches like a mother.

 Now I've had problems with bug bites in my room before, even waking up to five on one hand (my window has a shoddy screen for what it's worth) but never have bugs been so eager to bite a chunk out of me that they crawl under my comforter. 

Now I'm looking forward to an eight hour day of retail work, subtly scratching myself every thirty seconds. 

TLDR: A bug went down on me last night.",TIFU by sleeping naked,295
armersuender,32,81,12qqu5,254,Yup and woke up three hours late. Hopefully nothing eventful happened in class. : \,TIFU and texted myself the time to wake up instead of actually setting my alarm.,335
Rufus2468,25,50,1jrzgo,253,"Picked my nose today.

Perforated cartilage.

Bleeding profusely.",TIFU in the form of a haiku.,303
[deleted],68,42,16dwx3,257,"Sorry for the length but bear with me.... New Year’s Eve, I was at a friend’s house and I mentioned how my bowels were all messed up and I hadn’t taken a shit in about a week. I’ve read the TIFU about the dude that couldn’t shit and ended up in the hospital so I knew it was beginning to be no joking matter. I was bloated, uncomfortable, and miserable. So my friend gave me these daily fiber suplement capsules she takes every night so that she shits in the morning (she’s a teacher so she has to have “scheduled” shits.) Took 3 of those bad boys and woke up New Year’s Day with a monumental shit. Felt amazing. Kind of sucked that I blew up my friend’s bathroom and I couldn’t find the fan switch, a candle, or spray… but at least she was aware of the issue- I even got a high five when I went downstairs. 

Fast forward a week. I was at the grocery store and thought “Wow, I haven’t really shit since that day my friend gave me magical fiber capsules of glee, maybe I should buy some of those!” Because I was pretty embarrassed by being in that section of the store, I grabbed the first fiber thing I saw, buried it under a bag of frozen corn and hurried to the self-check-out.  I put them in the medicine cabinet and forgot about them. I took a pretty stellar crap that weekend after a serious bender at a company drinking event so I didn’t really need them until last night when I felt the nasty bloated feeling again. Light bulb! Fiber capsules! Took 3-4 and went to bed around 10. Woke up at 3am with the worst churning, gurgling feeling I’ve felt since the day I accidentally shat myself on the commuter train (that’s a story for another time…) So I rush to the bathroom, sit down and explode in the toilet. Watery yucky crampy shiss came out of my ass in a constant stream. Farts included. And of course, the farts are amplified by the bowl so my poor roommate was probably woken up by my Hindenburg shit.  

On three separate occasions between 330-5am, I thought I was done so I would wipe, wash and try to go back to bed only to feel like horrible cramps and imminent danger all over again- causing me to bolt out of my bedroom while pulling down my pants, fearing for my life that I was about to soil myself. At one point, I actually fell asleep on the toilet. Finally woke up on the can around 6-630am, wiped my butt, wiped my brow and headed back to bed hoping for the best. But before getting back under the sheets, I decided to check out these fiber capsules that were creating such a fuss. I read the label “Fiber Laxatives. Take 1 tablet by mouth to encourage bowel movements to relieve constipation. Do NOT exceed 2 capsules per 24 hours!” WELL SHIT, SON! These are NOT the daily fiber capsules that my friend shared with me! And I took THREE!!!

TL;DR – I took too many laxatives and nearly shit out my esophagus last night. 

Update: Just ate an apple at lunch and the process was nearly repeated. After WTFing my body, [I found this] (http://www.mayoclinic.com/health/high-fiber-foods/NU00582) Check out the fiber content of a freaking apple! (facepalm)

Update 2: [Just wrote my train shitting dilemma here] (http://www.reddit.com/r/tifu/comments/16el14/tifu_by_not_using_the_facilities_before_work/) You're welcome.",TIFU By buying the wrong fiber,299
beenhard33,66,31,uwp46,254,"At work today, while filling up a machine, I unknowingly let a substantial amount of diesel find its way into my jug of water. It's one of those rubbermaid gallon jugs and was only about a quarter full when the overflow from our skid-steer must have found its way down the drinking stem thing. Anyways, about a sweaty hour later I was super thirsty and took a few giant gulps before the taste hit me. So seeing as the price of diesel is super high right now, I'd be willing to pee in someones gas tank for $3.00 OBO ",TIFU and drank diesel fuel ,285
Jimbosilky,61,67,t582j,254,Revision? Ha.,TIFU: I started a new Pokemon game a week before my exams.,321
ScottyFalcon,137,144,1jcbxb,250,"Fuck, I did not intend for this to happen the way it did.

I just moved to a new city and my best friend has been awesome, welcomed me in to his home to rent from him when my previous domicile was made unavailable due to my other friend moving. He's supported me through a shit tonne of stuff since meeting me 3 months ago, been an all around GGG.

I am the asshole in this situation for sure, he's been interested in this girl for awhile, but hasn't made a move, prefering to go the friends route with her. Or at least I thought that was up, we've talked multiple times about how he was ""content"" with being just friends, leading me to believe that he was moving on, she obviously wasn't interested in being more than friends.

Her and I hung out for a few hours last night watching the meteor shower just the two of us. I'd been intending to have it be just as friends, she is an amazing girl, talented, funny, the whole nine yards. I just wanted to get to know her better, as friends. Sure I was interested in her, but she was off the table for anything further because, you know, the bro code. As it got colder we started getting closer, until eventually we were snuggling under the blankets, it didn't really hit us until he called asking where I was it was so natural.

Her and I aren't going to date yet, we are going to get to know each other better first, then reevaulate things in the fall, when we are both going to be living on res at the same school. 

Man o man is he pissed. Rightfully so, to the point where he made it clear that he won't hang out with the two of us in the same room. Which means I need to find a new group of friends, he thought it was going to be him not chilling with us, but there is no way in hell I am going to steal his friends too, I'll just have to find a different group of friends.

Fuck, just as I was getting comfortable in the church community too.

I fucked up guys, big time.",TIFU by going on a date with a girl my best friend was interested in.,394
NoAttentionAtWrk,128,68,xilrs,251,"So I met her for coffee at starbucks and it was fun getting to know her. The coffee kept on coming and we ended up staying there for like 6 hours

Turns out, she is a Redditor too. I told her about the post and all the input you guys had for me. She was pretty cool about it. She wasn't on this sub-reddit...she is now. Oh and she promises to make a comment on this Update thread (without revealing her identity of course)

Did we hook up? well... a [gentleman never tells](http://i.imgur.com/m2KXu.jpg) ;)

Original Post : [TIFU by getting my boss to believe that me and his wife are cheating on him because I had not deleted old contacts from my phone since college](http://www.reddit.com/r/tifu/comments/xeem4/tifu_by_getting_my_boss_to_believe_that_me_and/)",TIFUpdate : Coffee with my ex-hot teacher who is my (ex)Boss's ex-wife,319
tango-romeo,62,82,x88pq,252,"So, I was volunteering with Habitat for Humanity to build a house. I'm pretty ""green"" and enjoy volunteering because I not only get to learn new things, but helping out just feels good. 

Here was my mission: use the nailgun and nail in the baseboards into the cabinets. Me being the FNG I am, used it wrong and ended up shooting a nail up through my [thumb](http://imgur.com/FEl5I)! (That's about how it was positioned inside of it. Sorry lots of bulky bandages). 

So one trip to the hospital later and I'm all bandaged up and doing great! Doctor asked if I was posting it on Youtube. I said ""nope-Reddit!"". My only concern is that I can't unwind with a nice cold brew tonight with my medication.

So what do you think Reddit? Two thumbs way up? Did I nail it? That's enough puns for me.

**TLDR** I volunteered and shot a nail all the way through my thumb.",TIFU While Volunteering (Kind of NSFW),334
[deleted],107,35,uf538,253,"Okay so I'm basically fucked. Let me get started on how badly I'm going to lose my job.

So today at work my boss was sick so he called in her daughter who is a year older than me to come in to help close. So she came in and we proceeded to get done clean up and the other workers left. I work in a grocery store by the way so nothing too special. Anyways I was getting my stuff from the back when she came back there and she started to get really touchy.

So this is where shit got hot and heavy and we proceeded to carry on, she blew me for a bit and then she asked if I had a condom. I had one in my car so I went out of the store, but I took the short way which was to open the loading door, at the time I thought nothing of it. So we finished up and she said she has been wanting to do that for a long time and next time we should make it even more kinkier and all over the store.

So this is where shit gets bad. I was driving home when I was thinking of how awesome it was, when the thought hit me. The alarm was set because we had locked up. So tomorrow my boss is going to get to work and see the alarm had gone off, and do what anyone would do. Watch the camera's. So I'm basically fucked.

TL;DR - I fucked my bosses daughter in his store, but was dumb and opened the garage door making an alarm go off. So now he is going to watch the camera's and see us. 

EDIT 1: I don't work till Saturday. Next time I work with my Boss is Tuesday. I'm hoping he doesn't make a guest appearence anytime soon. 

EDIT 2: The girl was cute, not hot. There is a difference. But a good difference.

EDIT 3: Talked to ""Sally"" today for two hours. She said she will try to delete a weeks time of video and if he does/has found out she will try to calm him down.

EDIT 4: Done work today and he said nothing. I think I'm in the clear :D :D",TIFU Got Caught... At Work!,288
SoulCoughing97,31,51,1e9l2y,250,"This fuck up didn't happen today, about a week or so ago. But I need to spill. (No pun intended)

Well, I'm a *really* scrawny guy. I'm like 5 foot something and 120 lbs. I had been meaning to go to my local gym's weight room for months now, never really got around to it. I am extremely weak. I have trouble lifting 50 pound amplifiers by myself, without a roadie's aid. 

My aunt had just passed, and we're having a graveside service and it's rather small. The rabbi asks for men to be the pallbearers. Since it's such a small service, I am obligated to do so. Myself, and my 3 cousins go up to do it. 

We lift the casket, and, boy, this thing is heavy. Even with the 4 of us on each corner, (I'm on the rear left), this thing is unbearable for a man of my weak stature. 

We go to put her in the hole in the ground, and, well....

...reddit, I dropped the damn thing and....

....there was a spill. 

My kin were in shambles. The look on my poor ol' babushka's face was sheer horror. 

I can't even mentally grasp this fuck up. 

**TL/DR** - *Dropped deceased aunt.*",TIFU by not going to the weight room and ruining my aunt's funeral.,301
shitcannon,37,64,1a9p0y,249,"I'm at a weird stage in my life. I'm 28 and I just moved back to my hometown after quitting my job and moving to a bigger city months ago. Long setup short, I figured out that I was leaving fixable problems and I'm kind of a dumbass. I think they call this the quarter-life crisis thingie now? Oh, well. I wanted to come home for a multitude of reasons and I did today.

Now, my mother came to visit me earlier this week, with the express purpose of riding with me on my return journey. Why? I don't fucking know. She's crazy and over-bearing and thought that I would die of a bloodclot in my leg if she wasn't in the car because I would never stop during an 8 hour drive, which doesn't even make sense because I drink a gallon of water a day and pee like 400 times and I'm not an idiot and I like to move around every 3-4 hours and it's not like she came to my white collar job every day for 5 years to ensure that I left my desk every once in a while instead of sitting there for 8 hours straight. Plus, she wanted to torture me with her Barbra Streisand records, thus destroying any possible hopes of an enjoyable road trip, me by myself, in my metal beast/sanctuary.

So my mom is at my apartment and I set her up in my room because she's fucking old and I'm a good kid and even though sleeping on an air mattress combines sleeping on something entirely uncomfortable with sleeping on something that makes noise when you shift around and sleeping on something that you can literally NOT put fucking sheets on properly, I didn't mind giving up the bedroom for two days. Mostly, I wanted to watch Justified while she was asleep.

I started the nofap thing as part of my 2013 Better Me campaign (as I call it). I sorta believe the hype, but whatever, it's more about paying attention to life instead of porn for me. And I wanted the challenge. Now, sex is not an issue, but I've had a dry spell throughout this moving process, which has coincidentally lined up with me starting the nofap. I hit day 45 today.

So last night, I hit the old air-bed at around midnight. Comfortability being impossible, I finally succumb to the most horrendous slumber ever at 2:45ish. At 4:30 am, I violently awake and realize that something is horribly wrong. I feel some wetness and immediately think back to every time I drink way too much...1) Did I wake up while peeing? 2) Do I still have pee in me waiting to be evacuated? 3) Is it just a little spot? Or should I be worried?

The answers to those questions in this case are 1) No. 2). No. 3) Fucking worry. 

At this point, wide awake, I start to frantically rip the sheets and blankets off of me, convinced that there's going to be a horse's head somewhere in bed with me. Or, an even worse thought, what if this is my own puke or I had some kind of aneurism and bled out in the night? (You may think that's crazy, but one time my tonsils got so swollen, a blood vessel broke in my sleep and I spent hours choking on my own blood and puke...uhh...so there.) What I found was even more unsettling.

Cum. Cum everywhere. I mean, like a fire hydrant exploded and cum came pouring out. Like there was a bukkake party with one guest. There was more cum in my bed than in all 3 Kardashians last night. There was so much white in my bed that for a minute I thought I was at a Lumineers concert. The way in which my sheets clung to me was not unlike the way Manti Te'o has clung to his claims of heterosexuality. I mean, there was so much sticky on me last night that Snoop Dogg might've been interested ('cause of the whole...sticky icky icky...sigh). The point is, there was so much everywhere, that I immediately got up to go redo my whole bed and hose down my stomach, legs and crotchtal area.

That's when I looked at my bedroom door, realizing that I was, in fact, on the outside of my bedroom, which is where my bathroom is...with my sheets and my shower. I mean, I could totally sneak in on my sleeping mother and not wake her up and have to embarrassingly explain why my boxers were soaked, my stomach was glistening and I smelled like fresh sex, right? Then I noticed that the light was on under the door crack. My mom cannot fucking sleep regular hours because she's all retired or some shit. Fuuuuuuuuuuuck. I was totally ready for my Top Secret Operation: Clean My Dick Without Waking Mom.

Then I had a brilliant idea. My underwear is already packed! But fuck. My underwear is in my car, three flights downstairs, it's 4:45 am, it's below zero degrees and I only have cum-soaked boxers on. This is when I start to get really pissed. Not because I realize I'm just gonna toss these boxers and worry about how to hide my nakedness tomorrow morning and thus, avoid questions from my mom like, ""Why are you sleeping naked when I'm staying here?"" No. I had just realized that I didn't even remember the dream. I mean...surely, to do this kind of damage (I mean, we are talking about cum dripping off the sides of an air mattress), I probably had a good one going. I don't even have a remnant. I mean, what if I've somehow repressed an orangutan-fucking dream? What if it was the most horrible, dark, depraved act that I didn't even know I could think of? What if that's what gives my dick volcanic eruptions? Now I'll never know if I'm into testicle stabbing. Maybe it's a good thing that I repressed it. But on the other hand, what if I was like ravaging the most beautiful of all women and then fighting zombies while doing it? Seems like those are some images worth storing, brain.

Now something else dawns on me. I ruined these shorts, which I had planned to wear on the trip home the next day. I had already packed the rest and didn't want to undo all of my terrific packing! Fuck it. Bareback kinda day, like that shart at the championship football game a few months earlier. ( EDIT: Shart story available now...http://www.reddit.com/r/tifu/comments/1azpv8/tifu_by_trusting_a_fart/ )

Now I'm like fuck it. I'll peel these bad boys off and just jump back into bed...I'm sure the sheets aren't that bad. Wrong. They were. They were still soaked when I woke up 4 hours later. I'm surprised I hadn't somehow spackled the sheets to the ceiling. So now, I'm laying in the stickiest, coldest, wettest, most uncomfortable, fucking bed of all time, with my cum-drenched boxers hidden out of site underneath the bed.

This is when I have another dream and this one I remember and it pisses me off even more. It hadn't dawned on me during my earlier panic that sperm has a particular smell, so much. I mean, usually it's faint, who cares? But when an entire painter's bucket of cum has been dumped on you, you will smell it. It was like seawater and cake batter. It smelled, on the one hand, delicious (hey, that's because it's from me) and on one hand like something that came off of a hobo. So during this nightmare, my entire family was in the room smelling this and I had to play it off like, ""I dunno. What a weird smell. What could that be? Certainly not 178 fluid ounces of baby making juice."" Eventually, the smell stuck to me and I would have to evade questioning at schools, airports and hospitals. No one ever pinned it on me though.

In the morning, realizing that I was nude and still covered in cum, I pretended to sleep until I saw my opening...my mom went out for a cigarette, I showered and threw everything in the washing machine.

Shit worked out. But goddamn. A nocturnal emission at 28 years old is not pleasant in the least bit.

**TL;DR:**  28-year old staying with mom for the night had a wet dream, most epic amount of cum ever. Had to sleep in naked shame without access to clean clothes or shower. Like, so much sperm for real. Like...I couldn't even pee this much cum if pee were cum.

EDIT:  Too much shame for my real account. This is my throwaway. Thought I should explain that in case you see my 0 karma.",TIFU by trying to nofap,313
domenow,77,113,1qk3cy,244,"...thereby missing a class that the professor told me I really can't afford to miss any more days of. And, just to clarify: that would be 17 full blown orgasms, and 2 half orgasms.

It was 12:20, and I had to be out of the house by 1. I was right about to shower when I suddenly got in the mood. I swear, I don't plan these things.

I quickly mapped it out in my mind: Get in shower with vibrator and phone (for pornographic purposes), don't turn the water on so your phone doesn't get ruined, get just one orgasm, and leave the shower at exactly 12:40. You'll have just enough time to make it to class.
Usually, I knock out about 2-3 and that alone takes me 45 minutes, but today was completely different. The first one came rolling in at around 10 minutes in, the 2nd took me a mere 5. (Remember, I had my phone with me, and I was basically staring at the time to avoid losing track of it). I thought ""There's no way I'll make it to a 3rd, but I have 5 more minutes. I'll just enjoy the time I have left"". I had completely forgotten to factor in time to actually shower. The third one came....at 12:41. ""There, you might be a minute late, but you made good time"", I thought. ""Let's just wait until the amazing post-orgasm feeling goes away. Yeah, sure, keep it on while this happens. Why not?""

I can safely say that this is the point where all logic left me. No longer was I stringing together coherent sentences in my mind. It then became...a race against time. ""I came so quickly the last 3 times, maybe I can put on the first item of clothing I see and still be on time"". 4th orgasm. 5th orgasm. 6th orgasm. I was coming every 2-5 minutes. This never happens, and I told myself it would be a sin to stop now. ""6? You want to stop after 6? Why not hit the lucky number 7? That'll be the last one, promise"". 7th orgasm. ""You never really did like odd numbers. See if you can go for 8. 8th orgasm. 9th orgasm. ""Okay, so you'll be fifteen minutes late to class. You'll make it, don't worry, Don't you want to make it to the double digits?"" 10th orgasm. 11th orgasm. (I forgot where I had the two half orgasms, somewhere in between 10-17 I think).

When did I realize class wasn't happening? I'd say at some point between the 11th and 13th orgasm. I'm inclined to say 13th, because that's when the intense self-loathing started. ""So this is what you do all day, huh? Touch yourself?""
Indeed, it was precisely when I came to the realization that I wasn't going to make it to class that it went from enjoyable to pitiful. It became, ""There! Take that! Have another orgasm, you fucking better to make up for the fact that you missed yet another class. Isn't this what you wanted all along? Just another orgasm?""
Immediately following the 15th, it started to feel like razor blades were attacking my clitoris. I thought of a couple jokes to tell my friends. ""My clit looks like it grew another clit, that's how swollen it is"". But it was too late to stop then - I had to do it to ""make up for"" the fact that I had missed a very important class. I kept going, because I felt I deserved the pain. Deserved what was coming to me. Unfortunately, they were coming much slower this time around, and didn't last nearly as long. Every few second orgasm was a blissful escape from the hell I had created for myself. After the 18th, I decided to make a TIFU post about this. I waited another 15 minutes to make sure I wasn't going to get another one, got up to actually shower, and typed this all out in my robe.",TIFU by having 18 orgasms,357
Rob_G,30,60,1oxcci,250,"I saw this clip on /r/gifs or /r/WTF a while ago of a guy approaching a whole swarm of bees attached to a tree. He slowly puts his hand through the mass of squirming insects and removes it a few seconds later, totally unharmed. The next time, he goes back in, he pulls off a huge chunk of bees, almost like the whole cluster was a liquid, like he was running his hands through a loosely cohesive whole.

Scrolling down through the comments, I hoped to find some sort of an explanation. And I found it. Someone wrote about how when you find bees attached to a tree or some other object, it means that they’re swarming, that they don’t have a queen to protect, and that they’re incredible docile. It all made sense as far as I could tell, I mean, I’m no beekeeper, but this was proof, right?

So when my wife called me outside a few months later, she was screaming, “Rob! Come outside, come quick!” I went out back and she was standing twenty feet away from the garage. “Look Rob, there’s some sort of a beehive.” And it was just like I saw on the video, there were tons of them, all clustered in the top left corner.
I said to my wife, “You want to see something cool?” and I was just going do it, like I’d run my hands through and my wife would be all scared but after a while she’d see that I wasn’t being hurt. How would she react? She’d probably start asking a bunch of half-questions, like, “But … how? This … what?” and I’d just laugh, making up some nonsense answer like, “It’s all about confidence. These bees are more afraid of you than you are of them. You need to project strong vibes, and they’ll understand that. They don’t speak English, but body language a universal means of communication.”

So I calmly walked toward the hive. “Rob? What are you doing, Rob?” to which I replied, “Hey, I’ve got it. Don’t worry.” And that whole confidence, posture, body language thing, it totally worked on my wife. She saw me chill out, she started chilling out herself. “All right, just be careful. What are you going to do?”

“Watch,” and, you know, even though I was fairly certain that this was going to go just as it did on the Internet, there was still a palpable sense of fear. I mean, even if you’re positive that something doesn’t pose a real threat, a swarm of bees is still pretty scary. I’m not even used to dealing with like one bee, but this? This was hundreds of bees. I got close and the buzzing, which I could hear from back at the house, it grew louder, deafening, I could feel it like a cloud of vibration surrounding the periphery of my being.

I raised my hand toward the swarm and I realized that I was fighting my bodily instincts. It was same feeling I had when I went to this adventure park over the summer. One of the attractions was called the Mega Jump, basically, you climb up to a really high platform, they attach you to this rope and pulley thing, and you jump off, confident that whatever it is they’ve tied you to will slow your descent before you touch ground. Again, even though I knew it was this controlled thing, I still experienced a very physical reaction, a terror really, as soon as I stepped up to the edge.

But this was all in my head, I told myself, and I knew that I couldn’t stand there hesitating for too long. I’d psych myself out, or worse, my wife might get the impression that I didn’t know what I was doing, she might get hysterical again and I’d back out if only to keep her from freaking out. I swallowed the lump down my throat and I reached into the mass.

And the stinging was immediate. I recoiled my hand instantly, it was covered in bees, they were all stinging me. The outer layer of the swarm broke off and started circling my body, my face. I wanted to swat them away, I instinctively started flailing around, hitting myself in the head, which, with my one hand still covered in bees, it was just spreading them to my head, my scalp, the ones that had already stung me and died, it was like they were glued on, and I crushed some of them against my skull.

My wife came over with a bucket of water and doused me, but it did little good. In a brief lapse in between bouts of panic and terror, I regained control of my faculties and ran toward the hose, sprayed as many of them as I could away from my body, and followed my wife who had escaped inside the house.

There were like ten or twelve bees that had made it inside, and right outside, it was just this cloud, a whole nest of angry pissed off bees looking for some revenge. My hand was bleeding, everything was starting to swell, my wife was swatting at the few intruders were still circling our heads trying to exact revenge. I looked at my ballooning hand, she looked at me, she said, “What the fuck Rob? What the fuck?”",TIFU by trying to stick my hand into a swarm of angry bees,310
Shitty_Tweezers,94,130,1aiq0l,248,"I was sitting on the toilet enjoying a shit when I feel a slight prick/sting coming from my stomach, thankfully, my mother had left her tweezers sitting on the sink next to the toilet. So I reached over and started trying to pluck this small annoying hair from my stomach. 

But guess what happened? If you look at my username it's probably easy to guess, I dropped them, right between my legs. Into the pool of shit and piss.

I quickly stood up and stared at my problem for a solid 5 minutes before realizing, I can't flush this, these are mums good tweezers.. so.. I fished my hand down into a pile of bobbing shit and grabbed these putrid tweezers and threw them into the sink. I washed my hands before I puked and started filling the sink with soap and shower gel to wash the tweezers.

After that I ran and left them in there. I am so ashamed..",TIFU By trying to pluck an ingrown hair while taking a shit. [Semi NSFW],378
tifuthrowaway1994,89,42,11ts0x,248,"Edit: [Update on the situation](http://www.reddit.com/r/tifu/comments/11uwsx/tifupdate_to_tifu_by_ignoring_my_doctors_advice/)

Before I start, you should know that I was recently prescribed Zoloft for depression. It makes me feel extremely nauseated.

So I met this guy in my Italian class. He's a junior, I'm a freshman. We hit it off and there was some chemistry between us. He invited me to his dorm to watch some Buffy. 

He offered me some wine. I just turned 18 but didn't want to seem like a dork by saying no, so I accepted a glass. I clearly remembered my doctor's warnings when she talked about the Zoloft, one of them being **do not drink any alcoholic beverages** (she knows I'm only eighteen but she also knows that there are a lot of parties).

Halfway through the Dracula episode, my classmate and I started kissing. Things escalated. His tongue was in my mouth. And then I felt a wave of nausea. I tried to ignore it, because I was still feeling horny as hell. I felt a little better. He started stroking my tits, and I moaned. ""Mmmm."" More kissing. I unzipped my jeans and placed his hand on my crotch. He began to finger me. Even more kissing. I pinned him down and purred, ""I want to fuck you so hard right now.""

We started kissing again, and I felt even more nauseated. I unlocked my lips from his. ""I think maybe we should stop, I don't feel--"" And then it happened.

I puked on his face and chest. It was an explosive sort of vomit. It got over his couch and I'm pretty sure some of it landed in his wine glass.

He just stared at me, mouth open, vomit still all over him, blinking. I muttered a quick ""Oh my fucking God, I am so sorry"", started crying, grabbed my jacket, and hightailed it out of there.

And that's why I'm now in my dorm on a Saturday night, constantly refreshing Facebook to see if he's written anything about our encounter or unfriended me while my face still burns in humiliation. So far, nothing.",TIFU by ignoring my doctor's advice. [NSFW],290
Donkey-boner,49,68,11nqen,246,"I sat right in the middle and have been here for about half an hour

I have been asked a couple questions and got them very wrong",TIFU by going to the wrong lecture and sitting in the middle of everyone,314
shmiz,49,64,rzmby,247,"Last night I started to get those fourth meal hunger pangs and decided to (somewhat drunkenly) drive to the nearby T-Bell. I live in a pretty shady part of NE Portland. As I pulled up to the intersection of my residential street and 82nd (a busy street), I noticed I pulled too far forward for this woman to cross the street. So, being the gentleman that I am, I backed up a bit to give her space and waved her on. Big mistake. Next thing I know she is opening the passenger door saying ""Wassup baby?"". I panic, shout ""NO MONEY!"", and hit the gas. As I'm driving away with my passenger door flapping too and fro, I see a guy trying to catch up to me (presumably her pimp). This happened ON MY STREET. Now I don't drive at night on my street. Wonderful. But, I did get my tacos. They were delicioso. 

Edit: I don't understand all these down votes for driving buzzed. Isn't doing stupid shit the point of ""TIFU""? I never said it was a good idea, my admission to fucking up is right there in the title! 

tl;dr - I almost got the wrong kind of taco during my fourth meal outing. ",TIFU: I accidentally solicited a prostitute and enraged a pimp.,311
tripsyfag,44,47,1bpbm3,249,"First of all, I live with my elderly grandparents who are extremely frugal. They cut open toothpaste tubes to get the last bit out, mix water with dish soap to make it last longer, refuse to have any heat in the winter save for a single space heater in the living room, etc. 
They also refuse to flush the toilet more than once a day, claiming that it uses too much water. It's really gross. I tend to get my business done in the morning to avoid having to piss in a used toilet. Last night, however, was different. I'm lactose intolerant but indulged in ice cream anyway, resulting in stomach cramps. I suddenly needed to evacuate my bowels, so off to the toilet I go. Keep in mind the toilet has not been flushed yet today. Anyway, I walk in the bathroom and sit down. Wrong move. The seat was up, which I didn't notice before. So instead of sitting on the toilet, I fall in. I fall into a day's worth of shit and piss. I showered and scrubbed until the water ran cold, but I will never be clean again. ;_;

TL;DR Grandparents are frugal and only flush the toilet once a day. Didn't check to see if the seat was up. Fell into shit and piss.",TIFU by not looking before I sat on the toilet,296
ZeldaTheAnglerfish,26,57,14x5bi,246,"I'm a graduate student.
His profile said he was doing research in my department, and I, for reasons incomprehensible to me, assumed he was a postdoc. I sent him a mildly flirty message, then I looked at the link to his research page, which he included in the profile.
Well, shit.
Please don't let him be friends with my advisor. ",TIFU by messaging a hot professor on OKCupid,303
vinylwrec-cord,115,51,1e8waf,244,"Really this was like 3 months ago, but here goes. For Christmas I got a three month membership to the local UXL, I wanted a personal trainer as I know nothing about working out. I work with a woman whose daughter is a trainer there and I wanted to train with her. I had a sit down with the head trainer and the overview he gave me was two months in advance, then after that going month to month until I wanted to cancel.

Fast forward to April, while checking my banking I notice there's a $120 charge for for the personal training, after I said something to my trainer about noting wanting to renew. I talk to the guy, who's a real dick head, and he just puts on a shit eating grin and said yeah that was for a year, I can freeze your account and we can try and work something out. He then told me he would talk to the guy above him about getting me out of it.

I was checking my banking Sunday and  noticed another $120 charge after he said he was supposedly going to freeze my account. Every time I ask that guy how this negotiation is going, he keeps putting on his shit eating grin and telling me he will talk to him tomorrow. This is breaking me financially, I only work part time for the being, and I have almost over-drawn my account twice because of this. Yesterday I took a good look at the contract, just to see how badly I was fucked, and not only is a year, I initialed for the automatic renewal, I only had *three fucking days* to cancel this. I'm fucked

TL;DR Shady, slick personal trainer sees me coming from a mile away, gets me to sign a contract I didn't read carefully enough, and now I'm locked into paying $120 a month 'til next February.

EDIT: I talked to him today, and watched him put my account on freeze for 60 days. I am going to be up is ass every time I'm at the gym about this. If I am charged again next month I will take action with the bank. I have x-posted this to /r/legaladvice  and thank you for your advice.",TIFU by not reading a gym contract carefully enough.,295
poor_decisions,40,32,17uvmd,240,"Earlier today I was trying to get to my car, which was on the other side of a navel-high fence. Of course, in my divine wisdom, I decided to try and step over the fence rather than jumping over, or (better yet), walking the extra 20 yards around the fence. I planted one foot on the bottom rung, and just as I swept my other leg over to straddle the fence, the first foot sliped off (because icy fence) and my entire body weight suddenly slamed down onto the pointed fence via my crotch. 

I pierced my pants in two placed, stabbed my sack, my taint, and my butthole as I instinctually rolled backwards to alleviate the pressure on my body. Fortunately for me, the fence was just high enough so that I couldn't reach the ground with my feet. The fence nearly went up my butt and actually gave me some really nice gouges near my anus. I nearly passed out from the pain, but luckily I didn't tear the sack. 

It hurts to walk, sit, stand, laugh. It hurts to fart. I have to gauze my butthole. 

TL;DR: I'm afraid to poop.",TIFU and now I'm bleeding from the butthole. ,272
Gibs_is_anim_dom,65,51,uujc2,244,"Yesterday I had an incredible brain fart that I'm still trying to understand.

I badly needed a piss and rushed into a bathroom in the hospital where I work. I had a wrapper in my hand that I planned to throw in the bin after. Somehow my thoughts got scrambled and I went directly to the bin, stood on the pedal to open it, whipped out my knob and started pissing. Right into the bin!

It took me about 5 seconds to realise what I was doing and, in a dazed panic, waddle like a penguin over to the urinal to finish my piss. A few moments later another person walked in, had a piss and then stood in the growing puddle of piss beside the bin as he washed his hands at the sink. I was too ashamed to tell him to watch out  for the bin-piss-puddle.

**For the North Americans: bin = trash can.**",TIFU: I pissed in the bin at the hospital.,295
corncheds,30,84,1mhamj,240,"So this was a while ago. Whatevs. Still pretty fucked. 

So in high school, I played rugby (check my post history for a little surprise there). Like most school teams do, we had a rookie party after the season was over. The details of the party are unimportant, the only thing that matters is that I was 10/10 blackout. Straight assed. 

The next morning, my body turned on me. 

First was the shit. 

THE shit. 

I sat on the toilet and tried to avoid passing out from the smell emanating from the bowl below me. It was awful. It felt like I was puking out of my asshole. I wept. I prayed. It made me the man I am today. 

After that asscapade I knew wiping was out of the question, so I turned on the shower and spread em. A brown stream ran towards the drain as I let the warm water have it's way with me. All this time I thought, okay, this day might not be ruined yet. I might be clean. 

Then I popped a boner. 

Maybe it was the water on my bung hole. Maybe it was just morning wood. But whatever the reason, I thought to myself, *Hey, you know what would make you feel better? A quality jerk sesh.*

So jerk it I did. As I trucked along, I felt as though my headache was going away. This feeling was marvellous. I was healed. 

Then I came. 

As I finished my previous euphoria evaporated into nausea and shame, and my stomach began to turn. I puked and puked until I couldn't puke anymore. It splashed on my legs. It was horrific. I thought this was the worst morning of my life. *This has got to be the most awful thing I could imagine*. That was before I fell. 

My assorted bodily fluids had lubricated the floor, and my retching had done just enough to throw me off balance. I felt like that statue of Saddam. This time I did cry a bit. I only missed the tap by a couple inches, no doubt saving me a wicked conkie. I still shudder to think of my parents walking in on that scene.

tl;dr: I got in the shower clean and ended up covered in cum, puke, and shit. ","TIFU by nearly knocking myself out in a pile of my own shit, puke, and jizz. [NSFW]",324
ParathaReddit,66,67,1a08i0,247,"It all starts out on a normal day. I'm running late for school, and I'm in a hurry. As I barge out of the door, I realize that I have forgotten my keys and that without them I'd have no way inside my house because my father would be at work. I head back in a rush and absentmindedly grab a pair of keys from the windowsill and head out. While halfway to the bus stop, my father calls me and tells me I have forgotten my keys. Now, at this point I totally forgot that I had went back in to take keys, so I just went back home and grabbed my house keys and ran off to the bus stop just making the bus. Ten minutes go by, and I reach into my pocket for a piece of gum. Confused, I pull out my father's car keys. ""Oh, fuck."" I think. But no problem, because we have two cars and he can take the other one, right? WRONG. The car to which keys I accidentally took when I ran back into the house the first time were the car keys, my dad later gave me my own keys. That car was blocking the second car in the drive. My dad shows up to work two hours late, gets humiliated by his supervisor, and almost fired. Luckily, he was given a first warning because he never shows up late. 

TL;DR brought dad's car keys to school, almost got him fired.

EDIT: Some people are getting confused by my story. My dad works in a hospital and there is no excuse for being late unless it's something like a car accident, death in family, etc. Mostly everything has to be called in for. My dad works in the emergency room department so they always need people to be working. ",TIFU by almost getting my dad fired.,314
NelsonJamdela,76,56,14qhmx,242,"*Suds... suds everywhere* (But seriously: I'm an idiot for not discerning the difference between dish ""liquid"" and dish detergent) ",TIFU by putting dish soap in the dishwasher,298
tifuthrowaway92,152,131,z5n8a,248,"So this adorable guy got me a great job working in a kitchen as the pastry chef. We've always had a major thing for each other and text and flirt all of the time and we even spent the night of his 21st birthday asleep in the back of his truck together. But we never got physical because he had a girlfriend despite all our flirting. But anyway, he came to pick me up to go out with some work people and we got distracted and ended up drinking and playing video games with my roommates and skipping out on the bars completely. Not too much later it ended up just being the two of us, hammered. One thing lead to another and we fucked in my bedroom until about 5 minutes into it he stops and realizes, oh shit, I have a girlfriend. So he got up and started to leave and we got in a huge fight and he left only for us to be stuck in a kitchen together for 12 hours starting at noon the next day. Now he's over compensating acting like nothing is wrong and I have to pretend I'm okay too. And I have to deal with the fact that he has absolutely no intention of telling his girlfriend...and keeps fucking flirting with me. Fuck this guy. Aaaand I majorly fucked up. 

Update: I pretty much let it go and have been backing off not hanging out at the restaurant after work with him and stuff anymore and I felt a lot better, and I just didn't press the issue anymore and neither of us were acting weird or anything. Then last night a bunch of our coworkers were at the bar celebrating someone's birthday when he met a girl drunk off of her ass (he was sober) and he talked to her for an hour and preceded to take her home. So, any little tiny feeling left in me that he was actually an okay guy and maybe, just maybe it all happened because he had some sort of feeling toward me got shot to hell and I'm just done. Because I'm not going to lie, I couldn't really help crushing on him, and while I feel horrible about what happened (especially for his girlfriend) part of me was hoping for some sort of a happy ending. So yeah never mind. Sucks. I'm feeling even worse for his girlfriend now, bc now I know its not anything like he had feelings for the person he's fucking, its just he's horny. ",TIFU by having sex with a coworker who has a girlfriend.,379
InsertRelevantMeme,54,74,y4ab5,244,"About ten minutes ago i was laying on my bed, picked a big fucker of fluff and dirt from my belly button went to smell it being the dirty bastard that i am and snorted the cunt in. It went all the way and i realised how disgusting do have to be to do this. I feel violated by myself.",TIFU by snorting my own belly button fluff ,318
Legion299,44,61,1fdyp1,242,"I was browsing [this](http://www.reddit.com/r/tifu/comments/1f653z/tifu_by_doing_a_pull_up/) post and then I heard a little ""crack crack crack crack..."" sound, I just brushed it off and went ""I'll fix it later..."" then 5 seconds later BAM my jaws slammed right into my desk and I slammed my ass on the ground with the chair.","TIFU by ignoring the ""cracking"" sound of my chair while browsing TIFU",303
S3XPanther,125,74,17y4sw,239,"This is all 100% my responsibility. I had multiple chances to avoid it, and by multiple, I mean absolutely unlimited. But I didn't. I was lazy, irresponsible, and loose with my money. I let my bills pile up, forgetting to pay them until they got too big to pay off on my own. I started getting phone calls from collectors saying I needed to pay them now, which I just ignored and let go to my answering machine. I started receiving letters which I just tossed aside, thinking ""if I ignore it, it will just go away"".  

Today, I finally broke down and looked to see how much I owed, and it's out of my current realm of possibility. I checked to see if I could get a loan to pay my bills off, just to get started, just to breathe, but each place I went to told me ""Your credit is shit, come back when you fix it"". And I can't fix it without a loan. It's a great vicious circle that I was afraid of slipping into, yet I went ahead and did it.  

My parents received calls today about their credit going to shit now as well. My vehicle is co-signed by them, therefore they are on the line for everything as well. I fucked over my own family, which is beyond unacceptable to me. There was no reason for them to get dragged down with me into this hell, considering they are already facing their own financial troubles. They don't need my financial burden on them as well.  

""I have to be an adult. I have to be responsible"". I tell myself this everyday, thinking ""if I keep on repeating it, it will become true"". It hasn't yet, and it took this wake up call to make me realize I have things I have to take care of. The world will always refuse to coddle me, as it should. Everyone has to do these things, and I am of no exception to this rule.  

I need to find a way to get out of this situation. I need to be an adult. I need to be responsible...  

I'm sorry, Mother &amp; Father.",TIFU by nearly putting myself and my parents into bankruptcy,313
porn4everybody1111,17,41,1qcrmb,241,"So I just got a new 51"" active 3D TV.

The first thing I watched as Avatar. It was so amazing I wondered what porn would be like.

Put some on, and started rubbing slowly. Since I didn't to touch a new remote and put dick germs onto it, I elbowed the off button and went to shower and off to bed.

The next day, my family came over, the first thing the cousins and parents went to do was check the TV out. I'm cooking in the kitchen while all this happens thinking that will watch Avatar or what not.

BEHOLD, THIS FUCKING TV HAS AUTO RESUME. Turning on the TV bring you back to the last file played and where you left off.

At first it was silent as the kids were in the room... for 10 minutes. Then I hear the parents shouting at the kids. I come in to defend them to which the parents tell me 'No need to cover for them'

Now I'm hiding here typing this. Poor fucking kids. Stupid technology.",TIFU by showing 3D porn to my family.,282
mordekaiser94,163,336,1houxg,238,"
I was in a plane heading to Amsterdam. It's a 9 hour flight and we have little personal TV screens in front of us. I have a middle seat, on my right a old asian guy, and on my left a black guy who looks like he belongs to a gang. On my TV screen i'm watching Django. During one of the whipping scenes I remember a extremely funny racist joke and I laughed out loud. I see the black guy glancing at my screen in curiosity which I see gradually turn to extreme anger. I then feel his eyes drilling a hole in the side of my head for the rest of the flight, and as we exit the flight until I beeline for the restroom and hide there for 15 minutes.
Tl; dr I watched a controversial movie next to a possible gang member and might get shot in a drive by someday soon.",TIFU by watching Django Unchained next to a black guy,574
Michealxfoo,133,317,1ekttj,243,"So my dumb ass decides that I need to try and fap right after a fresh poo.. So, here I am, full mast, lubed up, going to town. When all of the sudden my lubed up hand starts to lose grip on my phone. Me being the idiot that I am thought It really wasnt that big of a deal and if it fell. I mean, I was mid fap, basically nothing but my family walking in was gonna stop me. So I let it fall. The next sound I hear was a loud PLOOP... My phone fell in my toilet.. mid porn... Now Im not sure if I should tell my mom what happened or just lie about it... Im scarred reddit.",TIFU by fapping with my phone...,560
jweezy3,44,84,z33sf,241,"After dating this girl that I really like for about a month, she took me to her lake house for a nice *relaxing* weekend with her extended family. Skipping to the chase, a day into the weekend, a poo storm was a brewin’ and the forecast wasn’t pretty… With no fan in the bathroom (like are you kidding me??), no Lysol spray, and paper-thin walls, I had to be an ultimate ninja shitter.  There was some shampoo in the shower, so I put a little in the toilet bowl so that the scent would rise when I initially flushed, cancelling the proof that I was even there. Genius right?? I eased out the first brown cow, silent as Anne Frank. Courtesy flush. Smells like flowers. I was in the clear! After making a few smaller ass kabobs, I reach over for the TP… not even one square. Not one. A quick glance around, no Kleenex either! Ok, don’t panic. Checked under the sink… nothing. Mini half-closet? SUCCESS! Haha! The gods were smiling down upon me. Smirking, and feeling like I just dodged a bullet, I was in a generous mood. I decided to change the old TP stub on the spring-loaded rolling pin to the fresh roll. A true *hero*! Dislodging the Chinese-finger-handcuffs, the spring was more “loaded” that I was expecting, and it fired. Then the unthinkable. Flying through the air, the half-TP-holder projectile was heading for the 4x2 inch opening right between my legs (aka the opening between me and the toilet bowl. Get your mind out of the gutter fools). In my attempt to save it, I managed to throw the other half and the spring into the bowl for one big poo party. Quickly grabbing them out, the pieces were dripping shit-water all over the floor and bath mat while I was in the middle of a potato sack race to the sink with my pants around my ankles.  Doing the best I could to wash the dirty off of them, I cleaned what I could. As I opened the bathroom door, her uncle was about to walk in (he’s ex-special forces and a scary, scary man).  As he’s walking past he sarcastically says, “hope you got it all in the bowl son, I’d hate for you to have to clean the walls.”

You don’t even know Uncle Rick, you don’t even know…
",TIFU by sitting on Pandora’s crapper and starting a poo party.,325
i_wotsisname,34,30,1jpd8p,242,"It's pretty straightforward really.

5am, I'm standing in front of the throne half asleep, balancing on my heels because the tiles are cold as fuck. I'm just relaxing into the relief of a nice long, early morning piss when the most horrendous and unexpected sneeze rocks me off balance, sending piss in every direction and putting me on my ass.

Now I'm hobbling everywhere because of my bruised ass cheek and the bathroom needs hosing. Though, at least I was already going to have a shower, so I guess there's that.",TIFU by sneezing mid-piss.,272
KrystalKastle,34,88,1nv9y0,238,"""Oh you shouldn't have used translate, you should have used a dictionary"" -___- ","TIFU by misspelling ""desert"" as ""dessert"" onto translate and gave an entire speech in Spanish on the ""inhabitable Sahara dessert"" and its colonization.",326
mimicryinc,82,102,z2col,239,"I was upset today, as I had been notified that I may be restricted from enrolling for school this fall. In these situations, I usually seek out comfort that only Taco Bell chalupas can satisfy. I decide to embark on this journey to get some fine mexican cuisine by bicycle. I get there and end up standing at the register and waiting for the cashier for a few minutes. There are 3 guys in the back who keep looking at me, but none of them actually come to take my order.

Cue one of the most handsome men I've seen since I've been home (although this might be an exaggeration as I worked at various Motorcycle safety classes all summer and was primarily exposed to middle aged white guys).

""Sorry for the wait - I thought xxxx was up front already”. No need to be sorry! I was a taken aback by his fineness in addition to being distracted by the day's stress and barely mustered my voice for a bean burrito, feebly handing him a $5. He smiled at me and gave me $3.69 (I swear he said 69 with a bit of grin as he gathered it from the register). To my surprise, he also gave me a cup for a drink - on the house - since I had to wait so long.

Now, this was a full sized cup, not just a dinky little cup they give you when you ask for or ""water"". I was stunned by this gesture since I'm not used to kindness, but I managed to stutter out an ""Oh. Thank you"" anyway. I retrieve a bit of water from the fountain but didn't put a lid on it since I wasn't going to be able to carry it on my bike. I take a big gulp, but as I do, my gaze crosses hot cashier guy's. As we're locked in an intense stare filled with what can only be described as a cornucopia of sexual tension, I miscalculate my beverage's path, which resulted in it missing my mouth completely and plummeting down the front of my shirt. As I’m staring at him. Dead in the face.

Fate would have it that my burrito is placed in front of me nanoseconds after my blunder. I toss my cup, grab my burrito and mumble my thanks, my gaze now set on the floor leading to my exit.

**tl;dr: I spilled water all over myself in front of an attractive cashier.**
",TIFU by getting wet in front of a Taco Bell cashier.,341
lilmisssunshine,33,70,1ittte,240,"I work out mwf with my husband in a boot camp class.  I got through almost the entire hour before my husband says in a horrified and hushed voice ""*BABE!*"" and points in the general direction of my crotch...look down and what do I see?  A small hole? nope.  The entire seam going down the front of my running pants is completely unraveled...I have no idea how long it had been that way, but chances are it was like that from the time I put them on this morning.  So yeah...if people didn't know what type of panties I wear before today, well they do now!   

*edit* I just want to thank you all for the shared stories...it's oddly reassuring to know I am not the only one that this kind of thing happens to :P",TIFU by not checking out my running pants...,310
The_Tolfdir,35,32,11xcf2,237,"For clarification, this happened last Sunday.

I was taking my morning walk by the beach and noticed a man who I thought was buried in the sand. I couldn't see his arms or legs, but I figured they had been covered with sand by his kids. 

I walked over and said good morning, to which he responded, ""It's a beautiful day, isn't it?"" I answered, ""It is! The way you're buried makes you look like a starfish!"" or something along those lines. 

Then it happened. I looked back at his chair and noticed his prosthetic limbs. I felt like the biggest fuck up ever. He grunted, ""Yeah..."" and I quickly retreated to my car. I called a complete amputee, no arms or legs, a starfish. Fuck me.",TIFU By Telling An Amputee He Looked Like a Starfish,269
coforce,29,37,vhy74,240,"I was eating in a restaurant with a group of people enjoying a meal. I noticed that a very attractive waitress (who was not serving our table) kept making eye contact with me smiling. She eventually took a break and sat at a table behind me. I turned around to look at her and as I did so I rocked the table I was sitting at forward haphazardly dumping every drink, food, plate, and condiments on our table into the floor. Most of my drink spilled directly into my right shoe and it looked as if someone just threw food/drinks randomly all over our eating section. I took my shoe off and dumped 3/4ths of my drink out of it. A flood of workers came to our section to help us clean. I'll never see her again, which is perfectly  fine with me. Talk about being awkward in public.",TIFU while eating at a restaurant. ,277
OttoBSleeping,21,19,qgtvr,241,"Parked in a paid lot too, so I had to pay for two days. grrrr.",Drove to work...forgot and took bus home.,260
falconburn,17,37,1il7vm,234,"After a drawn out period of a ""No-Burn"" policy being in place due to dryness, it was finally lifted so we had a campfire and did some old fireworks we had in our basement (really old). My parents were over, my brother and some family friends. They were inside, and my 13 year old nephew was sitting on the front lawn. I wanted to surprise them by setting fireworks off in the back yard and have them arc over the house so they could see them from the front window. I light a rack of really thick, short fireworks (six in a rack with fuse connected to each so they go off in succession, one after the other) and angle them over the house at about 65-70 degrees, and let them rip. Now, our back yard is long, but not wide, and I wanted to keep a fair distance from the house so the powder would not stink the place up. The fireworks flew out nicely, REALLY nicely, and arced gracefully over the house. WAY over the house. I could not see it when I heard it explode. The next one was already lit, and the next one, so I knew there would be two more volleys I could not stop from exploding on my front lawn like it was Vimy Ridge. As soon as the last two detonated out of sight, I run up, and sure enough, I blew up my nephew. We took him to the hospital, his hearing was gone for a day and he said it was like seeing after you look at a welding torch. He had minor burns and was pretty bruised and scraped up. The lawn is pretty much totaled. Parents pissed, brother relatively pissed. Nephew said, and I quote ""THATS HOW YOU BLEW ME UP? THATS AWESOME"". He is not pissed.

TL;DR accidentally mortared my nephew and blew holes in my lawn

Edit: My parents cooled down a bit, once my nephew said he though it was awesome. Brother is now laughing his ass off every time he looks at his kid.",TIFU by blowing up my nephew and accidentally reenacting the battle of Vimy Ridge on my front lawn.,271
fareastcoast,32,37,1efsd1,241,"I hurt my ankle earlier playing basketball so when I got home I grabbed a Lime yellow Gatorade, a bag full of ice cubes to wrap to my ankle, and headed upstairs to elevate it.  I didn't use crushed ice and needed to even out the ice pack, but my ankle was fucked, it was late, and the kitchen is downstairs.  I didn't think twice, poured some Lime Gatorade in it, sent out some texts saying I'm gonna be hard up the tomorrow, and inadvertently fell asleep.  

The girl I'm seeing thought she would be a dear and bring me dinner (Doritos Tacos).  She came into my room and lifts the blanket for a cuddle, when I wake up to her saying, ""Oh my fucking god"", chucking a 180 and walking right out of the house.  The ziploc bag had come open and my pants, white sheets and comforter were covered in a very distinct yellow liquid.  I was still barely awake when she scurried out.  

I just ate the tacos and sent her a text explaining myself, I don't know...

God damn i love tacos...
",TIFU by using lime Gatorade in an ice pack...,278
op_xsupernova,32,52,1o5mcs,236,"I'm not actually sure if this was today or yesterday, as I have no idea what time this happened.  Anyway.

I got drunk before I went to bed last night, one of my favorite shows (American Horror Story) started its new season and I saw that as a reason to celebrate (who am I kidding?  I'm an alcoholic.), so I went to the store and got some drinks and got shitty, then passed out.  At least I was *in bed*.  I did manage to take all of my clothes off before I passed out, I don't sleep very well if I'm clothed.  I woke up some unknown amount of time later and *desperately* needed to go pee, so I just hop out of bed and right around the corner to the bathroom.  I live with my SO, and it's just the two of us, so I didn't worry about things like getting a robe on or shutting the bathroom door.  I also didn't put on my glasses.  I feel like I should mention that I'm almost legally blind, so if it's more than about 8 inches in front of my face it's very unlikely that I'll even be able to tell what said object might be.  **But**, I know my house, so I just stumble around the corner blindly and sit on the pot.  I see a figure in my living room, crouched down on the floor (or maybe a midget?), and I slur, ""What'rrrre you doinnng babe?""  And then I hear, ""Playing video games... and ____ and _____ are here.""  OH MY FUCKING GOD THAT'S NOT MY SO THAT I'M STARING AT WHILE I'M NAKED AND TAKING A PISS!!  Slammed the door and damn near started to cry, finished peeing, grabbed a robe and ran back to our bedroom with the hot face of shame.  Didn't get much sleep, I feel like such an idiot.

TL;DR took a drunk piss while naked with the door open in front of guests.",TIFU by sleeping naked.,288
slugagainstsalt,50,39,1bvnx3,233,"I was buying an airline ticket, and decided to change the month of departure from my original search. When I did this, the month of return also changed without me knowing it. Instead of buying a ticket for June 28-August first, it them became June 28-June 30. Mind you, this is a ticket from Europe to the US. The ticket happens to be non-refundable and non-changeable. I can get a refund for only a small amount. $139 out of the $1,400 ticket. 

The worst part of this, I bought this for my boyfriend using his card (he knew, I just found the better deal quicker, so I bought it on my end.) So now, when he said the ticket still hadn't hit his account, we looked at the ticket and that is when we noticed the date errors. When I go back to the airline website, it still does the month switcheroo. 

Basically, I feel like I am about to puke. This might be my worst fuck up ever. 


*UPDATE* We ended up canceling the transaction through the credit card company and purchasing a new ticket, which was about $250 more. Also, the airline did say they had been having glitches with the website. I am just glad we were able to fix everything. ",TIFU by buying a non refundable airline ticket and clicked the wrong date,272
[deleted],37,24,z8awp,239,"I work at a local pool during the summer. We have a toilet bowl cleaner (Misty Bolex) that is 23% hydrochloric acid. It's fairly strong. If you do so much as drip the diluted stuff that's in the toilet bowl onto your foot, you better be near a water faucet or you're gonna have a nice burn. We're probably not the smartest by using it, seeing as how most of us are in nothing but swim trunks. Anywho, I was assigned to clean the toilets one day. I grabbed all the stuff in one arm: paper towels, disinfectant, the toilet brush, and the toilet bowl cleaner. Now, the toilet bowl cleaner has one of those flip open lids with the spout, and whoever used it last didn't close the lid. So, as I go to set all the stuff up on the sink, the toilet bowl cleaner slips from my arm. Being the genius that I am, I looked straight down at it. As it hit the ground, a couple of nice, big drops shot out of the bottle, landing squarely in my left eye. I let out a little weird yelp-type thing and run outside, thinking I could yell at someone to get the key from my supervisor to get the eye-wash out of the chemical room, then realized what an idiot I was being and ran back inside the bathroom and immediately started flushing my eye out with water from the faucet. After 15 good minutes of flushing, my eye is swollen and still has 20/20 vision.

**TL;DR: Got toilet bowl cleaner (23% hydrochloric acid) in my eye, freaked out, douched it like a mofo.**",TIFU by almost blinding myself with hydrochloric acid,263
Morpheus_Oneiros,22,38,yp80m,239,It looks like Starbucks explosively orgasmed in my truck...,TIFU by shifting gears with my coffee thermos instead of the gear-stick.,277
[deleted],38,47,wloip,234,"So I love hot wings, my entire family does. We had my parents over. My mother had gall bladder surgery 5 years ago, but her stomach is still not where it is supposed to be, so I decided to make her some really mild ones. Everyone else likes them extremely hot, as hot as you can get them. So I make my ghost pepper hot wing mixture with garlic, franks hot sauce, and a dried ghost pepper. I fry ours up in peanut oil with habanero flakes in it, and fry my moms up in reg peanut oil. I make hers with some brand name mild sauce my wife found on the store shelf, my mom tasts it, and loves it. So fast foward a few hours, when we are ready to eat. I am making the plates, complete with ranch/blucheese dressing as a dipping sauce with some celery. My moms hot wings turned out the exact same color as the others, and I got them mixed up. Now if any of you have ever ate a ghost pepper you know it doesn't hit you all at once, it sneaks up on it and then attacks. I pass out the plates, and get my dads and moms mixed up. She has devoured three of them before it hits her, and she hits the floor with cramps. I freaked the fuck out, called 911, and had an ambulance sent. This all happened about 2 hours ago, and now i'm sitting in the emergence waiting room while my mother gets her stomach pumped out and wondering if she is going to die. This fucking sucks Reddit. and I royally fucked up. I would take her place in an instant if I could. ","TIFU - I fucked up ROYALLY.
",281
BrownGirlLover,73,25,vtqtw,233,"I called this kid- with completely androgynous looks and name- ""ma'am"" when he/she raised his/her hand in class. The student ran out of the room crying, while all the other kids were laughing their fucking heads off. I guess this kid is male judging from the reaction, but I'm still not sure.",TIFU- I don't know what one of my student's gender is.,258
Solsken92,39,42,1op6bm,233,"Microbiology major here. Exam week in all the science courses, and forget to do a reading for a core theology course. Professor is unsurprisingly miffed that no one in his class of predominantly science majors bothered to read this week's passage. He decides to give a pop quiz on the spot. I start seeing looming images of my GPA decreasing decimal point by decimal point, and share a panicked expression of understanding with my neighbor. She shifts her paper to the side, I glance at it, I hear my name called. I look up, professor is looking right at me. He mutters ""No good, no good,"" marks something on his grading sheet, and speaks no more. I panic for the rest of class. The jig is up, I'm busted. They're going to burst through the door of my dorm a la Dog the Bounty Hunter and rip up my textbooks in front of me. I try to contain my tears for the rest of the class. The minute I get to my room, I hammer out an apology email begging for forgiveness, explaining the situation, prostrating myself before him via Outlook Express. Minutes later I receive a response. ""Alex- I was trying to remember names in class. I got your name and your neighbor Ashley's name mixed up, hence the interruption. I appreciate your honesty, however I would like to confer with you about this as I take academic integrity incredibly seriously. Please advise as far as times you are available to meet. Regards, Dr____"" 

My heart slowly shrivels and settles someplace between my bellybutton and pelvic bone. I snitched. On myself. TIFU. ",TIFU by cheating on a pop quiz...and then ratting myself out for it,275
hilerfleshlight,75,31,vuwg5,236,"My husband is a Marine, currently deployed to Afghanistan, and we live on base (very close neighbors on each side). I'm getting pretty used to living like a foul bachelor, usually not putting pants on until around noonish. Or wearing pants and not putting a shirt on until around the same time. That the instance today. This morning my dog wanted to go out, and without thinking, I stepped outside (very large dog, door opens outwards). Neighbor was outside, getting ready to go to work. Dear. God. On the upside, husband thought it was hysterical.

EDIT: For those questioning and commenting, I'm 29 and wouldn't scare any small children.
2nd EDIT: The ""Pics or it Didn't Happen"" has been done...and done...and done again..and done once more. There is a pic...OF MY FACE...in the comments.",TIFU by walking outside topless ,267
[deleted],47,148,1dbpzx,234,"I live with my grandmother and I took her out to go grocery shopping and my great grandmother who is currently visiting us didn't want to get up and put the dog out on his leash to pee. Upon arrival of my house I was trying to be the good grandson and carry as many bags as I could so my grandmother wouldn't have to carry too many. I had at least 9 maybe 10 bags in my hands and was trying to get them to the kitchen as quickly as I could because they were heavy. Well, lucky for me my dog pissed on the floor, I stepped in it, slipped and went head over heels, groceries went everywhere and to top it off my face landed in the puddle of piss. My great grandmother who was sitting 5 feet away at the dining room table grabbed my Ipod that was conveniently sitting on the table, laughed and then said "" Smile for the camera...loser""

....TIFU","TIFU and my great grandmother was there to witness, take pictures and laugh in my face..She's 98",382
Trollemmiwinks,34,34,s4sow,231,"I'm lactose intolerant. Like continent of Asia, completely lacking the proper digestive enzymes, diarrhea storm kind of lactose intolerant. I woke up kindof sleepy and hungover and drank some regular skim milk (my roommate's). I usually drink Lactaid milk. I couldn't throw it up and I didn't have any lactaid pills on hand so i just manned up and went with it.

So I hopped into my car and felt a little gassy, which I had fully anticipated. I propped up my left butt cheek so that it was slightly facing the driverside window and let er' rip.


... I had to get off the highway and head back to my apartment to grab new pants.",TIFU: Drank regular milk instead of Lactaid milk: shit my pants on my way to work trying to fart,265
gerrettheferrett,24,38,1q7c5k,233,"The problem  was compounded when the email self-corrected all other spellings of shifts.

""My shits were pretty quiet this week.""

""I have a busy looking shit tonight that I am not looking forward to.""

""There was a pretty messy looking shit last week I dealt with in the course of my duties.""

Yes, I said duties. * *facepalm* * Kill me now.

""Do any of you have any general advice on how to handle these shits in the future?""

Today I fucked up.","TIFU by typing ""shits"" instead of ""shifts"" in an email at work, sent to my boss, my boss's boss, and all my coworkers.",271
1fuckup,25,27,1d6yzw,232,"Last week, I remembered that my dad's birthday was coming up and decided to be a doll and send him a few of the books on his Amazon wishlist. Added them to my cart. Used the instant checkout method, clicking on his mailing address which had been saved from the previous Christmas. Awesome, birthday shopping complete.

What I failed to realize is that I still had items sitting in my cart from a few months ago, when I was planning on trying out some new, ahem.....*products*. I have my sign-in information set to my old, alternate email, because I hate getting constant Amazon-spam. Because of this, I failed to view the delivery receipt, which may have saved me the embarrassment that was to come.

Fast forward to today, his birthday. I receive an unusually brief email from him saying that I may have accidentally sent him some ""personal items"" and that he was going to mail the package back to me. I was extremely confused and hurried to log into my alternate email to see what he meant. 

Sure enough, one bottle of water-based anal lubricant, and an 8-inch ""realistic mold"" vibrating cock. 

I done fucked up.

Thankfully, we are 600 miles away and I don't have to face him anytime soon, but holy shit. I am mortified imagining his horror, opening a box presumably containing a birthday gift and finding *that*.
",TIFU by accidentally mailing my conservative Christian father sexual paraphernalia.,259
zishu,82,66,1i2cyv,232,"OK, so I go to Walmart for one sole purpose. Gushers.

I get there and I spend literally around 30 minutes looking for them. After a long time of searching for Gushers I had no luck so I decide to ask an employee. There were many out there but I went to this girl in particular. Super hot, my height too and that's rare, bro. 

I start to head her way. On the way I decide to drink the soda I had in my hand to freshen up my mouth, which was stupid to begin with. I get to her and as I open my mouth, I forget that I have soda in my stupid mouth. All of the soda comes spilling out on to my shirt and her shoes as well. I started to apologize immediately and crouch down to wipe some of the soda off of the floor with my knees. More soda comes spilling out of the can because I'm so red faced and embarrassed that I don't realize I tipped the can over. So now there's a bunch of soda all over the floor, her shoes and my shirt. Awesome.

And to top it off, I asked her were the Gushers were at after all of that. She was so pissed, I could tell. It was one in the fucking morning. Who the fuck goes to Walmart at one A.M. for some fucking Gushers anyway?! It's 2:17 A.M. and I'm pretty sure my face is still red.

**TL;DR; I aproach super sexy, female, Walmart employee. Spill soda all over her, me and the floor, then ask her for the location of Gushers.**",TIFU by asking a super sexy Walmart employee where Gushers were.,298
Staticplatypus,132,60,16y4cj,227,"This only happened a few minutes ago and I feel awful. So I was in my bedroom enjoying a bit of r34, altogether minding my own business when there is a knock on the door. I nearly shit myself at that, then the door proceeds to open without waiting for a response rom me. In walks my 13 year old sister. 13 fucking years old. Jesus Christ I'm crying a bit here. So I spring up and turn around in the air off my bed to face the wall, proceeding to stuff my junk in my pants as quickly as possible. To little to late I'm afraid as all I hear from behind me is a disgusted
""Oh no.""
She then proceeds to ask me questions about Dungeons and Dragons as though nothing ever happened but as she left I could see on her face and in her eyes (which I was trying to avoid at all costs) a look of utter repulsion. SHE'S THIRTEEN FUCKING YEARS OLD FOR CHRIST'S SAKE. Oh God I am so disgusted with myself right now and dinner is in 10 minutes. It's going to be terrible, I feel sick to my stomach. I really fucked up today guys. Fuck.


Bit of an update on this: she actually talked to me about it and said not to worry and that she wasn't scarred for life, so that's kinda nice. Mum still thinks the whole thing is hilarious and I found an unopened package of sausages in the fridge. Now that I think of it, the sausages were probably the closest call of the entire evening. Thanks for all your funny ass comments!",TIFU by being interrupted jerking off by my little sister. ,287
nukelauncher95,88,79,1fmp1y,229,"Hey Reddit. You guys might not remember me, but I was the guy who almost killed my best friend by giving her a hug. [TIFU By Hugging My Best Friend](http://www.reddit.com/r/tifu/comments/1ax8x8/tifu_by_hugging_my_best_friend/) Anyways, it happened again with a different friend! I made a girl shit herself. In school. In the middle of the cafeteria. For the purpose of this story, lets call her Kim. I have a major crush on Kim, and her boyfriend hasn't been treating her right the past couple days. Me being the horny 17 year old virgin that I am, I've been trying to break the two of them up so I can get in her pants. In hindsight, I feel bad about myself and my actions over the past few days, but that's not what my fuck-up is about.


Today at school, my friend Kim wasn't feeling good. She had gone to the nurse 3nd period for an upset stomach and still wasn't better by lunch time. She had slept through 4rd and 5th period, and wasn't in the lunch line. She was walking to the table that we normally sit at, right in the middle of the cafeteria. I knew that she had an upset stomach. I knew that she was not in the mood to be fucked with. I do not know why I did what I did.


Kim is ***very*** ticklish. I grabbed her and tickled her. She started laughing and I caused us to get a lot of attention from the commotion in the middle of the cafeteria.
""hahahaha stop hahahaha quit hahaha stop hahaha, no. no. STop haha no! WAIT! STOP!! **STOP!!!!**""


Her eyes filled with tears and she ran out of the cafeteria as people watched and laughed. The back of her shorts were badly stained and diarrhea was running down both of her legs. It was bad, really bad. I could not believe that I fucked up so badly with a girl that I like. I leave the cafeteria and go out to the courtyard in the pouring rain so I am left alone so I can try to think about how I can apologize. The bell rings, and I am thinking about leaving and skipping the rest of the day. I come across Kim, now wearing a pair of her friends volleyball shorts, walking out of the student parking lot exit, and I make the mistake of talking to her.


I begin to say that I am sorry. She then stars into my eyes and gives me the the angriest, most intimidating glare I had ever seen. The expression on her face was pure hatred, followed by ""Go fuck yourself"" before walking to her car. I've been told a lot worse, but the way she said it was deep and burning.


I feel awful. I'm sick to my stomach. I have 3 back-to-back classes with her tomorrow. I can't begin to imagine how humiliated she feels. We have our finals tomorrow and the next day and I know that she will be there and have to put up with the ridicule of the insensitive.


TIFU",TIFU by being an inconsiderate asshole,308
wanabeswordsman,71,51,13055s,226,"It's the middle of the night and I wake up having to pee. I hate turning on a light so I can aim so I usually just kneel down in front of the toilet, flop my dick over the side of the seat, and do what I must without worrying about missing. Well, as I finished up, I put my hand on the lid to brace my attempt to stand, but my hand slipped, causing me to fall back to my knees and the lid to fall down right onto my dick.

Toilet lids are fucking heavy when they crash onto your manhood like a hammer. It's about 1/2 an hour later and it still hurts like a bitch. Couldn't sleep, thus this reddit post. Gonna take some pm painkillers and hope they help.",TIFU by peeing in complete darkness.,277
GabrielNaess,30,58,1oum5j,228,"Update for http://www.reddit.com/r/tifu/comments/1ohsku/tifu_and_stalked_a_girl_at_school_without/
(Really sorry for the late reply, had things to do).

Nothing big happened, the principal, myself and the girl and her father was sat in a room where we talked it over.
Her father thought she was overreacting terribly and I ended up getting an apology. No consequences for any of us.

As promised I let out a wet and disgusting diarreah fart mid talk.",TIFUpdate: TIFU and stalked a girl at school without realizing it.,286
tifuacomputer,96,61,147csw,232,"At work today someone had to use my computer for a minute, so I decided to use my free time trying to figure out the sound my bosses computer makes. I'm pretty sure its the harddrive but I wanted to test the fans.  

I unplugged what I thought was the fan, but now know it was actually the power supply. This is while the computer is still on btw. Computer immediately shuts off, I think wtf the fan shouldnt cause that. Realize it was the power supply. Oh shit.
  
Now the computer wont turn on and idk wtf to do.  
  
TIFU

edit: I told him I was running disk cleanup and it just shut down. I was indeed running the cleanup when it happened. I moved the hard drive to another computer and its undamaged. His computer wont power up but the on/off button is blinking like it does when its off. It just doesnt turn on at all. Am waiting for his files to be backed up before I put it back together and try again.  

  
EDIT #2: I put the hard drive back in, popped out the motherboard battery, held the power button down for a few seconds, hooked everything back up. It turned on! But.. it's only staying on for a minute before shutting off. Fans are working at least! ",TIFU my boss's computer,293
Erikster,33,99,zzhdh,226,"So I went to the Anthrax concert last night. The building was hot and humid from the bodies and the lights. Even though I found a spot that was under an A/C vent, I was still roasting.

In fact, as I type this now, I remember that A/C can contribute to dehydration by drying out the air.

Anyways, I went to bed without drinking enough water. When I woke up the next morning, my right leg cramped so hard that I started yelling with pain. My girlfriend freaked out.

Then I walked the Race for the Cure 5K...",TIFU by forgetting to rehydrate before going to bed,325
koremanmusic,50,43,vr6km,228,"I attended a networking event with a local Japanese cultural group and made various good contacts. The smorgasboard had all sorts of great food including raw oysters-one of my favorites. However, these may not have been fresh enough as within moments of consuming them I had an enormous gurgling and unsettling feeling spread through my stomach to my bowels. In the middle of a conversation with a high-ranking person in a different company, my stomach made a huge growling sound. I reacted physically in front of this person and cut off the conversation to proceed to the bathrooms. The bathrooms had a line, and I thought I could stifle a fart for relief until the line subsided. That did not succeed, however, and I ended up sharting slightly; it was enough for everyone in line to notice. Humiliation creeping in, I walked very fast (slow enough to inhibit a full evacuation) back to my wife. I had to interrupt her conversation with someone who organized the event so that we could go home. While rushing over the speed limit on the way back I suffered through the cramping with my only solace being that I would eventually get rid of this stuff in my colon. As I pulled up to our house, the pains increased exponentially. I then remembered that I had stairs and immediately went into colon panic mode. Rushing up the stairs, I considered myself home free until I realized I was wearing a belt. As I approached the toilet I fumbled with my belt and zipper and yanked my pants down whilst proceeding to squat. My bowels evacuated prematurely, though and poo (the runny type) gushed everywhere: all over my trousers, my hands, the floor, and the toilet seat with none of it getting in the toilet. I had no idea what to do as my hands were equally soiled so I just stood there helplessly while my wife came in. Fortunately, she decided to be nice and help me with the cleanup. I guess that is a sign that she loves me, regardless of how undignified I occasionally become.",TIFU: I went to a networking event and ate raw oysters.,271
JaedenStormes,75,47,1fd3f4,223,"So, I went on a trip for a few days, driving from Florida to Indianapolis and back. On the way up, I had a tire crack due to dry rot (and proceeded to drive over 900 miles with a severely left-pulling car, thinking the alignment was off.) Replacing the tire in Indy ate up most of my available funds for the spontaneous trip, and I ended up vacationing very sparsely on borrowed money.

On the way home, my car (which was pushing 100K miles) started really struggling to accelerate. It wouldn't go above 40-45 mph, even when I pushed the pedal as hard as I could. At first, I thought my little Scion was struggling with the mountainous terrain of Tennessee, but the problem persisted the whole way home, turning a 19-hour straight-through drive into a 23-hour drive and making me late (and dead tired) to work the next day.

After borrowing even MORE money, I took my car to get a basic fluid change, hoping the issue was transmission fluid or something. $40, no change. The oil change place recommended a new air filter. $30. They said it didn't look too bad, but the car was at 100K miles so I figured, better do it. Still no change. Next, they recommended a fuel filter change.

Well, the fuel filter in a Scion can only be changed by ripping out the whole seat, so off to the dealership we go. $320 and a new fuel filter later, I get a call from Mike at the dealership telling me to come pick the car up. When I arrived, this is what I was told:

""So, we changed the fuel filter out. It didn't look like it was too bad, but the car's at 100K miles so we changed it. We don't think that was your problem, as the filter wasn't very clogged. We put the whole seat assembly back together. When we did, we noticed your floormat was curled up and jammed under the gas pedal, so we pulled that out for you.""

TL;DR: Spent $400 and panicked the whole way home from a vacation to find my car wasn't accelerating because the fucking floormat was crammed under the gas pedal.
",TIFU a road trip and wasted $400 by not checking the basics,270
psqhcf,131,108,11aysf,228,"**TIFU and didn't read the rules before posting, so this is a repost with a fixed title.**

**Edit: The ""fuck up"" is that co-workers are off-limits if you don't want problems for yourself at work.**

A little over a month ago, we interviewed a new staff member for our international support office, and I was called in to interview her in Japanese because although a native Japanese she had lived overseas since childhood, and often in those cases they can't really speak or read well enough for a professional setting.

In going over her resume, I noticed that she had lived in Sweden for a few years as a child. We definitely could use a Swedish speaker, too, but nobody had planned to interview her in Swedish because they didn't know we had any Swedish speaker. And this was very cool and interesting to me personally because my grandmother was Swedish and I had spoken it with her until she died when I was about 9 years old.  So I switched from Japanese  put on my best Swedish lilt, and asked ""kan du taler svenska?""

She looked shocked, but said yes, she did. And we had a brief chat to the limit of my 30-years-ago childhood vocabulary. She kicked my ass speaking it, and was clearly fluent. I'm not, and completely exhausted my vocabulary trying not to look like a faking douche.

Long story short, as a speaker of English, Japanese, Malaysian, and Swedish, she was a great candidate for dealing with international clients and was hired about a month ago.

But during these past weeks, we've not spoken a single time. We're on separate floors, so there's not much opportunity other than the break room or when people are grouping up or lunch. But I got the impression she was avoiding me, since she would never say hello or make eye contact walking past in the halls.

But then a week or so ago, I noticed that every time I was on that floor, she would be staring at me until my gaze wandered in her direction and she would look away before I could catch her eye. And last week, she full-on blushed when I caught her staring at me while I was talking with one of her nearby colleagues.

So maybe she's avoiding me because she likes me, I thought.

It's a company tradition to have a welcome party for employees after their 30-day probationary period is up, and last night was the party for her and three other new hires. I was working late on a project and was still in the office a while after everybody else had left for the restaurant. I made a last sweep to pick up stragglers, and found only her, hunched over her phone and terminal working on some last support call.  I waited patiently for her to finish so that I could show her the way in case she didn't know the area well enough yet.

So we leave the office, barely speaking two words other than the basic functionalities and pleasantries.
As we swiped our passcards to leave the building, I realized that I had only brought my small business card/commuter pass case but not my regular wallet, and only had $20 folded up in one of its pockets for emergencies. But my apartment is about a block away from our route to the restaurant, so asked I she didn't mind if we stopped off there so I could pick up my wallet. I'm not sure I noticed it at the time, but in retrospect she looked startled--mouth agape and eyes wide--before saying ""Uh, sure, I guess.""

As we get to the building lobby, I said, ""I'll just be a minute,"" walked to the elevator and pushed the button. But she kept walking right along side me and waited for the elevator with me.  I didn't really care where she waited since I was just going to dash in, grab my wallet off the credenza, and get to the party.   So she rode  up standing just beside and behind me, quiet and demure, holding her purse with both hands down in front of her.

I opened the door and stepped in, turning on the hall light and slipping off my shoes in the entryway before heading in a few steps further to pick up my wallet.  She also stepped into the room and stood just inside the doorway for a few seconds.  My walllet was right there, but I also decided to put my briefcase away by my desk, so turned on the living room light and stepped around the corner.  

""Is that Akvavit?"" she called from the entryway. Putting down my briefcase next to the desk, I stepped backwards into the hall again to see her pointing towards the liquor cabinet in my kitchen.   

""Yes, it is.  Oh, you must know it from your time in Sweden?""   

""I love it!   It's so rare to see it here,"" she excitedly replied, while in one motion closing the door behind her, slipping off her shoes, and briskly walking into the room.  ""Oh, I'm sorry, I just wanted to see, do you mind?""

I did not.  

She reached the cabinet, took the bottle down, and said, ""Wow, this is my favorite brand; I haven't seen it in ages!"" She started to put the bottle down, then suddenly clutched it to her chest and asked, ""Do you mind if I have just a sip?  For old times?""

I gestured towards the glasses in the shelf, and she squealed like a child, carefully pouring out two shots in (for some reason) my pair of Absinthe glasses. It was a surprising sound to come out of her considering her habitually quiet manner.  ""Here, you should have some with me.""

Coming closer, I took the glass she held out to me, and stood there a few feet apart. As I started to slowly sip mine, she took hers as a shot--choking a bit as the liquid came in a sudden wash out of the bulb at the bottom of the glass. ""Oh, that is so good!""

She looked at the bottle again.   ""I'm a little nervous about the party. May I have another?""

""Of course, I'm glad you like it,"" I said as I finished mine.

She drank the second one more slowly, eyes closed, enjoying and savoring the flavor.  As she drained the last drops from the glass, she opened her eyes, looked at me, and put her left hand on my chest. ""This is so nice, thank you!""  Then she stepped forward and hugged me. And didn't let go, head against my chest.

I put my hand around her shoulder and patted her on the back. She pulled in closer against me and looked up into my eyes. Then moved her hand behind my head and closed her eyes half way, reaching up to me with her lips.

She was gorgeous. Overcome, I kissed her, and soon our hands were all over each others' bodies, pulling at buttons and blouses and tie knots. We collapsed onto the bed, and still partially clothed had amazing, exciting, and exhilarating sex-- for about 10 minutes until she said, ""Oh my God, what are we doing, we have to get to the party!  You have to come soon!  I'm almost there!!""

Arriving finally at the party 40 minutes late, I apologized for being late working on my project, and she told everyone that I had been kind enough to wait for her and show her the way to the party.  The party went completely normally, and I didn't catch her looking at me once--but she had a subtle smile and her eyes and hands lingered as we shook hands on everybody's way out when it was over.

I haven't seen her yet today.

**Update:** Ran into her in the break room accidentally on purpose, chatted briefly and exchanged info in Japanese since nobody else in the room speaks it (as far as we know).

The votes seem to be about 50/50 whether the company pier is open for fishing or not, but we'll at least meet up &amp; talk about it.","TIFU--last night, actually--and slept with a recently-hired co-worker on the way to her welcome party. ",336
foxxinsox,113,67,zjyui,227,"I decided I wanted to be a bold badass woman last week and had my head shaved last Saturday morning. Guys, I don't know if you understand, but this is a really major thing for a girl. Society has done a pretty damn good job of drilling in our heads that we need to look feminine and pretty, and hair is important to that. I decided to say ""fuck the norm"" and shave my head. Still, I couldn't bring myself to go completely bald so I had it cut down to a #3 on a pair of clippers. For context, that's about 3/8"". Still pretty damn short. Once I got over the initial freakout, I loved it.

As the week went on, I see that my hair is growing back pretty quickly. I decided to use my boyfriend's clippers to touch it up. I trimmed it and then decided I was feeling a little more bold and wanted to go shorter, to a #2 length. I took the #3 guard off, brushed some hair loose, and my boyfriend said something to me from the other room. I opened the bathroom door to hear him better, had a quick conversation, and returned to shaving my head. All it took was one pass for me to realize my error - I forgot to put the #2 guard on so I now had a reverse mohawk that was about 1/8"" long.

I freaked out and he came to see what I did. Thankfully he didn't make fun of me in any way because I was pretty close to tears. He put the #2 guard on and did the rest of my hair, hoping it would blend it a little better and not be too obvious. It didn't work. It's still really obvious, so this morning I shaved my whole head all the way down. I will now be wearing scarves and hats for a couple weeks while fighting off concern from people who think I'm sick.

TL;DR - female, shaved head to #3. Forgot to put guard on for part of it, shaved a big stripe down the front of my head, now totally shaved to a #1.",TIFU while shaving my head (female),294
HolyEdward,98,45,twxlj,225,"I'm a server. My co-worker was doing something by the counter and i had to reach above her to get a condiment. There was an empty tray in my left hand, and as i was reaching that tray toppled forward. I then pushed my hand forward as well to try and catch the tray. Seems the only thing i caught was the woman's rear end. Now she won't stop flirting with me.

EDIT: She's Fat.",TiFu: Accidentally smacked a co-workers ass,270
FrostySack,47,105,1l0dn2,223,"TL;DR - I put this up here to make you think I'm considerate.  Read the fucking story.

This happened last night but I've had some kind of paralyzing shame until now.  My brother works at a sales job and the last Friday of every month they have a big drink up at the bar near their office.  It's an open bar to pretty much anyone who says, ""oh yeah, I'm with the company.""  So I usually end up showing up and we hang out and get super drunk.  Nothing in this world feels quite as amazing as getting sloppy for free.

This night my brother and I were being our usual jackass selves to each other: one of us would go grab a round of shots and chasers (usually the High Life, we keep it classy).  And the jackassery is that we always try to get a worse shot than the last one.  So we went Jack, Don Julio, Lunazul, Wild Turkey (gobble gobble), Old Crow.  And a beer with each to boot.

It was at this point that it was my turn to go to the bar.  I order two shots of Midori, which I thought would have won the game, to which a very cute girl says, ""double fisting, huh?  Bold.""  Or something to that effect.  I give her my most dapper smile and say, ""Well God gave me two hands for a reason.""  It was around that time that my eyes made their customary once over of this girl's body, and it was a great body too, until they stopped very suddenly.

This girl only had one hand.

This girl, who I had actually met before at one of these drink ups, was born with one hand and one nub.  I stood there just shellshocked for a second and then went into Super Apologizer Mode.  I did everything short of prostrating myself in front of her.  To my incredible luck, she had lived through 28 years of this sort of thing and was a very good sport about it.  I offered to buy her a drink and that eventually diffused the tension (open bar, remember), but the rest of the night, everyone who was within earshot looked at me like I was a damn serial killer.",TIFU by taunting a disabled person,328
LumberjackBastard,15,45,1irpim,228,"I had just got out of a movie with my friend.  We were standing outside the theater chatting when I felt a sneeze coming on.  I turn around to sneeze away from my friend and at that exact moment a woman pushing a stroller came up behind me.  I sneezed all over the baby.  

Baby instantly starts crying, mother begins shouting at me, I begin apologizing profusely.  She eventually walks away and I'm left there looking like a total douche nozzle.  ",TIFU by sneezing.,273
BeenDead,21,38,1aztqr,223,"So... yea. Last night I was browsing AskReddit and that thread about the ""deep web"" came up. It sparked my curiosity, so I downloaded Tor and started browsing the forbidden land.

Anyways, it was getting pretty late and I was getting bored, so for my last destination I went to /r/SpaceDicks. I must've forgotten to shut down the browser before I went to sleep.

Fast forward 8 hours later, and I am about to hold a presentation about Online Education in front of 50 people and a professor. I connect my laptop to the projector, turn it on and... Boom.

On two large screens stood a picture of a man's dick pierced by needles and some other shit. The look of sheer horror on some of the faces will follow me for the rest of my life. I heard an old lady scream silently and I am pretty sure my professor had a minor stroke.

Like a genius that I am, I just said ""Ooops"", shut the monstrosity down and started presenting... But nobody's face changed. I imagine they are all scarred by the pierced spacedick.

Yup.",TIFU by streaming r/SpaceDicks to my class,261
Azba,63,45,19bnbr,225,"So, today (as in earlier in the week) I almost killed myself by suffocating on water vapor in my shower. Or would that be drowning? Anyway, to the story:

My bathroom is almost airtight with the door closed, with only 2 small windows (one of which is jammed) and a really, really bad extractor fan/heat lamp thing. It's so bad at its job that usually I have to have both a window open and the fan going to get an adequate amount of steam from the shower out. This day however, I was in such a rush to get clean for upcoming activities that I neglected to open the window. This was a huge mistake.

As I am getting busy with the soap after spending a long time contemplating unimportant things as I often do in the shower, I notice I'm starting to have trouble breathing. I put it down to there being too much steam in the shower box and make to turn and open the shower door - and I slip on something. BANG. Next thing I know, I'm flat on my naked ass in the corner of the shower box, and my vision's going funny - blotches of colour dancing everywhere, blacking out now and then - and I realise I'm in deep shit. The shower head's still relentlessly beating down on me with hot, steamy water, my head hurts *bad* and I'm finding it increasingly difficult to breathe.

At this point I'm taking gigantic gasping breaths trying to get enough oxygen in me, but just sucking in more steam. I felt really, really weak. Like I couldn't even move if I tried. But somehow I did. I'm not sure of what exactly happened, but evidently I made a desperate lunge for the door as my next memory is me laying face down butt naked half-out the shower door with the thing still going and me gasping like a fish out of water.

From that day forward I always, *always* made opening the window my first priority when taking a shower.

**TL;DR** I learnt the importance of good airflow in a bathroom.",TIFU by almost suffocating in the shower,270
dickblister,55,58,ucn3c,225,"As it says, we had a drunken get together, when I finally got in I thought I'd have a quick wank. My dick was obviously a little sore anyway an I've gone at it too hard.

Obviously I can't explain this to them, they'll probably just assume I have an infection (which I don't) so best to stay clear and hope I have the chance again.

FML.

UPDATE: It healed up in about 5 or so days to the point i'd be confident with it. Met up with her last night and had a great night/ morning together during which my dick performed admirably. Seeing her again soon.

Turns out [pillowplumper](http://www.reddit.com/user/pillowplumper) was right, thanks all for the advice and funny comments which made me laugh during the rather depressing evening when I turned her down!",TIFU by having to refuse a booty call because i'd blistered my dick wanking over the person who's just invited me over. The wank was after a drunken one night stand with this person.,283
l0l_cabbage,61,37,sonry,225,Never bend down then you pee with a boner :S It's better to wipe your pee later.,TIFU - Wanted to pee. Had a boner. Bended down a little bit to don't miss the toilet bowl. Peed on my face instead.,262
wergerfebt,25,83,1cnmki,224,"I'm enjoying a good ol' Italian Beef my mom cooked up, and being me, I like jalapenos and giardiniera and shit on my beef. FAST FORWARD 10 MINUTES: I finish my fantastic meal of deliciousness when I get a nose itch. I decide to wipe my hands on my jeans and give it a quick deep scratch, as I was in my room and no one was watching. FUCK UP NUMERO UNO - I got jalapeno all up in my nose. Now, this shit stung like a motherfucker. It felt as if the devil decided to go to town on my nose without buying it dinner first. I blew my nose practically 20 times to try to get the fiery demon out of my naval cavity, but to no avail. I needed something to cure this pain ASAP. FUCK UP NUMERO DOS - I squirted milk from a baby boodle into my nose to cure the pain. THE PAIN DID NOT CEASE! It merely got worse! Its 30 minutes later now, and my milky-fire-snots have not stopped!
TL;DR - I spent 5 minutes writing that shit so read it you lazy fuck!
EDIT - spelling, but fuck it. Naval, anal, boodle, poodle - you got the idea",TIFU by having nose sex with Satan without proper protection,307
NippyBiscs,18,45,15unt3,226,"I work at a sandwich shop with one of my really good friends, so naturally we're faffing about the whole time.

It's about 9 in the morning, so I tell him I have to go to the bathroom, which he replies ""I'm gonna kick the door open when you start pooping""

So there I am, sitting on the toilet in defense mode when the door just starting opening. (the lock doesn't work very well at all)

I ran to it, yelling ""HEY MOTHERFUCKER CLOSE THAT"" at the top of my lungs, and then it happened.

the door opens. there I am, staring into the eyes of an equally confused elderly man, pants around my ankles.

All I could think to do was pull my pants up and go straight to the back. where I remained for a good 5 minutes.

I don't think he'll be coming back anytime soon.","TIFU by yelling at a customer, with my pants around my ankles. ",271
SPAZZEH,154,67,ywzw4,220,,TIFU by forgetting to delete my sexual pics on my phone and opening my picture media during class,287
m0lly,78,36,u5a3t,223,"TIFU: I was messing around with her necklaces for awhile, looking at one that was half heart with ""friend"" on it...she knew I was playing with her necklaces cuz I was doing it for awhile...then I saw her locket, I thought there might be a cute picture of her and her boyfriend in it or something. It was oddly hard to open, so I worked at it for awhile and got it open. This grey powdery stuff fell out. I asked her what it was. She stared at me for a good 2 minutes, then told me that they were her mom's ashes. I said sorry about 50 times. Then she hugged me and left.
TL;DR: I was messing around with her necklaces and unknowingly pried open the locket containing her mother's ashes.",TIFU: Dumped a girl's mom's ashes...,259
Garrettmightbedead,36,97,1n2bmz,224,"This actually happened last summer so I guess Im a rule breaker.So I have been dating this girl for around for months and, I honestly thought tonight would be my first time having sex with her. So we are in this upstairs room that has a Wii and some games, one of which was legend of zelda: Skyward sword and stupid, stupid me thought it might be fun and silly if I showed her how to play this fantastic game. So after the beggining tutorial part, she gets bored and tries to snuggle up on me but alas, I try to convince her that the game gets better. She sighs and refuses so in an act of intense stupidity I decide I will at least get to the first dungeon. After an entire first dungeon and her giving obvious hints that she didn't want to watch me play some game, I am at the first boss battle: Girahim. So anyone who has played this can tell you that there is a lot of sword slashing with the Wii controller in this boss battle and, she decided she needed to go to the bathroom right as I was swinging the remote and it ended up slamming into her right eyesocket in a glorious yet, terrible way. Glorious because I had just beaten Girahim and terrible because, well you know. I fucking hit my girlfreind in the eye with a wii remote. She cried and got super pissed off and left my house while I apologized profusely. Luckily her black eye was miniscule and it was the summer so she didn't really go into town alot while her face was messed up. She ended up forgiving me but im sure still has a grudge. The worst part is after she left, instead of calling her like a good boyfreind, I sat down and played through one more dungeon.

I have been dating this girl for four months now but, at the time of the incident we had been dating for only lik 3 weeks.",TIFU by playing Zelda in front of my girlfreind.,321
uncle_tambour,10,38,1mi50d,221,"I have worked the same dead-end job for a year and a half, and recently hired on as a work-from-home tech for some DSL company. I turned in my resignation, left the old company on good terms, blah blah. Set up everything for the new job, and I was excited beyond words. This was going to be my foot in the door for advancement, this was going to be my chance to better myself, to get into the IT industry.

I was due to sign on at 8:45.

I woke up at 10:00. They have a strict zero-tolerance policy for tardiness, so I lost my job before I started.

Good news: my manager gave me my old job back. I couldn't kick my own ass any harder right now.",TIFU by getting a good night's sleep.,259
HecticHeretic,19,40,1fnt70,225,"In my house there is a cork board that is used to attach various things to (no shit its a corkboard) but at some point something had got stapled in that wasn't relevant anymore so I decided to get the staple remover to attempt to take the staples outs. Gave it a few good yanks but that staple wasn't for moving so I did what any self respecting man would do yank harder (not in that way) and the whole board pulled out of the wall causing me to hit the fridge with it, so now there are two large chunks missing from the wall where the nails went in and a dent in the fridge.


Oh and that fucking staple is still in the god damn board.",TIFU getting a staple out of a cork board.,265
MjrJWPowell,119,66,wuogb,220,"We were telling a mom about how she should check her kids internet, and reddit came up. I described r/gonewild to her and my brain mouth filter failed. I meant it as a joke. But my gf had thought that I liked the lady before this. And now my gf is super pissed. Staying low right now, and I've apologized to her (profusely but I understand she doesn't accept it right now). Sorry, I really didn't mean anything by it, ms Jones.","tifu: Told a female friend that she should post to r/gonewild with my girlfriend, who I want to marry, right next to me.",286
CyborgHippie,11,42,13jqqw,220,"I am female, and was texting my male roommate while he was at work.

I told him I was having a bad day. He said ""I'll give you a hug when I get home.""

Trying to be funny, I responded with ""Ok. Give it to me slow and hard.""

It went to my mother. Of course.",TIFU by fake sexting the wrong person,262
ncergnul,70,71,1m030j,219,"So today I looked online and everyone made it seem really simple to pop off the keys on the Macbook Pro, that I decided to do that myself to clean under them. I pop off 13 keys before I realize that they are not going back on all the way and aren't attaching to the right side. I have to take the thing into the Mac store and have new risers put under 7 keys. Those stores are expensive, by the way. Do not try to do it without the right tools!",TIFU by cleaning my Macbook keyboard,290
Pathfinder09,44,42,1colil,221,"Ok so a little background first: 

I am the head of Set Construction/ Running Crew for my school's technical theater club. Right now we are building the set for Chicago:The Musical. We have these things called ""flys"", which are weighted ropes that control bars running across the ceiling of the stage which we use to hang things from. 

Back to the Fuck up:

 There is a huge screen that the school usually uses for various assemblies as a projection screen for power points, presentations, etc.. We had to take the screen off to use the bar for our Proscenium, or border surrounding the stage. Anyways, we get to the rope and it is incredibly weighted, making it difficult to lower and nearly impossible to raise. It took 2 grown men plus 4 high school students just to get it all the way to the ground. Once we get the screen off, everyone else begins to attach the border to the bar. My genius self thinks ""Oh, let me raise the bar to get it out of their way."" So I walk over to the lock which is holding the bar in place, unlock it, grab hold of the rope, and immediately shoot 20 feet into the air. I am literally dangling 2 stories up on nothing but a rope. My friends rush over to help lower the rope I was hanging on and get me down safely, but my hand got wicked ropeburn from me gripping the rope so tightly:


http://imgur.com/qTqcZpc [1]


TL;DR - Ended up being suspended 20 feet in the air, holding on to a rope for dear life.",TIFU by accidentally flying 20 feet in the air.,263
OneagainstOne,58,45,ythht,220,"Whenever I get absolutely shitfaced I tend to sleep walk. Last night while sleepwalking drunk I managed to enter my girlfriend's study, get on her work chair and piss all over her laptop. Needles to say she is **PISSED.**",TIFU by pissing on my girlfriend's laptop while drunk.,265
b0w3n,70,24,qkdy6,222, title says it all,I went to fart discreetly at my desk at work.  I shit my pants and stained the chair.,246
KaiserInch,45,48,10j176,219,"I took my girlfriend to a pizza buffet, being the classy guy I am. It's swamped with loud black people, so I take this opportunity to let the stereotypes in my mind run wild. I wont try to justify it - I'm just a bitter person who can't see past my own small world. 

Me and my girlfriend normally play a game as we leave restaurants; We buy gumballs and attempt to guess what color we're going to get. I reached in my pocket to do this, but we weren't able this time, because a large unattended group of black children were climbing all over and around the machine. In my frustration I say ""Looks like we can't guess today, too damn many little monkeys are in the way.""

We walk out of the restaurant and start to the car. The door flies open and this black guy walks out. ""Hey! HEY MAN!"" I turn around around and see this thug marching towards me. He's got the doo-rag on, a wife beater, and he's pulling up his sagging pants while he continues to walk to me.

I thought to myself ""Guess he heard what I said and didn't like it."" I was already in a foul mood, so I'm ready to escalate the situation. I start walking to him, mentally psyching myself for a fight.

Before I can say a word he holds a hand up to me. ""Sir! You dropped your money inside!"" I look at his hand to see a crumpled dollar bill. I had carelessly pulled it out of my pocket while trying to get change for the gumball machine. This completely shatters my mind. I had built up this elaborate structure of anger and hate, only to have it come crashing down around me because this guy went out of his way to be honest and show another human being compassion and kindness. He could have thought ""Nobody will miss a dollar, mine now!"" but didn't.
I was so taken about I couldn't even thank him properly. ""That... that was real good of you, man. T..Thank you so much.""
The only way I can relate how low I felt after this is to say I didn't even mind my girlfriend berating me and telling me about how that ""goes to show you.""

**TL;DR - My extremely racist comments and attitude were shoved in back in my face because of incredibly nice and honest black guy.**",TIFU by being stupidly and profoundly racist.,267
AaronSarm,80,184,1ocy31,221,"Yesterday we went to a swingers party at a friend's house.  The whole afternoon was filled with naked swimming and soaking in the hot tub.  Lots of drinking as well.  So, as it got darker and we got drunker, things turned more sexual.  My gf and I were sitting in the hot tub with three other couples, one of whom were our good friends (John and Jane) that we've never ""played"" with, but have hung out with at several parties.  Jane and I dance together at parties and I've played with her boobs and we've kissed some, but that's it.  My girl friend got up to go pee and John and Jane were making out across from me.  Jane's leg was sort of laying across mine, so I was stroking it while she and John were messing around.  She gave John and blowjob and then turned to me.  Needless to say, my girlfriend walked up on us and flipped out.  Now we can never hang out with John and Jane again, which is sad, because I really enjoyed them.  My girlfriend blames her for everything, even though I explained that Jane asked me if my girl friend would be okay with it, and my alcohol-dulled, sexually aroused man logic figured it wasn't that big of a deal.


EDIT: Okay so I'm just going to answer some of the questions here instead of replying to each comment. I'm also going to give my gf a name: Jill.  We've been together for four years and have been swinging during that whole time just about.  It was a new experience for both of us.  We are unofficially engaged (i.e. no ring).  We have done everything there is to do as swingers, fully swapping in different rooms on numerous occasions, though we both agree it is more fun to do it together in the same room.  Our one stated rule, up until now, was that we always swing together, which means that we don't go to parties single and we don't sneak off while at the party with other people.  In my mind, because it was in front of John and in the tub in the common area, it would be okay.  Also there was a similar but reversed incident at another party that made me feel like it was okay to continue without her.  At another party there was a whole group of us that made plans for one of the bedrooms, but I had to go pee.  By the time I got to the bedroom everyone was in full swing including her, and I just joined right in.  It was no big deal.

As someone mentioned, sometimes one member of a swinging couple will not like certain people and set them off  limits for their SO, and that's fine.  Jill said that she felt betrayed by Jane because John and Jane had always presented themselves as mainly/only looking for bisexual women for Jane to play with.  Jill is straight, so that's why we had never done anything with them other than flirt and dance.  In dancing and playing around with Jane, I had concluded that Jane also wanted men (she certainly acted like she wanted me), but that John may have been reticent about full swap.  I had shared those thoughts with Jill before because of the way Jane had acted towards me.  I guess Jill did not believe me.

The real ball gnawer here is that after everything went down last night, Jill told me she had planned to make out with Jane in the hot tub that night and possibly some of the other women until I fucked it up.  I would totally give the incomplete blow job back for that. ",TIFU by agreeing to a blowjob while my gf went to pee.,405
thedirtyspatula,71,57,1k3gu0,216,"I was at a park that had a festival going on to support cyclists, I was by myself looking for a place to smoke from my dugout. I wanted to be somewhat hidden so while the area was packed there was a gap in between which looked to me like a great little place to sneak a toke. I go over to the spot and sit down, AAANND I get caught up in the blackberry bushes thorny branches. ""No big deal."" I say to myself whipping out my pocket knife. I swiped twice at the branch as I sat, it was cutting but not enough so the branch was just getting stuck to me. Then I swiped at it again with force, so much force that I cut through the branch and stabbed myself in the top of my knee. The blade went in half an inch into my kneecap. Never have I felt this stupid, luckily the festival had a medic on site so I go down get cleaned up and walk it off. 

Next day

""OH MY GOD WHY DOES THIS HURT SO FUCKING BADLY???"" I attempt to get up out of my bed and as I stand, it felt as if there was a sword in my kneecap, nearly bringing me to tears. Knee injuries are nothing to joke about, thought they were but they are not. Every time I have to sit or stand my leg has to be straight out or it's excruciating. 

Tried to be stealth, ended up not being able to use my legs for now.",Today I fucked up by stabbing myself in the leg with a knife.,273
illdrawyourface,49,43,175dck,217,"Fuck it, no throwaway. 
Just got back from work and literally sprinted into the bathroom. Sat down to pee and I had to go so bad that the stream of pee went right out of the space between the seat and the bowl. It sprayed all over my underwear, pants, and somehow ricocheted upwards onto my legs. Fuck.

Edited because repeated word",TIFU and waited too long to pee. ,260
bigDean636,40,60,1597a6,215,"My girlfriend and I had lunch at a restaurant. She ordered a shake and when he brought it, it had a cherry on top. I asked the waiter if they had any cherries with the stem still attached. He said no, and I told him that she could tie a cherry stem into a knot in her mouth. My girlfriend's face turned beat red and the waiter seemed a bit flustered as he walked away.

Apparently that implies a girl gives good oral sex. I had never heard this before. 

She does, by the way.",TIFU by implying to a waiter that my girlfriend gives good oral sex,275
Carver_Descartes,121,218,1bwb69,215,"So I find a guy on Grindr, we meet up. He's a little bit older than he said he was, but plenty fuckable, so we proceed. 

We get back to his place, all is going very well. After about half an hour of fun, I'm giving him head, and all of the sudden a weird taste comes. I look down (I was on top) and his thing is all bloody, and I'm like WHAT THE FUCK HAVE I DONE¿?¡!

He says that this has happened before, no big deal. He used a word to describe his ""condition"" let's say, but he's speaking in Spanish (I'm Canadian, but living in Spain now) and I don't understand the medical terminology I suppose. 

Then I feel something weird in my mouth, and it's a little piece of skin from his funstick. 

We're going to pick things up again when his member has heeled.

**EDIT**: I thought I should clarify some things:

I speak Spanish, I just didn't know the word *frenulum*, which I now know is frenillo. So I that's what he tore. 

Thanks for your concern about my health everyone. 

For those of you who think that I'm making it up, go suck a dick.",TIFU by sucking off a piece of a guy's dick,433
Ratay151,88,60,13cclc,218,"A little back story. It all started on Wednesday when an African American male (this is important) was asking me a question. I work in a factory so it's very hard to hear what someone is telling you without asking them to repeat it several times. The guys is already really quiet so after asking him to repeat himself like 5 times I gave up and just started smiling at laughing at him because I assumed he was just telling me a story. Fast forward to today when I went into work and he was acting all weird around me. He pulled me to the side and said, ""You know, I was being serious when I asked you for your number and you just laughed in my face."" I was mortified, Reddit. I just looked at him and said, ""Is that what you were asking?..."" He just kind of looked at me and said, ""Is it because I'm black? Are you not into that?"" So now I look like I'm racist and after all that, I did not give him my number. This is not because I'm a total bitch, but I'm in a happily committed relationship...which he knows. 
So yeah, I laughed in the face of the a guy who worked up the courage to ask me for my number. Good times.",TIFU by laughing in the face of a guy who asked me for my number.,278
SEGnosis,32,102,1cd1s7,217,,"TIFU by writing and submitting a 1,600 word paper when only a 2 paragraph outline was due",319
administrator_,59,50,1b89dl,215,"Today, I tried writing a PHP link shortner (I'm really bad at PHP), and because I forgot to tell a loop to stop, and because I messed up using the `chdir` function, I had to deal with 50,000 empty folders in my `C:\` drive.

[Here's a picture of quite a few of them.](http://i.imgur.com/J6lNMGA.jpg)

","TIFU by making 50,000 folders in my C: drive",265
[deleted],87,50,12uor3,216,"Ok, I know there have been a few genital mutilation stories on here and rather than bring something fresh to the subreddit I though ""hey, why not share mine?""

This actually happened a little while ago - I got horrendously drunk and came back to my uni dorm with a girl I'd been seeing and she came to my room. Sexy times were a rollin' and I was all like ""fuck yeah"" etc but in my haste I hadn't really pre-heated the oven so to speak.

So I sling my schlong in her and immediately it feels weird. It's warmer than usual and it just felt a little uncomfortable. I look at her and she seems ok so I think whatevs and keep ploughing, not really feeling much due to whiskey-dick.

In the morning I wake up and she's gone and when I pull back the cover I see all this blood on my sheets and think ""urgh man, no wonder she went, she got period juice all over my bed.""

So anyway I get up and got in the shower. I've not had the chop and being a clean guy, I wash my bellend every day. So I pull my foreskin back and...

...well you know in the movies where someone is in excruciating pain, screaming their head off? And the camera cuts to a picture of the block, town, country, planet - all the while you can hear screaming? That's what it was like. I snapped my damn fucking banjo string and the soap and hot water combined confirmed it beyond any doubt.

So yeah TIFU by ripping my fucking dick off.

TL/DR - No foreplay + no lube = Stitches in ya Johnson",TIFU by ripping my Banjo String,266
[deleted],69,58,12cjay,216,"So, to be clear I am in no way racist. one of my friends is racist and wrote ""nigger"" on my windshield this weekend when everyone piled in my car and it steamed up. Well it wasn't steamed up until my friend got in the car this morning. He climbs in, we start driving and then BAM its really huge across the window and its too late. My hear sank and I froze. 

He didn't say anything, and I'm not sure what to do. We met two days ago, when he began working at my place of employment. Please Reddit for the love of all that is holy, help me. What do I say tonight when I go into work? I feel like dying.

Also, I'm a woman, it was a guy. I don't know if that changes anything, making it worse or what but help me.

EDIT: ALRIGHT, let me explain further. They are not MY friends who piled in the car. They were a bunch of friends of my boyfriend, who I was just meeting for the first time because him and I started dating about a week ago. SO we piled in the car to smoke a bowl, commence the rude writings on my windows. I bitched him out about it and I'm not going back to their parties.","TIFU by offering an incredibly nice African American gentleman a ride home from work, forgetting that this past weekend a huge group of friends climbed into my car during a party, and someone wrote an incredibly racist word on the wind shield.",274
Frylok1177,44,22,125nmu,216,I work for an automotive repair shop and while bringing in a car knowing that it had no brake pedal at all because of a rusted brake line I was using the E brake to drive it in.Theres a little bump on the lifts at work so I gave the car a little bit of gas just to cripple it over the bump and when the cars front tires went over the bump I pressed the E brake harder to stop. WELL the cable SNAPPED and the car kept going forward with my boss in front of the car. She saw the car and before it was to late she got crushed in between the car and a tool box. Her pelvis is broken in 3 places and she will be out of work for 5+ months. ,TIFU by crushing my boss with a car.,238
Lag5pike,33,52,1nxwrz,213,"This happened like 30seconds ago.

So i felt bored today, so i took a few bong hits throughout the day.
When bedtime came, i totally felt in the mood for a good old boxing match with mister D.

Twelve seconds later I was fapping away like a god to my new brazzers account, but as high as I was I did not prepare for the finale. I used lube to fap with so it got pretty messy (anything to make it better).      Normally i would have had tissues ready but today i was a lazy asshole, (as always).

Done.

I looked around. I really needed to clean this shit up, but i was too tired and the bed was two feet away. So what do i do?

I decided to wipe the scene with a fucking page from a magazine. 
It cleaned up the mess pretty good, so i thought i might as well use it as a dick-cleaner as well.

BRILLIANT

When i started fixing up the mess downstairs i instanly felt a sharp pain in my dong.
I pull the paper away, red. Blood everywhere, it looked like satans dick.

My god, i am sitting here almost crying with a band-aid on my penis.
Please god save me from myself

Tl;Dr - Weed, fapping and blood. Read the story, it's not that long ;)

-sorry for any spelling errors, english is not my first language

EDIT: I forgot to mention, this is actually my very first post on reddit, amazing with such response :)",TIFU by papercutting my dick (NSFW),265
smellyhookercunt,25,38,14gicl,217,"Okay, so this happened like 5 years years ago and I wasn't able to put the pieces together until now. 

I was rummaging through my parents bedroom looking for porn, as I knew my dad had some DVD's stashed in his dresser drawer. I was too afraid to use the internet in fear of leaving history behind. As a girl who didn't watch a lot of porn, I didn't know how to delete the history, and did not want to risk it. I came across one DVD that was just blank and had nothing on it. Curious, I put it in the DVD player and it was a homemade porn with some red headed girl in it. The video never showed the mans face, but he was hairy. I remember I turned it off because it was too fucking boring to watch.

For some reason this afternoon my mind decided to take me back to this day. It all makes sense now...the hairy man in the video? My dad. The red head? The girl he had been cheating on my mother with from his work. (She found out) ....But yeah I tried to masturbate to my fucking dad and I feel like a sick piece of shit. ","TIFU by remembering something really, really awful.",255
K_X,41,60,1b59xg,210,"This happened a couple days ago, but whatever.

Saturday night, eating dinner with the gf, feeling randy, and know I'm gonna get some tonight, I can just tell.

Finish dinner, it's her friends birthday so she wants to go to a bar but I'm exhausted from drinking all night with my friends the night before, so she goes drinking and I wait up for her, buy myself a couple Old E's in tall cans and pass the time on reddit.

She gets home, sexytime commences.

All sorts of positions, all over the room, best lay I've had in a few weeks for sure.  I have her laying down facing me on the bed, I'm standing off the bed and her legs are over my head.

Feel the climax coming, so I get ready to pull out. I've been playing a game where I try to hit her in the tits, neck, or face with my cum--which I did that night, but for all the wrong reasons. 

I pull out, and she moves her legs a bit and I sort of lose my grip/collapse because I'm, you know...

BANG. Searing pain in my oldboy, and there's no cum yet.  I quickly push myself off of her and shoot the farthest cum ever.  Like, all the way over her head.  I had temporarily, for like 2 seconds, blocked all my semen from coming out because when I collapsed, I pushed my Chuck Berry right into her pubic bone, which cut off the flow.

Temporary pain is gone, we fall asleep, but the next morning when I get up to pee, I experience, hands down, the worst pain in my life.  Imagine razor blades being forced down your urethra (some of you sick fucks probably do this for fun) while you unless a hot stream of post-coital piss.  I couldn't stand up after my pee, and when I looked at my Leadbelly, it looked like Blind Willie McTell. 

Swollen tip, head, sides, everything. Awful.  This continued for a few days until I went to see the urologist.  I wasn't about to go to the ER on Sunday in New York City to wait in line for 4 hours and get some sass from a resident who didn't give two fucks about my broken dick and not give me anything to ease the pain.

Go to urologist yesterday, he's like ""Dude, you traumatized your urethra. Take a urinary analgesic, they sell 'em over the counter.""

So I did that, and now I wait.  The pain is subsiding with each piss, but my piss is bright orange and kind of syrupy looking when it hits the water. I don't care though, I feel better, and more like a normal person who doesn't scream and almost cry when he pees.

tl;dr: I almost broke the neck on Roy Orbison's gibbo.

Edit: Who's gonna start /r/nydadb (naming your dick after dead bluesmen)?",TIFU by traumatizing my urethra.,270
TheBirdKevin,21,125,1mbzgj,213,"So I was chillin in my room upstairs pulling off a quickie when the phone rings. I let it ring but my parents watching tv downstairs were being lazy and wouldn't answer it. I figured what the hell ill just do it. It turned out to be my grandma who wanted to ""chat"" with my mom. I yell downstairs for her to pick up the phone and go to hang up the one I was using. Now here's the screw up. Our cordless phones are screwy and sometimes they don't listen, so I thought I had hung up, but our phone chose not to and my mom and grandma heard me masturbating furiously upstairs through the screwy phone. ",TIFU by pulling a quickie and answering the phone,338
Advancedphish,33,54,1eo2ay,213,"So hungry, the pizza looked so good. I had managed to cook it perfectly and rushed to get a 400° (F) slice of awesome in my tummy. Instead I got it ON my tummy as well as my thigh. It actually pulled skin off of my thigh and it looks like I'm icing my vagina.

So much hurt.",TIFU by eating pizza while nude.,267
sorryemporioarmani,14,53,1caqm7,213,"Sorry for whoever has to reset the counter for how many days we can go without one of us shitting ourselves. I never thought it would happen to me. 

I was feeling in a shitty mood today, I was hungover and smoked a lot of weed last night. I was really hungry and wanted food but I was too tired to cook. A magnificent idea came to me-- let me to go the local 24/7 deli that serves amazing sandwiches! Hmm. What to get. Waffle fries with honey mustard. And a sandwich-- chicken cutlet, swiss cheese, onion rings, barbecue sauce on a hero that's been toasted with garlic butter. Yummmm right?

My stomach didn't think so. I immediately had these terrible pangs in my abdomen. I used the bathroom, but nothing. Maybe it was just gas. 

Oh was I wrong.

See, in a matter of 10 minutes 3 firetrucks made their way to my block. They busted open a hydrant, and all of the other neighbors like us, who didn't have a clear line of sight to what the fuck was going on down the block from their windows, got out of their houses. 

I was standing by my doorway when I felt this whirring in my stomach.

WAS IT GAS? This was going to smell so fucking bad for how much it hurt.


I thought it was going to be a fart. But no. My no-no spot exploded. And I felt it. Immeditely all I could think to do was unzip my leggings before they would be soiled. I had them unbuttoned and unzipped around my hips. 

It was like my stomach giving me the biggest fuck you ever. Like hey you didn't just take a nice long shower, no definitely not. You didn't get all pretty for your boyfriend, fuck him. You know what you're going to be doing tonight? You're going to be washing YELLOW DIARRHEA out of your fucking emporio armani underwear and your diesel jeggings. And why? Because fuck you, I'm a princess bitch, I get what I want.

Then an obstacle, that could have ONLY spawned from the very depths of hell revealed itself: my staircase.

I was holding in the rest of what ungodly matter was dying to escape my body with all the muscles I had, while at the same time, I was hopping up the stairs. You can see where this can go bad, because I missed a step and tripped. 

I can't even explain what happened because at the moment I'm trying to repress what the fuck just happened. 

Long story short, I'm cleaning shitpiss off of my staircase. 

My boyfriend is going to be here in less than a half hour and it smells terrible. I don't even.. Fuck.

TLDR; ate food that didn't agree with stomach, tripped and had diarrhea all over staircase.",TIFU by soiling a pair of expensive underwear and leggings.,266
fdup_throw,65,82,1482r0,213,"Well, last night anyway. I got a phone call from a friend of mine, a girl that's I've known for about four years now. We've had the ""playful banter"" thing going on ever since we met... but she's been married for almost 20 years and almost 10 years older than I am, so neither one of us ever came close to crossing any kind of line, let alone talking about the state of her marriage. In fact, the bulk of our ""relationship"" involves texting the other person when we're about to eat something appetizing for lunch or dinner with a picture of the meal and a caption like ""glad you're not here to ruin this for me.""

Last night, I got a phone call from her. She's been to an event and got drafted to do a little amateur bartending. I was also out, separately, and had had a bit to drink myself. She tells me that I should roust myself out of bed because she's stopping by. She says she's sick of making drinks and knows she can drink my alcohol for free. This is banter and we've spent time, alone, at my place before without anything even remotely happening. When I tell her I'm out, she says ""ok, I'll wait. But hurry, I have to pee."" You'll wait? Not to distribute blame here because I did the kissing (we're getting to it, I promise), but why would you call me up to come over and then wait for me to get home? Oh, yes, alcohol. It doesn't lead to good decision making. But she's not a lightweight or a lush, so I head towards my place.

When I get there, she's about as sober as I am and we end up on my couch, first drinking bourbon, then port (does that even matter?). She's telling me tales of how, when she was in college, she got revenge on an ex-boyfriend by picking up the girl he left her for, fucking that girl, and then dumping her. Again, alarm bells should have been ringing. They weren't. I'm dumb. Then she's joking about her bra, how it's more of a sports bra and clasps in the front and how un-sexy that is. And I'm idiotically playing around as though I'm trying to figure out how to unclasp it. Her head ends up, non-sexually, in my lap a couple of times, and then I'm stroking her upper back and giving her a backrub. This seemed like a good idea at the time. It wasn't. I am dumb.

Eventually, I lean in (yes, I'm the asshole) and she says ""no, no, we shouldn't"" but I kiss her lightly anyway... and then she's mostly on top of me and her tongue is down my throat. It's 15 seconds of a very  heavy kiss. Then she pulls back and says ""oh god, what have I done!"" and bolts for the door. She's drunker than when she came in, and my thoughts are ""I'm an asshole for that"" and ""shit, she shouldn't be driving."" I follow her out the door and catch up to her on the front walk. I say ""you shouldn't be driving, you might..."" and then she's in my arms, sobbing. ""Oh, he'll hate me forever, I can't believe I did that, what was I thinking?"" I'm trying to calm her down and doing a decent job, for a second.

Then I make another mistake. My thoughts were, get her calmed down, get her keys, call her a cab. But I say ""ok, wait, just come back in for a second so you can collect yourself"" and it hits me that that was exactly the wrong thing to say, it sounds like I'm trying to get her to do... something. She picks up on that too, apparently, because she bolts at that moment, sprinting for her car. I follow, but she's already in the car when I get there, frantically backing it out of her parking space. She almost hits an on-coming car, avoids me, and speeds away.

Later, I get a few texts from her. I'd tried to call so I at least know she's going to make it home or to confirm which ditch she's crashed into, but she hasn't answered and I'm worried. The first one says ""He's checking AT&amp;T to see who's calling so don't."" I assume this means her husband, but he wouldn't know anything unless she's told him. Then I get ""I am stupid"" followed by ""This is my fault and I hope you forgive me."" I don't even know what to say at this point, first I'm thinking her husband is coming to kill me and now I'm thinking that it's not her fault, it's MY fault. I don't respond.

About 30 minutes later, I get ""I am sorry about tonight. All my fault. I will return your books and delete your number."" She's borrowed a few books from me, but at this point they're the least of my worries. I finally respond and say ""Can I text you? As in, will you listen to anything I say? A) you are not stupid, please stop saying that B) why are you saying anything is your fault?"" 

I get no response. This was last night, about 11pm. I have heard nothing from her since and I don't expect to. Strangely, if she did tell her husband, he and I are still friends on Facebook. She doesn't have an account as of last year, but that had nothing to do with any drama, as far as I know. So, I fucked up by not just kissing a married woman, but also costing myself a very good friend. And I failed to mention her husband was formerly in the military, so I might end up a friendless, married-woman-kissing asshole who has been beaten to a bloody pulp. 

**TL;DR: A married female friend of mine came over last night. I should have sent her home. Instead, I made out with her, which led to her having an attack of conscience and running out the door to tell her ex-military husband about it. So I'm not just an asshole, now I might die.**

Edit: I've replied to most of you in another wall of text, it's somewhere down there...",TIFU by making out with a married friend,295
GOB224,22,18,r48v6,213,"A few college friends and I drove from Massachusetts to Tennessee to camp in the smokey mountains. After about 20 hours of driving, we arrive and unpack to find that the tent was still at home.

We ended up buying one but it leaked in the rain so we slept in the car

Edit: Oh by the way, the  next day we saw a double rainbow. all the way across the sky.  No lie.",TIFU by driving 20+ hours to go camping and forgetting my tent.,231
open_your_heart,40,49,1lljos,211,"I was off work and it was very late. All my roommates had gone to bed and it was just me up. I was reading a spiritual philosophy book by a guru named Ram Das and he was talking about peeling off the layers of consciousness and being truly naked. I finished reading this and decided to take a cold shower. I hopped in the shower and began pondering what this meant to be truly naked. 


We are rarely naked in today’s world. The only time we are really in our natural form is when we are bathing or changing clothes. I got out of the shower and decided to walk into the living room and look at the stars for a short minute when I got the idea (thinking it would be good for mental health) to do it naked. I walked into the living room where it was very dark, and I was butt naked. I stood there for about a minute, hands on my hips, legs spread, pondering life, and the meaning of reality when a light turned on. No, sadly not a mental light, a real light…. ""Oh my god"". 


There was a breathy gasp as my poor poor poor roommate flipped on the light for a late night trip to the bathroom where she found a naked man starring up at the sky in what had previously been total darkness.  I don’t think I have ever been so embarrassed in my life. I threw a towel around my waist as fast as I could and immediately began apologizing but this was not before blurting out like a loony wide eyed, cult crazed follower “I'm so sorry! It was supposed to be like a spiritual experience!!!” 


She used the restroom while I sat on the couch. My head in my hands more embarrassed then I have ever been in a long time. She walked out of the bathroom and again I began apologizing, she laughed and patted me on the shoulder saying that it was Ok but that hasn't made it any better. 


To make things slightly more awkward she is 40, I am 20. 


TLDR: Wear a towel.


","TIFU by trying to be spiritually ""awake"" (NSFW)",260
Jelly_sandals,22,56,1kvfbu,212,"This morning, I walked into my bathroom to see the toilet filled to the brim with brown water... definitely a clog. I began the plunger-ing process, inadvertently spraying water all over the toilet seat and floor. When I was done, I grabbed a wash cloth that was nearby and wiped up the water then threw the towel on top of my laundry pile. I took a shower. Got out of the shower. I saw in the mirror that I had some extra face wash on my face, so I *accidentally grabbed the shit rag* from the top of the laundry pile and put it on my face. The minute I smelled that rag, I knew.


tl;dr: I had to take two showers this morning because I wiped my face with a rag covered in shit water.",TIFU by drying my face with the toilet rag.,268
bankergoesrawrr,19,55,1kkqgz,211,"This happened some time ago but my friend suggested I post it here.

So I have this nervous habit of picking on things. Usually I'd chew off my fingernails first, then start picking on my cuticles, and then I'll pick on whatever's nearby.

That day, I had a client that had a multi-million dollar deal happening, and they needed my bank to provide the bid bond (basically a statement from the bank saying they have a certain amount of money locked up, that the government can take if the company fails to meet their obligations) to the government. If they don't win this deal, they pretty much have to stop operations in the country I was in. They're long time contractors of the government so it's a sure win, they just needed the bid bond as a formality. Since it's a big deal, they've asked about it for over a month.

Somehow, tons of fuck ups happen culminating with the biggest one on the day we had to issue the bid bond. There's only ONE person in Operations (the other people were sick &amp; on compliance leave) who could approve it and he went for a long lunch. The bid bond had to be submitted by 2pm. At 1pm, the guy still cannot be reached.

My douche boss freaked out and ran off, going, ""Oh, you're a sweet, young thing. They won't yell at you. So you deal with it? Ok, bye!""

He then proceeded to ignore everyone's phone calls so it's just me trying to calm everyone down. I had the local CEO, local CFO, Regional CEO &amp; Regional CFO calling me nonstop. The 2 Finance Managers were with me, waiting outside out Operations department. I realized I may not be such a shitty banker after all when my bullshitting skills came out. Our conversation went something like:

Client: Why is it taking so long??

Me: Ah, you see, since we did not receive the telex, our Operations department have to type the entire thing from scratch.

Client: We gave you the soft copy!

Me: We thought that would work, but turns out the system doesn't allow copy pasted text, so someone in operations has to retype the entire thing.

Client: Oh my god...you're one of the world's largest bank and this is what your operations have to put up with? I feel so bad for them.

Me: Me too, so let's be nice to them.

*20 minutes later*

Client: Can you check what's going on? It's been 20 minutes and it can't take that long to type up one page...

Me: Bad news, the guy typing it up made a typo so we have to backspace all the way to the typo and retype the entire thing.

Client: What.

Me: Yes, it's time for a system upgrade. Don't worry, I've asked my legal team to be on standby to check on the typing to make sure there are no more typos.

Client: Oh my god, thank you so much!


As you can see, the bullshit I was coming up with was incredible. Obviously I was trying not to shit bricks while maintaining a calm front. I chewed off all my nails already and picked my cuticles until my fingers were bloody. 

Unfortunately, I noticed a loose string on my skirt and started twirling it around my fingers nervously while I kept chatting and joking with my clients trying to pretend everything's fine.

Then I heard the string snap. I looked down quickly but everything looked fine. 

The bid bond finally got approved and I got up to collect it. As I kept walking, I noticed it kept getting breezier. That's when I noticed the slit on my dress kept getting wider and higher. By the time I saw my clients off, it was up to my waist. Luckily, it stopped there and my clients didn't notice since they were too busy trying to rush off to deliver the bid bond. 

I spent the entire day holding my dress together with paper clips. 

Some comments I got:

""I knew I made the right decision leaving you with them."" /sleazy wink - The douche boss

""Congratulations on your upcoming promotion!""

""Wow....I didn't realize this is the service your bank provides...""

""So this is why your clients like you...""

""Gentlemen, this is true dedication right here. So next time [this infamous creepy, super horny middle aged female CFO of a very large, multinational company] has a deal, one of you need to one up this and take one for the team. Just close your eyes and imagine you're somewhere far away...""",TIFU by accidentally stripping myself,266
humiliatedd,130,57,13d5vx,216,"It wouldn't be a big deal really, but a few things make it horrible. Her family has done an insane amount of nice things for me. I just moved 700 miles away from my family with her (she's my best friend), and they have taken me in as another daughter.

She and her mom were sleeping in her room across the hall from mine, and her aunt and cousin were sleeping in the living room. 

Anyway, I wake up to this text this morning: ""Just so you know, we all heard you and ____ last night. It was extremely awkward and disrespectful. I would never do that to you and your family.""

So, needless to say, I feel like shit. I'm humiliated and embarrassed and ashamed, and I don't know what to do. I apologized and she said she didn't want to talk about it and that she was embarrassed. It would have been fine if she had just said, ""Hey fucker, I heard you boning ___ last night. You're disgusting. Next time be quieter. Love you"" ...but as it stands, I feel like I've lost their respect and done an extremely shitty job of showing them how much they mean to me. 

:( If anyone wants to cheer me up, please do.

**EDIT** for clarity: I actually wasn't expecting to get so much feedback, and I need to clarify (and I apologize for simplifying) - the aunt and cousin aren't actually blood relatives. It's my best friend's mom's best friend and her daughter (I think you can see why I decided to simplify it). I am 24; roommate is 22; ""cousin"" girl (my roommate refers to her as ""sister,"" ""friend,"" or ""cousin"" at any given time, as they have been around each other constantly since birth) is 25; roommates mom and roommate's mom's best friend are both in their mid-50s or so. This occurred in the apartment where my roommate and I live and split rent together. My roommate's mom, mom's best friend, and mom's best friend's daughter were visiting. 

I would like to thank everyone for their kind words. The thing is, I *did* do something -- not ""wrong"" exactly, but offensive (I guess that's the right word). I'm not looking for anyone to say, ""They're overreacting"" or ""You did nothing wrong"" (thank you for those of you who said those things anyway in an effort to cheer me up - you have all helped tremendously). I just needed to get it off my chest, and you guys helped to shed some light on the situation and make me feel better. Thank you. &lt;3",TIFU - my roommate and her family heard me having sex. ,273
[deleted],43,41,zeka7,212,"I give out the GED Test and one of the rules is that you can't leave during the test, or it will be picked up at whatever point you stopped at. 

Well, in a session last month a guy (let's call him Stan) had some stomach problems and needed to go. I explained to him about leaving and me having to take his test up. He agreed to stay. 

A few minutes later, he came back up to the front and told me it was too much and he had to go. I told him the next testing date and he left. 

Fast forward to today. Stan is back for the subject that he missed the first time I saw him. I started the test and there were two students who showed up late. I'm fairly lenient, so I go out of the testing room to explain to them the rules about the test. They had less time then everyone else, but it was a non-issue. the real issue was what happened next. 

I was filling out paperwork for the rest of the GED subjects amd I periodically looked around to see if anyone needed something. One of the girls needed a pen, so I told her to come up to the front to get one. She was pregnant, which may or may not be relevant to the story. Anyhow, I go back to working on papers. 

As a student was turning in their test and left the room, I notice another one coming in. The same girl that asked for a pen was now sitting back down, only this time she had a handful of tissue. I confronted her and she confessed to leaving the room. I told her next time to let me know what she needed because she could not leave during the test (something I confess to NOT) telling her beforehand as I was rushing her in from being late.

Remember Stan? He turns around and is shocked, and gives me a WTF? type glance before continuing his test. He completed his test and left. After the test my manager called me in her office and told me Stan made a big fuss about what happened earlier. 

Apparently, at another testing session he went to, the proctor allowed one person to leave the room at a time. I usually asked before the test if anyone needed to use the bathroom. Now, my manager has to decide whether or not to invalidate the young woman's test, or to appease Stan in some way. Either way, my lack of attention to detail put her on the backburner. 

Reddit, TIFU. ",TIFU someone's testing situation for the GED Exam.,253
Estranged_Noodle,37,34,u3w2a,213,,"TIFU: I'm severely lactose-intolerant, got super fucked up this afternoon at a work party, and my colleagues ended up convincing me to drink unpasteurized yogurt. I'm now shitting snow-white while wrenching in constant, agonizing pain",247
wintertash,33,70,1kqq9a,210,"I'm a blogger and associate editor for one of the big LGBT politics &amp; culture blogs. Yesterday I published a post about the hashtag #fuckcispeople trending on Twitter, and it ended up being the last post of the day. 

Now, our style guide says that we don't use ""fuck"" or ""cunt"" as the subject of posts, but I figured this would be a place where it made sense to make an exception, so the post title was [""A Cis Guy's Perspective On #fuckcispeople""](http://www.bilerico.com/2013/08/a_cis_guys_perspective_on_fuckcispeople.php)

What I *didn't* know was that the title of the last post of the day *becomes the title of the daily digest!* 

Because ""fuck"" ended up in the email subject line, pretty much all of our daily digests landed in people's SPAM boxes, meaning that our opening traffic this morning was down **%67 off average.** And what's more, unless people manually mark as ""not spam"" our digests will keep landing there from here on out. 

**TL;DR - Published a post at the end of the day with ""fuck"" in the title and landed our daily digest in everyone's spam boxes for the foreseeable future.** ",TIFU And Cost The Blog I Write For %67 Of Its Traffic,280
heyhihellogabi,31,28,zk9id,214,"I took a three-week exchange trip to Tokyo, Japan over this summer. I've taken two years of high school Japanese classes and didn't really know what I was getting into. Because I tend to use hand gesticulations while I speak, I was making [this] (http://imgur.com/e1cCS) sign quite a bit over my trip. It turns out that in Japan, the sign that means ""okay"" in america means ""condom"" in Japan. 
""Do you want to go to a museum?""
""Condom.""",TIFU because of a language barrier.,242
[deleted],197,80,18js1d,211,"Definitely not as good as the scalding hot balls TIFU from earlier this morning, but here is my own

DISCLAIMER: I apologize for the lack of horrific anal injuries

So anyways I figured since today was Valentine's Day I would actually just go up to my crush during our lunch period and just play it cool and chat a little bit. Well that didn't exactly go as expected. I saw her getting lunch from the main lunch thingy so I went over to her and said hi. She's kinda quiet and quietly said hi back. Stupid me didn't prepare for social interaction with any human females so I froze up and the first thing to pop up into my mind was ""ererere uhh ahudfhadfh blurg werg werg can I copy your algebra homework?"". Aside from the insane amount of stuttering, it wasn't totally terrible. So I follow her to where she sits and I settle down and we both pull out our binders and we cross-check our homework. Apparently it's insanely obvious that I have some huge crush on her because all of her friends were looking at me strangely and one sat right next to me and yelled out ""cockblock"". I'm just thinking 'Roll with it man, finish checking your homework and then try to start something actually interesting'. Well her friends brought up the topic about other guys and I was just thinking 'hmm okay I'll wait a sec to see if her attention strays away back to me' but my body decides to blurt out ""I like you very much, bye"" and I just speed walk the fuck out of there with my bookbag wide open, my jacket hanging in my arms and my face red as a tomato. To add to it all my friends were watching from a table away and laughing the whole way through adding to the awko-taco-ness.

tl;dr: TIFU by having no confidence at all with members of the female population


Also, I know this isn't interesting or anything, I just wanted to divulge this little failure to the internet.


EDIT: Btw, I'm 14 years old and a freshman in high school (9th grade) and have never had a girlfriend or any sort of thing with a girl


UPDATE: One of my friends gave her a box of chocolates and it said it was from me to her. Apparently her and her friends found it cute and sweet. I actually have no idea how to approach her now. Any suggestions?

UPDATE: Okay, I saw her again today but didn't feel ready and confident to approach her. Over the weekend I will try to build up some confidence for next week. Anyways, the ""wingman"" friend of mine is ThunderCowNinja for any of you that wanted to know. I think she caught me looking at her for a split second in class and she half-smiled so that wasn't too bad. I'll start to say hi to her when I see her and smile, keep it simple, and if she seems like she's in a happy, friendly, energetic mood, I'll continue. Also, not saying awko-taco anymore. Or awko-burrito. And also, I forgot what genius brought it up, but saying words is a marvelous idea.",TIFU by attempting to talk to my crush,291
Xemeriba,59,47,wt9i4,208,"Alrighty, a few months ago I posted a TIFU about [how my girlfriend at the time's mom opened my glove box and got a bunch of used condoms in her lap](http://www.reddit.com/r/tifu/comments/rv7iu/tifu_girlfriends_mom_opened_up_my_glove_box_to/). This is important.

So I had never met my girlfriend's (now Fiance's) dad up until this week. Honestly, I've been pretty terrified to meet him as he is an ex Navy Seal and could probably turn me into mulch if I so much as look at him funny. The guy (from what I've heard) is a complete dick, though. He cheated on the lady's mom with another woman who looked very similar to her (hair, height, stature, eye colour) and ended up divorcing the mother to marry this bimbo. I've hated him since I first heard about him (as does the majority of their family) but I knew that eventually I would have to meet him, especially if I planned on proposing to my girlfriend.

Turns out, his new job (which I can't remember the exact title, only that he works with General Atomics) pays pretty well and he was able to purchase a Porsche Mirage - the Gemballa GT one, or so they said - for his new wife. Not sure if any of you know but this car is pretty damn quick and has a lot of torque.

While the two of us were staying at their house and after announcing the engagement (which surprisingly went well, her dad was really cool with the whole thing and wished us well, etc...) my fiance's step-mom asked if we could run to the local grocery store to pick up a few things (Milk, cigarettes, bread, assorted fruit, and a cake that the step-mom had ordered for the occasion). Unfortunately, since we flew out I did not have my car and her dad rides a Honda Valkyrie which obviously would not work for transporting cake. This left one option; the Porsche.

My car, being a 95 Ford Contour, has almost no power or torque behind the engine so when I got in that Porsche, I had to be as careful as possible. Got to the store alright, got the groceries and the cake, and got back to the house safely. No problem, right? Well, it wouldn't have been if the gas pedal wasn't so sensitive that one could drop a safety pin on it and it would lurch forward. When I pulled into the garage, I had my foot transferring from the gas (tapping it ever so lightly to get into the garage carefully) when all of a sudden the car jumps forward and smacks my fiance's dad in the gut and knocks him back into a wall. Turns out that my foot brushed against the gas on the way to the brake pedal and I had thought nothing of it as my car back home needed an anvil dropped on the gas to get it to accelerate.

No damage to the car, luckily, and her dad escaped with only a couple of pulled back muscles and a bit of anger. I freaked out, went whiter than white itself, finished parking and got out to help her dad. I thought I was dead and this marriage would be off but no, thankfully he understood and explained that the reason he bought the Valkyrie was because he can't stand driving the Porsche.

Later that night, we were explaining what happened to my fiance's step-mom and she said something along the lines of ""Wow, I'm surprised Tom didn't freak out that much. When Nana (Fiance's grandma) told him about that condom incident with Lisa in your car, I thought he would die laughing after his blinding rage subsided.""

Remember how I said I was whiter than white before? The shade of pale I turned when she said that can not even be described with words and the chill I felt when his gaze locked on me was something that is going to haunt me forever. Fiance's eyes were wide and her mouth was open as I tried to break the tension by chuckling softly. I thought I was going to be a dead man but luckily her dad just looked me straight in the eye with absolutely no emotion and said ""I'm glad you two are at least using protection."" He then got up and left the room. Our trip has officially been cut short and we are going home tomorrow rather than in a week from now.

**TL;DR: Ran over my fiance's dad who found out about our premarital adventures and the aftermath of a night of debauchery.**

Will update as the day goes on today (hopefully) and will give one final update when we get home and tell her mom.

Also let me know if something needs to be reworded or if something needs clarification. I typed all this up at about 4am so I'm a little fuzzy right now.

**Update!** Okay, thanks to the observations of a couple of people and my own thinking, her father was indeed not hit in the gut, but rather the knee-area and fell forward onto the hood before falling back against the wall. From where I was in the car, I had incorrectly assumed I hit him in the stomach. My lady's stepmom explained to me that the reason the father let me drive in the first place was because he saw it as a trust exercise and even though he thinks I am a good guy, I will not be driving that Porsche any time soon, If ever. We did receive his blessing before we left and very thing is as close to ""okay"" as possible. If anything new happens I will update again!

**Update Two:** It seems that a few people have inspired me to write a screenplay regarding the events of my relationship. I am very willing to do this but I'll need some help with a few things. Obviously, names will be changed, and due to the level if competition in Hollywood, a number of the events will be very exaggerated for comic effect and viewer appeal. That being said, I will base everything as close as I can to the real deal as possible. I will take suggestions for ways to play it out, dialogue, and most importantly; a title. Either post it under the comment I left below about this idea, or PM me. 

Now, back to reality. We told my fiance's mom about what happened and I have never seen that woman laugh harder. The whole reason she and the father broke up was because he was not a good man: cheating, lying, abusive, etc. They pretty much hate each other now and when she heard my lady say that I ""ran dad over"" she literally fell off the couch because she was laughing that hard. It made me feel a lot less tense about what happened because looking back now, it was funny. Somehow, I managed to screw up something I desperately needed to get right, and it magically ended up okay in the end.","TIFU by hitting my soon-to-be father-in-law with his car, then found out he knew about the previous condoms-in-lap event.",255
axelblaise,62,68,w1p02,208,my step sister bought me a bracelet that said legalize it with a bunch of weed plants drawn on it and i forgot to take it off i realized i had it on when the manager kept staring at my hand ,TIFU by wearing a weed bracelet to my job interview,276
xyz66,37,11,sow5i,213,"For the past 2 years, I've been calling this girl Susan, and I found out today that her name is really Jeanette, which would explain the look she'd give me whenever I said hi or tried talking to her.",TIFU because I just found out I've been calling a girl I know by the wrong name for the past two years.,224
climate_change,78,123,18ybsm,203,"I was supposed to take three internships, 4 month each, in labs in the U.S., Australia and Scandinavia. I am a top of the class student and got these internships by rank, but one requirement was to get a doctors note that I got all the necessary vaccines and that I got no major infections and so on. The deadline to hand it in was today and I don't have it, which puts my rank automatically to the lowest possible. I fucked up my opportunity to study on three different continents over the next year. fml.",TIFU by not going to the doctor.,326
[deleted],75,49,18vzie,206,"So...living in an apartment with two other roomates has it's perks. Privacy is rarely one of them, at least as far as masturbation is concerned. To make matters that much difficult, one roomate has a girlfriend who practically lives there, making her the third person who could potentially hear my big screen boom with xbox porno-awesomness. Which brings me to this particular day, when I had the whole place to myself.

'Bitchin', I thought. 'I can jerk my gerkin without awkward staring'.

I sprawl the sheets, set the towels, select tasteful clips and prepare to make love to my oldest friend; when I realize I have nothing for lubrication (dry pumping weirds me out for some reason and feel's terrible. Like i'm beating my cock for rent)

So i'm looking all over the place, when I find a pink bottle in the bathroom. I see the word 'lotion' and don't think twice.

Hitting the bed, I start up. A minute in I noticed a peculiar warming sensation. At first it feels awesome, just what I needed: lotion with warming qualities.

'Must be some BodyWorks brand' I thought.

Fast forward 20 seconds later to the most painful, poignant, painful sensation at the base of my meat stick. It was like a ring of fire ants on meth and bath salts went crazy. By this point I realized something was wrong, yet I couldnt seem to break the hold on myself. I convinced myself to finish. Like Kumar once said ""We've gone too far.""

But two more minutes of intense pain and i'm tapping out. I rush to the shower and start rinsing like a mad man, which was the wrong approach considering the flailing only made it worse. Then I stare in horror at the lacerated, gashed, bleeding remains of my once proud scepter. A ring of skin, clear finger indentions, was removed below the head along with random spots.

Upon looking at the lotion bottle, I read: ""Clear Skin: hair removal lotion for women"" complete with a smiling, slightly amused looking woman with long, lovely legs. They might as well replaced that smug bitch with a ""Problem?"" meme and called it a day.

Update: Sorry if literal fire ruined any expectations, but I guarantee a chemical burn..is quite painful.

My penis is doing good though, I expect a full recovery.",TIFU by nearly burning my dick off,255
Clashloudly,28,34,1qdggs,210,"Well, not *today*, obviously - this was on Saturday. I am a fire spinner (using a fire staff) and fire breather.

I went to a friend's party and decided to do my thing on the roof, where the people who wanted to chill out from all the dancing and drinking going on downstairs went. It went excellently well - I was really in the zone. I had even breathed fire successfully earlier, but I tried something new without practicing: kneeling down and breathing upwards, rathern than at an angle.

The result: a drop of kerosene fell onto my beard, and another on my shirt, and I spent five seconds with half my face on fire. I suffered first and second degree burns, but after soaking my face in water and applying some ointment, I was fine... and even breathed fire again.

[Here's a pic taken one second before going all Ghost Rider](http://imgur.com/RHVSD4S)","TIFU by setting fire to my hair, beard and face.",244
Dynomite333,50,69,1popz4,203,"So I get up the morning after Halloween, there is nothing for breakfast. So being the retard that I am I decided it would be ok for me to eat Kit kats for breakfast. 20 mins later I am sitting on the can holding a bucket to my mouth and blowing chunks from both ends.",TIFU by eating 20 kit kats for breakfast,272
Bloodclots,40,51,1kr0hv,203,"Today I had a nice long list of errands to do including a drug test for a new job.

Planned out my route to ensure I didn't have to double back for any errands and would drink just enough fluids to make sure I could ""perform on queue"" and would not have to wait in the office.

I took along my standard iced coffee and jug of water and started off at 10am with my first stop being the place of employment to pick up the drug paperwork.

Next stop, Target. I had to ""go"" but decided to wait since I only had one other stop before the drug test. The time is now 10:55.

Next stop was Lowe's, still need to go and thought, ""screw it, the drug test is my next stop, I can wait."". Finished at Lowe's, the time is now 11:40.

Arrived at the drug test and I was READY TO GO! They finally call me and give me the directions and cup and cut me loose. Sweet sweet relief. Finish, wait why is the cup.... red? (OH GOD)

Being a drug test bathroom, I couldn't take anything in or out with me... so yeah, I had to go out and hand the male tech a cup of pink pee. I'm not sure which of us was more embarrassed, but he was nice and told me it happens more often than one would think.

So the worst part was I needed to change my tampon and while changing, blood everywhere! It managed to get on my leg, shorts and flip flop. So here I am in near tears cleaning up a random public bathroom and I still have to go back and face this guy.

Needless to say I'm home, laundry is going, errands are not finished and I'm going to have a drink with lunch and probably not accept the job because I will never forget that drug test.

So TIFU by not peeing and changing my tampon before a drug test.

Oh, second TIFU in one day. I asked my husband to proof read my run on sentences. He is currently laying down trying to not throw up and isn't speaking to me.","By not peeing before a drug test...(kinda gross, sorry men)",254
mollyconnolly,40,57,1fm1u7,211,"My fiancé and I had a drunken night out at the bars and returned to my parents house for the night where we proceeded to get down and dirty in the basement. Us being drunk and all, my fiancé took a couple pictures on my phone while we were having sex. I'm talking me riding him on top backwards and my whole ass and vagina WITH his penis inside of it. Graphic stuff. 

So the next morning we had forgotten all about this and I let my mom use my phone to take some pictures. Afterwards she was scrolling through looking at the pictures she took and suddenly gasped and said ""I just saw something I did not want to see"". It took a while for it to click with us what exactly she had seen. We are mortified. My mom said we can pretend it never happened.. But it DID. It happened.",TIFU by letting my mom accidentally see a picture of my fiancé and I having sex.,268
enjoi928,44,32,151tsz,204,"After sleeping at friend's house with filthy toilet, i got to work extra early to take a relaxing dump and get in a few moves of words with friends ( yea i still play it, fuck scramble). It was so early that I didn't even bother locking the door.1 min turns into 20 and before I know it i was so glued to the toilet that the bathroom decided no one could POSSIBLY still be sitting here. That didn't prompt me to leave. But as the thought of getting up crossed my mind 10 minutes later, a coworker walks in to find me shitting in the dark starring at my iphone blasting 2pac. No Shame.
 
tl;dr I'm addicted to my phone and I love to shit.",TIFU by poopin so long at work that the motion activated  lights turned off....and then someone came in.,236
jbmass,38,41,z7fgy,206,"I screwed up my semester and I have to redo it (yeah I fucked that up as well). One of the teachers sends me an email asking me if I want to do it again or if I'm stopping my studies. I answer that I'm continuing. He says okay. That was back in late June. 

Fast forward to today, and I realize that I haven't checked my emails in two months. There it goes, one email from the university saying that I have to formally answer that I wish to continue in this field, by sending a letter, blah blah. The answer must be sent before July 5th or it'll be too late for me and I'll be considered as resigning.

Seems like I'm fucked, and I have no one to blame except myself.

Edit: It's a French university, not as expensive as an American one. I did lot lose/waste a huge amount of money because of that, but still a little bit. Still a dumb mistake though.",TIFU by not answering to an important university e-mail,247
throwaway455998,35,43,1pfcf4,204,"So I'm a girl. And today I'm wearing skinny jeans and a lace thong. Yes, this does have to do with my fuck up, I'm not just trying to turn you on. So I'm sitting in class with my legs crossed and I somehow get a really bad front wedgie when I stand up from my desk (see, I told you I wasn't turning you on.) So I leave class and as I walk back to my residence, this wedgie problem is getting worse and worse. I am in a ton of pain, so I'm trying to wiggle around while I walk, with great success- I could barely notice it now! So I get back to residence and I'm lying on my bed when I feel the urge to go to the washroom. As I'm pulling my pants down, I experience the worst amount of pain I have gone through in a while. It felt like someone just pierced my lady business. I let out a shriek and look down and notice a pool of blood forming, as well as a piece of what looks like rubber. I sit down and as I'm peeing I'm freaking out, trying to figure out what the rubber is, when I realize the toilet is full of blood. The piece of rubber turned out to be part of my ""labs"", which I had ripped a chunk out of. I guess what had happened is in class, part of the lab got stuck in the lace of my thong, as I walked I further got it stuck, and when I pulled down my thong, it ripped that part right off. I now am no longer able to walk, and am throwing this underwear out right away.


TLDR; Female front wedgie turns into bloody, ripped labia mess.",TIFU by pulling my pants down,247
Dizzydubby,27,45,1j3kax,203,"Normally my bathroom trips are quick. I'm not a toilet redditor. But today was a different story. I knew I was in for the long haul with this one. So when the time came to greet the bathroom I grabbed my purse, which had my ipad in it, and sat down.

I opened up ebay to find I won my auction! Yay! I get a new watch! Lucky for me I brought my purse into the potty!! Perfect day! I reached into my purse and retrieved my credit card. All of this excitement made my bowels oh so happy! I typed in my credit card information and placed my credit card down on my leg.


But my leg was not where it normally is. Nope. My leg was in potty position which creates a gap between my thighs. Credit card is now in the lovely toilet water. 

The next part I do not want to talk about. I have blocked it out of my mind. But I do have my credit card back.

TL;DR: I have a crappy credit card",TIFU by shopping online while on the toilet,248
Seraphiend,86,62,1190rv,206,"I work in a warehouse and am getting to know people there slowly.  I saw a coworker upon exiting who I met a couple of times before, and after chit chatting for less than a minute, proceeded to tell her she reminds me of the chick who plays Janice in the movie Mean Girls, played Marlene in Cloverfield,  and also played the girlfriend of Jason Stackhouse on True Blood.  I believe I used the words ""hot"". She proceeded to quickly walk away.

 I think it came off creepy, especially since I am also female.  I have a feeling I'll be labeled the creepy lesbian from now on (I have no aversion to lesbians, but I identify as straight).  

TL;DR Told a chick she's hot and am also a chick, came off  kinda creepy.  Not going to compliment people anymore.",TIFU by acting slightly creepy towards a new-ish coworker,268
jukejointj,57,38,1peg6d,203,"I opted to cover a shift for a coworker today and it turns out whoever worked that shift was the winner of the first ever random drug test this base has ever had.

Yesterday I went to a buddy's house to watch the football game and smoked pot for the first time in years. It was my day off and I knew I'd be sober well before I started my shift so I had a few hits off a bong.

I don't smoke regularly and I didn't smoke a lot. I take the test in about 20 minutes, so wish me luck!",TIFU by covering a shift for a coworker,241
oursurveysays,34,48,1lsq1g,206,"Okay, so I was jerkin' the turkey if know what I mean earlier in the day, and silly me left reddit on /r/gonewild open with a very... gonewildish picture on it. 

Anyway, skip forward a few hours and I'm working on my computer trying to sort something out with my dad when I decide to check twitter. No new tweets, oh well then lets check reddit. So there I am with my phone out in front of us and I open reddit to be greeted by a very attractive redhead... touching herself. Fuck, I instantly die inside and my dad excuses himself and I'm now just sitting here.

well, dinner is going to be fun :(",TIFU by opening a /r/gonewild pic right in front of my dad's face,254
x_glo,83,52,1k4wrx,206,"I woke up this morning groggy, having slept in after another night of gaming and watching Breaking Bad.  My hand reaches over to my nightstand to grab my phone, it was something like 12:30 in the afternoon.  I am still nearly half asleep at this point.  Well, my door is to the left side of my bed.  I flip the sheets off and roll on my side, one leg in the air, to get out.  

Then my mom walks in.

So basically, I am on my left side, one leg in the air, with my fully-erect morning penis is full view.

Of my mother.

Still half a sleep, I belt out, in a very awkward and loud voice ""I WAS GETTING UP!""

A look of awkward pain sweeps across her face as she quickly closes the door.  It wasn't until I got in the shower, fully awake, that I realize it must have looked like I was masturbating.  When my mom.  Walked in.

This entire morning was painfully, excruciatingly awkward.  I thought about explaining I was just getting of bed, but I realized that would just make it seem like I was masturbating even more.

God dammit.",TIFU by getting out of bed.,258
rrims,49,37,1fr9r7,205,"Backstory: I'm very heavily into computers. It's been my life since I was a kid. And due to brain tumor in my Sr year of high school, which caused me to drop out, I never really got into the work force. I've had small side-jobs and cash jobs. But nothing I would call a ""job""... But I've since fixed my life, got my GED, and on my way to better my life. I have been shooting emails and resumes out hoping for a response.... until...


I was outside cutting the grass when I stopped to bag the grass clippings. I heard the phone ring inside, but didn't think anything of it since it would go to voice mail. I then proceed to finish the grass. My Dad comes outside (yes I live with my parent) to talk and what-not. I decided to get us some drinks, so I head inside and the phone rings again. This time from my step-mom. So I answer, talk to her, then go to hang up. That's when I see the blinking voice mail light. I went to listen to it and it starts out..

""This message is for rrims. We've received your online application and would like to schedule a face-to-face interview. Please give us a call at..."" 

So I didn't think of writing down the number. I go call to my Dad to come inside and take a listen (i'm excited I finally got a call back). I go to replay the message and...... deleted. I pressed the wrong button. 

We don't pay for a voice mail option on our phone bill, so we use a phone system to record the voice mails. And once you delete it on the system, it's gone forever. And I filled out so many online applications that I can't tell which one called. I can't remember the lady's name, the companies name, or the number. 


TLDR: Unemployed, desperate for job, accidentally delete my first call-back voice mail out of over-excitement. 

Update 1: I went through all my applications and tried my best to match the town where she was calling from with the job I applied for. I narrowed it down to 1 job, so I shot her an email last night but haven't gotten a response yet. But I did find their number as well, so I'm calling them as soon as I finish typing this.

Update 2: Good news everyone! Called, got through to the lady that left me the voicemail, and now I'm scheduled for an interview Monday morning. I'm excited as hell! Thanks a ton for all the ideas! ",TIFU by deleting the voice mail from a future employer,242
[deleted],69,49,1dzipj,202,"So I usually shave, but I thought that this would be easier and work better somehow. I find some 7+ year old Nair in a bathroom in my home. It says ""Warning: do not use around pubic area"" or something like that. It smells really strong (probably both because of its age and because I think they've formulated Nair now so it doesn't smell as bad). I mean, it says not to do it, but I can handle this. These stupid hair removal companies, always coddling us. I spread a thick layer over everything as indicated. I try not to gag at the strong smell and note that it does burn a bit on contact with my skin. Make note of the time. After a few minutes, the burning intensifies. Starts to get pretty bad. But I have a high pain tolerance; I can take it. Nearing the end of the time, it hurts pretty intensely. I go into the shower to rinse it off and discover that my labia are kind of bloody. This is when I notice that not only did the Nair take off my hair, but also the top layer of my skin. I gingerly touch it, and yes, the skin has indeed been burned off and is somewhat bloody. Also my vagina smells like Nair. At least when I wash it with (burning) soap it doesn't smell bad but the top layer of skin is gone. ",TIFU by trying to use Nair on my vagina,251
Tankred,31,45,xpfxv,204,"Well, my dad and I were insanely bored.  I don't have to go back to my tech school for another week, and we were both off of work today.  I ran out of dip, so my dad offered me one of those e-cigarettes.  I declined (They taste terrible to me), but noticed he was refilling it with a bottle of menthol flavored, nicotine infused mystery liquid.  We got to talking about that nicotine liquid and figured that, like any bored Southerners, we'd do something stupid.  Rather, I'd do something stupid.  I squirted about half the bottle around my gums.  At first, it was alright.  Very minty.

Then came the stomach pains.

Then came the worst headache I've ever had.

Then, finally, the grand finale of my retarded decision, the vomitting.

This wasn't your run of the mill gag n' puke.  This was violent, projectile, Yellowstone-esque geysers of vomit.  After letting loose a salvo, I grabbed the nearest thing I could to puke in.  My dad's prosthetic leg.  He had just taken the thing off to relax.

Now, for those of you who don't know, those amputees that are only missing from about 1/2 of their calf down have prostetics that pretty much cradle what is left of the leg all the way up to the knee.  For some reason, my subconscious figured it would be a great puke receptacle.  

After a few more rounds of vomitting, the headache eventually subsided.  I'm still feeling nauseated, but I'm not going to die from nicotine poisoning.  My dad got a kick out of it, though.",TIFU by having a mild overdose of nicotine amd threw up in my dad's prosthetic leg.,249
TheSoundofStars,38,25,vq5iz,203,"The (T) is there because this happened a couple years ago. I was mowing the front yard (we have a lot of land, almost 3 acres total), and I was maneuvering around some baby evergreens, when suddenly a little chipmunk darts out from a hole beneath one of the trees. And unfortunately, doesn't make it pass the mowers blades. But instead of getting chopped up, the chipmunk gets sucked in, and goes flying out the back with the rest of the grass and leaves and shit. 

I rolled on over to where I saw it land, and got off to inspect it. It wasn't moving. I love animals, so this was heartbreaking for me. I got a plastic Target bag, picked up the poor little guy, and carried him to the cornfield next to our house. I dug a hole for him (or her), and just as I was laying him to rest, he suddenly wakes from the dead, bites my finger, and runs into the corn stalks, never to be seen again. Fucking asshole.

TL;DR: Hit chipmunk with mower, tried to bury it, turned out he was alive and was an asshole.","(T)IFU by running a chipmunk over with my lawnmower, trying to bury it, and end up getting bit.",228
ContentiousDelicious,102,58,wc0n7,201,"So I had the incredibly fortunate experience of studying abroad last semester in the beautiful country that is Australia. I spent my five months making lifelong friendships, traveling all over the country, and having the time of my life. While academics have always been important to me (I'm generally an A/B student), they were not my focus abroad. I went to class, did some work, but not as well as I would have at my home university. Towards the end of the semester, I had just lost the ability to GAF..final papers were just not happening. I'd much rather spend those last precious weeks doing the things I might never be able to do again, in a city I might never get to see again, with people I might not get to see for a very, very long time. I am SO scared to go back to my home university and face the repercussions. Will I be able to graduate? Take the classes I need to graduate? Will my GPA forever be fucked and therefore lead to never getting a good internship/job? I'm going into my senior year with all this on my chest. I plan on working my ass off next semester to get straight As but until then I don't know what to do. Thanks for listening.

EDIT: For the guys saying it's not a TIFU since this was over a period of time... I posted this because we received our grades yesterday. Sorry for any confusion. ",TIFU by failing all my courses last semester,259
Chairmanmeyow,88,36,smbbi,201,"UPDATE: Sorry it took me so long! I don't know if this is the proper way to update on a post, but here goes. 

My bank gave me the money back with very little hassle a couple weeks after the incident. I had to wait for the charges to officially post to my account, which took a few days. I navigated the automated system a few times to get in touch with the Claims department. I was issued a new bank card even though the guy who took my money from the ATM left my debit card behind. I also had my limit decreased. Once I actually filed the claim, I set up an appointment at my bank to see photographs from the ATM. I had to complete a form identifying the guy if I could (I could not). The next week I got a deposit! Love my bank. 

Unfortunately, I got a call yesterday from my bank informing me of some suspicious charges to my account. I took a look at my transaction history and there are 2 charges ($250 an $200) from Publix #store number. I Googled and found out that this is a grocery store in FL. I live in CA. As I mentioned above, I was issued the new card just 2 weeks ago and I did not lose it... I have to go through the whole process again. Yesterday, I cancelled my current card and will be issued a new one. I have to wait for the transactions to post and then file a claim. WTF. I'm actually kind of concerned that this happened again so recently, but I don't believe the two incidents are related. Any thoughts? 

Edit: Wow. I am so bad at this. Lost the original text of my post didn't I? ",TIFU by leaving my debit card in the ATM. The person behind me withdrew $900. ,237
griffthedestroyer,30,61,1nfp31,201,"Today when i got home from groceries I had to make two trips.  I left my front door open for the 5 minutes that it took for me to get to my car and back.  Between that time I had a few things stolen from my apartment; a Nintendo DS with Pokemon Ruby, and Pokemon White, and most importantly my new copy of Madden 25.  I thought i could trust the small town that i live but now i know i cant any of those fucks who live around me.",TIFU by leaving my front door open...,262
HellenSkelter,3,47,1n41fq,202,"Today I walked into my workplace, like any normal day. I work for one of those Wine and Painting Party studios, and besides the owners, I am the only one with a key. So I walk in to see about four dozen roses, a big banner that says I LOVE YOU, and a felt ring box, containing ( what I would assume to be) a diamond engagement ring. I have a live in boyfriend, no one else was scheduled to come in that day, and the clients for the day were a group of 13 year olds for a birthday party. So, my mind jumped to the obvious conclusion. I looked around with tears in my eyes, tears of happiness, but no one popped out to surprise me. I snuck up to the box, opened it, to find it empty. Suddenly the door opens, I spin around to see a very hungover couple. Holding the empty box with tears in my eyes, I stated at them as the newly engaged couple gathered their things that hey had been too drunk to grab the night before, when he had proposed.",TIFU by stealing someone else's wedding proposal.,249
hitlerslonelynut,35,73,1bx7i7,205,"So I'm a referee for soccer. I've been doing this for years and it's something I'm highly passionate about. This wasn't today, it was yesterday, but it's going to haunt me the next time I have a game. Around 12:30 yesterday I was watching my dad ref for a little bit, it was a good game. I get stung by a bee. I'm like, ""Shit, better get my epi-pen out before something happens."" Nothing happens for 30 minutes. I start my game at 1 and start feeling terribly sick. I tell the coaches (it was this bad) that if I stop the game, it would be to use my epipen. Well. I push through it. My second game, at halftime, I walked off the field trying not to panic, epipen in hand, start crying and my airway shuts off for a little bit. I calm myself and am able to breath a little. I go over to the game my dad's doing, and the guy who is the AR on the line I was walking to (who is like another dad to me) Panics because he's allergic to bees too. They stopped the game because my dad was in the center. My breathing got good enough to talk at this point. OH. I forgot to mention at this point I was running around with 3 bee stings at this point, wait too long to take my epipen, and then get stung by another. So 4 bee stings. After the fourth one, I couldn't breath, took my epipen, rushed to the emergency room and was relaxed.. 

I fucked up by waiting until after 4 bee stings, knowing I was allergic the whole time, and accidentally almost killing myself.

For the record, I was waiting (which was incredibly fucking stupid) to get my money, because I make better money than any other person my age doing this job. And I was greedy and needed it. Which I will NEVER put my life at risk like that again. Ever.","TIFU by accidentally nearly killing myself by being stung by 4 bees, knowing I'm allergic.",278
Ihaveaseriousquestio,62,46,1gs0ex,203,"This actually happened a year ago. I had planned a vacation and took 5 days off of work to sit around the house and play video games. Last day before my vacation I notice my Unibrow is growing back so I shave it with a razor, no big deal.

Day 2 the area is a little sore, I ignore it, I get pimples sometimes. 
Day 3 I see a pimple and try with all my might to bust it wide open. Nothing happens and it kinda has that pulsing pain feeling. I fall asleep to it. 

Day 4 I wake up and my fucking eye is swollen shut and the whole side of my face has gained a pound. I feel like I rubbed the side of my head against a cheese grater and then dumped my head in alcohol. The pain sucks and I'm starting to throw up everywhere. 

I rush to the emergency room, they put me on an IV and give me a pill for dizziness. WTF. I throw up on the nurse because I have a heavy head and my brain feels like its exploding. Pill kicks in and I feel a little better and they give me some antibiotics and tell me I'm going to need plastic surgery. Uh ok, but i want a second opinion. 

Morning of day 5 it's saturday I try to find a doctor that can help me on the weekend. Fuck me. 

I found a doctor, he sees my face and starts saying , "" Oh shit that's nasty. We are gonna lance it. You ready?"" 
I don't know what lance means because I'm a retard. 
DR. calls nurse in, she sees my face and I see her face make a face at my face. I feel very scared now. They have a needle and they stick it into the giant Boil/tumor on my head near my eye. 

Fucking red unbearable pain grips my whole existence. I start to feel liquid on my face and the nurse is gagging. They doctor sounds like he isn't breathing through his nose to talk. He is saying ""This is fucking nasty, damn"" and cursing more frequently now. The nurse leaves and I hear her puke. I see pus and blood soaked paper things. 


My head feels better, doctor packs it and gives me antibiotics. I go home and my vacation was obliterated. 

TL;DR Boil almost destroyed my eyeball because I wanted to pop a pimple. I'm a terrible writer but I hope I got the point across.",TIFU by popping a pimple near my eye.,249
the_spatzman,35,35,16nh4i,202,"So at my school there is a very attractive girl, she's an exchange student from Portugal named Mari. Exotic, tan and a cute accent. A week ago I happened by her number because she desperately needed tutoring in chemistry and I am good at science. So I became her tutor, got her number, and 15 bucks an hour pays well. So all's good?

Well I was going to pick up my friend to go see a local concert so I go to text him I am in front of his house. His name is Mason. I jokingly type, ""prepare your anus, I'm coming in hot"" to let him know. I instinctively type ""MA"" into my shitty samsung phone which goes to the first name starting with ""MA."" Mari comes before Mason in the alphabet. Until a week ago Mason was the only ""MA"" in my phone. I completely forget that I had added Mari. Only when I saw ""Message sent to Mari"" had I realized what I had done. I held down my car horn in rage, and then the police came because I was causing a noise disturbance. So on to of the rapey text I got fined $50 and couldn't go to the concert.

TL:DR I texted ""prepare your anus, I'm coming in hot"" to the most attractive girl at myself school because I don't know the alphabet. 

P.S. Samsung is crap

EDIT: She didn't text me back for a day until finally she sent me basically, ""what the shit."" I attempted to convince her that her english wasn't good enough and that she misread it. Wrong thing to do. So she took her phone to her friends and parents to make sure that she didn't misread it. So now I appear to be a serial rapist to her friends. And then her parents. When they found out and I had a 15 minute conversation with a portuguese mother, using profanity in two languages. I am no longer her tutor and grounded.
Worst part? Mason and I both took AP chemistry. Now it looks like he is her tutor.


","TIFU by accidentally texting the most attractive girl at my school ""prepare your anus."" then got a noise disturbance citation from the police.",237
sebast91,107,55,113t56,200,"http://www.reddit.com/r/tifu/comments/1130tf/tifu_i_possibly_molested_my_roommate/

It feels like its been a long day but I'll just state now that everything went a lot better than I had expected. 

I didn't reply to his text but he did get pulp so that was good thing number one. After I helped him put all the stuff in the fridge we started to talk. I asked him again if I did anything last night and he explained. It turned out that I remember less than I thought. I had calmed down partially from the shock of the morning but sitting next to just felt crazy when he first came home but at that time he didn't act like he was grossed out or anything. Back to what happened, it turned out he only had two beers but he didn't feel to good so he stopped after those two, I know I said I had 5 or six but he recalled that I had at least ten. He then told me that after going in to lay down he saw me walk in after him and then partially collapse on his bed. At this point he said he didn't want to explain anymore but he explained anyway. This whole part was really embarrassing but I think it must have been worse for him to explain how he wasn't really drunk but he let me do all the things I did to him anyways. But the most important part of our conversation was him coming out to me. I know this sounds really dumb of me to be surprised at the time because it's a bit of *of course he's a homosexual why the fuck else would he let you have sex with him?* but I've known him for so long that I never noticed the little things like how he's skinny in that I don't know delicate? way? This sounds like shit but I can't think of how else to explain everything. I guess I'll just go back to my conversation with him. He looked like shit after he told me and I felt even more bad but I didn't want him to be sad either. What I told him next wasn't out of pity though because as I told him that I'm not a homosexual but I think I only like you in that way I felt I had a bit of a realization. He's always been one of the people I cared about and we've always been really close so I guess something was bound to happen sooner or later. I'm really bad at explaining things but I hope writing this will help others later on if they ever end up in a situation like this. I feel like I should put more but I don't know. ",TIFUpdate: So I talked to me roommate about what we did. ,255
clearedasfiled,24,23,rh2vc,200,,"TIFU: I sent my best friend (who's black) a text that said ""Lynch tomorrow?""",223
feedle,96,43,1htw5t,200,"Sorry, I just have to vent.  

I had four pullets at the beginning of the day.  They were about 10 weeks old.  One of the pullets (a black banded we had named ""Popeye"") was becoming quite attached to me, and I loved having a new little feathered friend in my life.

Today, my girlfriend was going to take them outside and put them in a mesh run we have so they could get some fresh air and sunshine.  She leaves them in the run out in the open sunlight.. with no access to shade or water.  It's a 95 degree day today here in the Central Oregon desert.

I come home to find all four chickens stone dead two hours later, including my fairly new friend.  I don't understand how anybody can leave an animal in full sunlight with no access to water or shade on a hot summer day.  I'm personally devastated.  Yeah, they were ""just chickens.""  But one of them was quickly becoming a pet.  She'd spend time perched on my shoulder not unlike a cockatoo or parrot (and the ""redneck pirate"" jokes flowed like warm chicken guano).

I guess I should head to /r/r4r next.  Going to need a new girlfriend as well as new chickens.

EDIT: No, we're not ""breaking up"" over this.  It was a pretty serious breach of trust, and one that we will have to work on repairing.  Thanks to everyone for kind words and support.",TIFU by trusting my girlfriend to take care of my chicken,243
Some_Stupid_Hoe,18,41,1i1xll,200,"I was headed to the bathroom at work when I stepped on a piece of trash (that someone must have tried to toss in the wastebasket and missed) that caused me to roll my ankle outward and start to fall forward.  In my scramble to catch my balance and not eat shit in front of my coworkers I must have relaxed my sphincter because I let out the loudest public fart of my life.  Everyone was already looking at me stumbling around and so there was no way to blame it on anything or anyone else.  I didn't even look back, just walked straight out of the room and down the hall to the restroom where I cowered in shame and contemplated leaving and never coming back.  I eventually walked back to my desk.",TIFU by letting out a massive fart while trying not to fall down.,241
bmcnult19,93,59,1foj8o,200,"It was actually around a year ago.  Me and my GF were on a cruise with her family(3 younger brothers, two of which were 6 and 7 years old, and her parents) and the oldest brother's best friend.  We were alone in the ""old kids room"", which housed me and my GF along with her oldest brother and his best friend.  

My girlfriend was talking to me about how she sometimes doesn't feel attractive in a swim suit, which if you don't know is pretty much all you wear on cruises.  I was half asleep with my eyes closed and she was sitting on the bed beside me. At some point she asks something like ""How would you rate me, from 1-10?""  Ugh... that's a trap.  

I sort of pretended to be asleep while I thought up what to say as I didn't want to say something too high and make her feel like I was BSing her and I didn't want to say something too low.  

I reply with ""oh I don't know... I guess average.  But you have an amazing personality and I love you mostly because of that.""  and immediately regret that decision.  

She scurries to the bathroom and starts crying.  ""oh fuck me"" I yell-whisper.  I then hear the door that goes between the parent's room and ours open and her littlest brother comes in and asks if I can go with him to get some food.  I say sure and I don't see her again for a couple of hours.  When we meet up again, she's apparently not mad at me or sad.  

I later proceed to explain my rational, which was ""Average is attractive.  You know what I mean, I mean I'm average.  Neither of us are 10s, but we still love each other.  I wouldn't break up with you just because I found someone else more attractive.""  ugh.  I just need to shut up.",TIFU when my girlfriend said she didn't feel attractive,259
iscrewedupverybadly,52,51,16w67v,198,"I'll admit, this wasn't today, but actually yesterday because I was very sick and I couldn't drag myself to the computer or phone to write this.

So yesterday my family went out to a fairly fancy restaurant. They have surprisingly large portions along with very rich food (you can tell where this is going). Earlier that day I had gone to In-N-Out and gotten a lemonade, animal-style fries, double double burger, and a milkshake for an early lunch. Throughout the day I had been drinking delicious lemonade made with lemon's fresh from our neighbors yard.

My stomach seemed to be complying the entire time we were at the restaurant and on our way (it was an hour drive). When we got there, I ordered some smoothie thing with various fruits and a tea. For dinner, I had some really rich fish and rice. For dessert, I had a huge chocolate cake. At this point I was still feeling good. My stomach hurt a little, but it was the pain that you get after you ate way too much food (which I did). I fell asleep on the way home, so I couldn't tell if my stomach hurt.

I woke up to a slight discomfort (different than the full feeling I had earlier) but thought nothing of it. Ten minutes later it was starting to hurt a little more, but I figured I would be in the clear for the night. Another ten minutes later and was hurting even more. Then, all the sudden, out of nowhere, I ran to the bathroom with explosive diarrhea. I managed to get the toilet seat up and get my pants down before I exploded into the toilet, but it made a huge mess. It was all over the seat and stuck to the side of the bowl. I sat hunched over the bowl for a good ten minutes hoping the pain would subside, but it didn't do that. I then flushed the toilet and decided to lay on the bathroom floor because I thought I was going to throw up.

So I'm laying on the floor, pants off (I had enough foresight to realize I would need to take them off) with a shitty butt in the fetal position holding my stomach. Maybe twenty minutes before my stomach decides to make those horrid gurgly noises. I knew what was coming (eventually). I'm waiting for the inevitable to hit me, when all the sudden the door to the bathroom opens. I was too weak to scream at whoever it was, but I jerked up and saw my sister's eyes darting back between my shitty ass (. Right at that moment, (I don't know if it was because I jerked up or if my stomach just decided to betray me), my stomach decides it's time to expel all the contents from my body.

I jerk up, turn to kneel over the toilet, and let loose a geyser. I throw up literally everything I had eaten that day, which was a lot. It hurt so bad coming up, but I fought through the pain. Halfway through, I realize two things. One, I have to shit again. Two, I am not going to be able to stop vomiting for long enough to position my butt over the toilet. Shit starts to pour from my ass as I am letting out toxic, smelly vomit from my mouth. The shit went everywhere: the wall, my legs, the floor, and the towels. Eventually all the contents were gone from my stomach and bowels, but not before making a huge mess which I got to clean up.

To make matters, worse my sister decided to watch my entire display. I honestly don't know why she didn't just turn around and walk away. We haven't even been able to look at each other since this event.

Tl;dr: I got really sick from rich food and my sister walked in on me naked with a shitty ass. Then, she got to watch me simultaneously vomit in the toilet and shit on the floor.",TIFU by leaving the door unlocked,249
[deleted],16,35,10o389,197,"So I am a computer programmer, and as part of my job working at this development agency, we have to go out to discuss with customers what projects we are going to work on for them.  I drive my project manager out to the clients office.  At the office we meet with the president and the two lead tech guys at their office.

After we are all done discussing what we are going to do, the customer says that they will give us the assets to their database so we can get work done, and asks if we have an FTP server set up to receive the stuff.  We say ya, but then I have the bright idea that I have a 4 GB USB flash drive on me, and we can use that.

The previous night, my friends and I found a video of people stretching and putting condoms over their heads and we decided to do the same with the pile of unused condoms that just sit around forever. (forever alone).  In the morning, in my haste to make the house clean and get out the door for work, I must have accidently put a unwrapped condom which we had used for this in my pocket to be thrown away.

Well, I take out my keychain, and there is a condom wrapped up in it.  Its right there in front of everyone.  I panic and put it back in my pocket, remove the condom from the key pile, and get my work done.  Everyone pretends it didn't happen (it was only visible for a second and I hoped nobody realized what it was).

On the way home my manager says ""so, did you have a quickie at lunch or something?"" I said ""I... don't want to talk about it.""

TIFU",TIFU by whipping a condom out in front of the president of a company,232
roltrap,85,43,17v4x9,200,"A few weeks ago I found out that my now ex-girlfriend sucked her best friends dick. I was hurt and mad, but I love(d) her, so I made her promiss not to hurt me anymore and be faithful. I gave her another chance.

I noticed though that she kept playing with her phone and that she did her very best to hide whatever she was doing on it. So yesterday I got fed up with it and I asked her about it.

She said not to worry. So I then asked her if she minded showing me what she was doing on it. She replied with something in the vain of ""No, I like my bit of privacy"".

After me trying to convince her that if she had nothing to hide, she could just show it to me and make me regain my trust in her after what happened, she admitted that she was still sexting with that guy.

I told her to pack her stuff, hand over the key to my house and get out.

I got drunk alone at home and I a fit of bad judgment and blind rage, I posted some screenshots of her talking to that guy on facebook (she left her facebook open the first time she cheated on me).

I just had a phonecall from the police about that. They said it was harassment and that I could be prosecuted for that.

I guess I fucked up...",TIFU by not thinking straight after being cheated on,243
thatgirlgidget,17,75,15jqmt,202,"I'm sorry r/tifu, I posted a sock pattern request here instead of r/knitting... Thank you for not making me feel more moronic than I already feel. ",TIFU by reaching the front page of a subreddit with a post meant for elsewhere,277
Chop_Hard,44,56,158syl,197,"I was browsing 4chan when we decided to play a game involving hunting zombies on Omegle.

I was minding my own business killing shit when I came across a lonely male masterbating.

Not really out of the ordinary but the timing was impeccable. My mom decided to start cleaning house as soon as he connects. He starts making loud man noises and my mom turns around and sees me ""chatting"" with a lonely masterbating man.

I think she thinks I'm gay.

Tl;Dr Mom walks by as soon as I connect to a loud horny man on Omegle. She thinks I'm gay.",TIFU By getting on Omegle in the living room,253
Sageypie,29,80,13fxr4,196,"Basically the backstory is, at my job we're supposed to have this cleaning crew that comes in after us and cleans off all the machines. Whole point of having them. Lately, however, there's been a lot of complaints about things just not being cleaned, which leaves us doing it more often than not, and our cleaning ends up being the only bits that really get done. End result is we complain to higher ups, and they ignore it, so some of us end up drawing things in the dust (smiley-faces and whatnot) to kind of see how long it takes before it's cleaned up. That said.

TIFU by drawing the Operator symbol (from the slenderman mythos) in the dust covering some of the machines I'm around. Well, several symbols. I was bored, didn't think much of it, and was a bit peeved at how much dust there was after I'd spent several hours cleaning it completely the week before. Twist is that my boss is apparently pretty savvy on the slenderman stuff, and is now thoroughly freaked the hell out and being super paranoid. Ended up having to clean everything, but they don't actually know I did it, they just wanted the symbols gone. So yeah, was forced to clean like hell and now my boss thinks some kind of otherworldly monster is going to kill them...or...you know, whatever the hell slenderman does.",TIFU by drawing the Operator symbol in the dust of some machines I work with at work.,276
Dentonhere,100,77,1268r0,197,"first post to reddit, but it seems appropriate.

so today i got offered to go to a party with a girl ive been texting for a few weeks, we've met a couple of times before just as friends but god knows how i managed to get her to agree to body shots before this party.
we ended up getting there before her and her sister, so i decided to have a few drinks before she got there.
I woke up this morning blood all over my face, jam rolly Polly all down my chest and seven beer caps in my pocket and half a bottle of the tequila in bed with me.
I may of got so drunk that seven hours of my life dissipated, but i can put the puzzle together enough to know nothing happened between me and her.
now i know why i stopped drinking tequila years ago.

update:text her, no reply.
FOREVER ALONE.

Update2:she replies.
she says she took me home as i live only five mins from where the party is and tested me to see if i would try anything.
she said she would of ended everything then and there if i did as she doesn't want to seem easy and all that stuff.
seems blind drunk me managed to refrain from anything as she is happy with me.
result!

update 3: She's a virgin, so she doesnt want some bloke who uses and abuses.
 test me away all you want!",TIFU by getting blind drunk.,274
defectorlacera,19,24,zhwpj,196,"Technically, this happened a few nights ago. I apologize for the wall of text, but this is a long story.

I work for a major big box home improvement supply store, throwing freight overnight. On a bi-annual basis, we have a resurfacing company come in and sand the floor down to remove stains and buildup, then buff and seal it to prevent further damages. They had been here for nearly a week and were almost done. We were glad to be near the end of the process as working around them had been a nightmare.

This particular night, I was in the paint department. We had a lot to do as far as catching up because the resurfacing crew had done that department the night before and we weren't able to put up any stock during the process. Things were backed up pretty bad, but they had finished, leaving the floor shiny and new, and moved on to another area of the store.

I was attempting to put a case of concrete stain up on the shelf when it got caught on a bolt holding the shelf up. As I attempted to shift it over, I exerted too much forward force and caused the whole case to defy the laws of physics and dump out backwards off the shelf. This would have been bad enough, except that instead of just hitting the floor, the cans of stain landed on top of a display of spray paint directly beneath where I was working. The result was catastrophic. 

The cans of stain busted open and poured out all over the display and overflowed onto the floor, taking many cans of spray paint with them, breaking nozzles and lids in the process. Some of the spray paint cans went off, some leaked, all adding to the wave of liquid fuckup washing around my feet. The whole incident took a few seconds, but it seemed like hours, watching it all unfold just beyond my grasp.

[Here's a photo of the carnage.](http://imgur.com/aOA1Y.jpg)

I stood there dumbfounded for a moment, before realizing the depth of my mistake as the friends I was working with began swearing explosively. I had ruined three pairs of shoes, two pairs of socks and a pair of pants, on top of destroying merchandise in the initial fall and the splattering of stain.

Things went from bad to worse at this point. I called my manager over to inspect the damage and direct the cleanup. He was not happy. He retrieved the paint spill kit and I proceeded to start the process of cleaning up the mess and bagging the damages. However, for whatever reason, the cleaning solution did less to clean up the spill as it did to liquefy it further and spread it around more. TIL concrete stain does not react the same way standard paint does to cleaning chemicals. I wound up making the mess much worse. 

I finally resorted to letting it dry some under an absorbent powder, then scraping the residue up with a shovel. This process got up a good deal of the stain, but took off a good deal of the fresh sealant on the floor. I wasn't going to win either way. I got up as much as I could, but not before ruining the expensive surfacing job and leaving a giant stain on the concrete.

The next day, word traveled around the store about the incident. Upper management wasn't happy. Because of this, they had to schedule an additional night with the resurfacing crew, adding to the bill. We were out the money spent on the destroyed merchandise as well. I'm not sure how much it was all together, but it was more than I make in many, many months, I know that for sure. 

Luckily, I have a record of being a dependable worker and witnesses that verified it was a freak accident, so I didn't get fired. The cold, stern looks of disapproval I've been getting from certain managers is disconcerting, though. We shall see. I just know this is going to come up in my performance review next week.

tl:dr: I destroyed a bunch of expensive paint and spilled it on the floor at my job the night after a very expensive floor resurfacing was completed and a week before my annual performance review is due.","TIFU at work by dropping a $100 case of concrete stain onto a $500 display of spray paint, destroying both and spilling their contents all over the floor the day after a very expensive bi-annual floor resurfacing.",220
Treetrunksgoespop,47,81,1qxh24,197,"Well. here it goes. I work alone, selling mattresses. I spend 10hrs a day surrounded by comfy beds waiting for someone to come in, its alot of down time. Mostly I spend it watching Netflix and reading reddit and every now and again when things get slow I rub one out. 

It was a slow *slow* day. No one was even parked in the parking lot so I decided why not, im coved up by the big desk that faces the wall of windows, and Im wearing a dress, so its not like anyone would see right? Wrong. I closed my eyes for a few seconds, enjoying my dirty time and was on the edge of cumming, ohh god I was *right there* when I open my eyes and see a group of high school boys looking through the windows on theyre bikes with looks of awe and disbelief, noses pushed up on the glass. 

No ""instant mood killer"" it was too late, It was a mix of pleasure, shame, and guilt. I instantly jumped up and hid in the back room, face beet red with embarrassment vowing to never to touch myself again(at work). At least those boys got a nice show :/  

",TIFU by masturbating at work.,278
Doggyintheheadlights,52,36,1m6tg6,198,"Okay so usually when we're together, my boyfriend and I spend most nights at his place. I still live with my family so it's just easier on everybody for us to have a place to ourselves. Today though he came straight to my place after work and neither of us could really be bothered driving anymore. We just decided to hang out in my bedroom and re-watch some GoT.

We were snuggled up in bed together, and after an episode or two, we started making out a little, which quickly lead to the removal of clothing. A little while later we were getting pretty into it. We kept quiet of course, but it wasn't the softest sex we've ever had. 

All of a sudden, my dad knocked on the door. I quickly yelled ""hold on!"" but it was too late because the door was already swinging open. Yeah, he's one of those people. I don't know what the fuck happened, but both me and my boyfriend just completely froze in position. It would've been slightly less disastrous if we'd pulled the covers over ourselves or something... *anything*, but nope, frozen doggy style and in full view. 

My dad half-stepped in and said ""there's beef and gra-""

Eye contact.

Fuck. I can't even describe the look that was on his face, though I'm sure it mirrored my own. Absolute pure, unadulterated terror. It was probably only a second max, but it felt like a fucking eternity that everybody in the room was just completely frozen. After the second it took for him to wrap his mind around what he'd just walked in on he fled pretty fuckin' quick though. I heard his voice say ""...shit"" as he hurried back down the hallway. 

Fuck's sake. I can't believe we didn't lock the door. My dad didn't talk to me for like 3 months when I first came out to him years ago, so I'm pretty sure we're never going to speak again now that he walked in on me balls deep in my boyfriend. 

Needless to say, we did not finish, and we did not join my parents in the kitchen for some beef and gravy. We were both pretty keen to drive afterwards though because there was no fucking *way* we were staying at my house after that.

I plan to stay at my boyfriend's place until he's absolutely sick of me to the point of it potentially ruining our relationship. I'm just not sure I can ever look my dad in the eye again without experiencing terrible flashbacks.

TL;DR- Made eye contact with my slightly homophobic father while I was balls deep in my boyfriend. Terror, so much terror.

",TIFU by having sex at dinner time,234
Bason-Jateman,47,48,1jrhzi,198,"Logged in to my trading account through a major online trade company and sold 10,000 shares of stock. I received an error message that I've never seen (database not working etc). 

I checked my recent orders and nothing showed up and I still owned all the stock. So I tried to resubmit the order again. 

I repeated this process a few more times with no success and eventually gave up. 

Just logged into my account this afternoon and now I own -50,000 shares at -$131,000... 

And while I have $160,000 in cash in my account, the stock ended up going higher after I sold it so according to them I've lost $3,500... 

Called the company, sat on hold for 45 minutes and all they can say is ""Oh, wow, we have to look into this. We will call you back soon.""

I guess all I can do now is wait. 


**EDIT** It's now 3 hours later and I still haven't heard back from them. In addition, my account still shows the $160,000 in cash available. It's really too bad the stock didn't just tank after I sold it, as I would have made out like a bandit. 
",TIFU By resubmitting an order to sell my stock when the website was having major issues.,246
PCruts,17,32,1d5kj5,192,"Ok, so this wasn’t today, but a few months back.

After spending lots of money over the years for my wife to go to salons and spas and all of those other womanly places to get waxed, I decided it was time to tighten the belt a notch and have her start doing it herself. We bought the wax, we bought the strips, and we were ready to go.

So the next day she’s in the bathroom doing her thing. This is when I learned how messy waxing is. That stuff was ALL OVER. She spills a bunch of wax and needs to clean it up. With her leg up on the toilet, she looks around and sees my pajama pants lying on the floor. What better to clean up wax with right? I’m sure you see where this is going. 

I had been lying on the bed and decided to head out for a smoke. I get up, put my pants on, commando style of course, and go outside. I sit down in the chair and enjoy my cigarette. I play on my phone and after about 30 minutes, I stand up. When I stand up, the cheap plastic chair comes with me. Something’s not right here. I push down and that’s when I realize what has happened. The chair is stuck. I push harder. Still stuck. I thrust down hard and it comes loose. My pants stay stuck to the chair and so does most of the hair I have on my ass. I scream. Yes it was the girliest scream that has ever escaped my lips. About this time, my wife is rounding the corner at a run trying to see why her manly man is screaming like a 10 year old girl. As soon as she realizes what has happened, the giggling begins. I’m not amused…
I have to step out of the pants and walk back in house pantsless with a flaming red ass that feels like it’s been burned with a hot poker. She’s still giggling….

TL;DR: Always pay for your wife to get waxed somewhere other than your home, it will come back to bite you in the ass otherwise.
",TIFU by accidentally waxing my ass,224
Tilted_Axis,48,84,1bcscs,195,"So I go with some friends to the river like we sometimes do, it's a big area with no strong current.  I decide to walk upstream like I've done before.  I take my little bro and a friend.

They decide to be pansies and walk on the river edge, but I'm all about adventure and decide I'm traveling in the fucking rapids.  First obstacle was a natural slide that took a minute or two to power swim up it.  From there it was boulder jumping and clinging to avoid losing ground.  

Finally I come to a big ass boulder the size of two ford explorers easy.  The water is higher than the last time I explored up here but I recognize it and remember thinking that if the water were higher (like it is for this story) and someone slipped they would surely get sucked under and drown since the exit was blocked by small rocks and branches, maybe a baby would make it through.  

So my smart ass decides to be adventurous and walk the path through the river.  I make a leap from a big boulder to a tiny one.  Then there is a branch alongside the giant boulder of death which I test and then walk across.  Now I'm on a small boulder, and see that there is another smaller boulder about 5 feet away that I can jump to.  I also note that if I slip there is a good chance of death by drowning after getting sucked under the giant ass boulder, and the current is very swift and strong.

I don't want to turn back, and this is the last risky move I have to make before joining my little bro and friend.  I calculate my leap, and I stick it....for a second.

Then I immediately slip on algae and in a fucking instant the current pushes me into the giant rock, folds me, and pushes me under.  I don't no how long I was down there, not very long.  Less than 10 seconds.  I somehow find something with my feet and manage to summon super strength and rocket myself back out against the speeding current.  Which is Faster than any human can swim I promise.

As soon as I rocket the fuck out of there I start to get sucked back in, I would not be able to summon that strength again.  I put my feet on the rock I slipped off of, and my upper back on the previous boulder.  I then arch myself up so the water can't push me.  Now I'm fucking stuck like this screaming for help.  My little bro and friend came not because they heard me, but because I was ""taking forever.""

At this point I was contemplating my death, and was surprised at my acceptance of it, not really all that scared.  But I sure as hell wasn't going out without a fight.  I almost laughed when the thought popped up that if I did die my student loans would be forgiven.  I laughed later.

They try to reach, no use.  I can tell that if I move I'll get sucked under instantly.  I tell my friend that if I go under, to make sure my little bro does not come in after me, or him either.  At this point I've been arched grinding my back into rock for at least 15 minutes.  Just sitting there losing strength.  I tell my friend to give me his foot, so most of his weight is secure on another rock.  We lock feet and he tries to pull, but no luck as I almost go under again.  When I secured myself again, I was in a slightly different position than before and was losing it, slowly slipping back to how I was.  I needed to use this new leverage NOW.  I ask my friend how far another rock is behind me, almost 3 feet, I can't see it. 

I make calculations on the strength needed and if I even think I can make it.  No choice.  I look at my baby brother for hopefully not the last time, give him a smile full of grief.  And push like I've never push before.  I had to go back a few feet and flip over all at once and fucking nailed it.  I scrambled to the center of the low laying boulder and collapse.  Resting for a long while.  We decide the adventure is over and ride the current back to base.

I also must admit I once almost slid off a cliff and a friend caught me by my backpack.  But that's another story.


I almost drowned because I was a dumb ass looking for adventure.",TIFU (last summer) by walking upstream.,279
escroto-peludo,43,31,uq6q6,199,"I was post-shower when I noticed that the water level was quite high. I haven't had a problem with my shower drain clogging before, so naturally my first thought was that something had to be blocking it. I look down at what appears to be a loofah sitting on top of the drain, half-submerged in soapy wash water. Without thinking twice I grab it, as me and both my roommates use body scrubs of some sort (I figured I must have accidently knocked it off the wall mid-shampoo). That's when it happened... the ""loofah"" began breaking apart in my hands and trickling down my forearms. I panicked and immediately shook my hand away from me, the pube snowball hit the wall and splatterd onto the adjacent wall and on my face and chest. I had to shower again and cursed out my roommate in front of his female company.",TIFU by grabbing a fistful of man-pubes,230
strappingyoungpeople,65,66,u7wop,196,,"TIFU by leaving a vibrator in too long, lost the cord in my anus, then had to poop it out and clean it off in a public restroom",262
paki123,91,98,y2o99,194,This deal is so fuckin good tho... the shits I'm getting right now aren't :(,TIFU by eating an entire Pizza Hut $10 Dinner box,292
PaulFuqyaself,44,41,tp96e,192,"I was on the train home and felt a number two coming on so I went  to relieve myself. So I headed to the bathroom and went about my business. In my haste I forgot to lock the door, when I noticed it was too late, I was at the do or die part of the poop. Then right at that moment someone the door open, with out giving a courtesy knock to see if it is occupied. He then proceeded to have the audacity to poke his head into the occupied restroom, immediately we locked eye contact. At this point my only reaction was to proclaim the obvious and shout,""Woah pal I am pooping!"" I am pretty sure everyone in the train car heard me. ","TIFU, I went to go take a poop on the train and forgot to lock the door.",233
Backdrifts32,46,117,1c5dwq,195,"I feel like there has been an influx of ""This happened x amount of time ago but anyway...."" type post. While these stories can be interesting it's not something that you did TODAY or hell even in the past couple weeks. Personally, I enjoy this subreddit because it allows users to A) talk about a bad situation. but it also B) allows people to comment on it in an effort to HELP with the situation. When the story happened 3 years ago *coughcough* There's then no room for discussions like ""well what are you gonna do now?"" or ""you can fix it by _____"" because it happened sooooo long ago we already know the result. I realize some people didn't know about this place when they had their fuckup and thats why something within a few weeks is even okay in my book. Anyway that's just my two cents.",A little trend I've been noticing on TIFU...,312
MrWiggles2,15,35,17qaqm,193,"So, late last year I started working with a new company as a sort of trainee to take over my direct boss' position when he decides to retire.  A couple months later (before Christmas) he bought himself the iphone5 and gave me his old iphone4 so I would have all of his contacts.  I have never been an iphone guy.

So a couple weeks later I'm texting with my girlfriend.  Texting turns to sexting and I send her a pic of the ol' ween.  I delete it immediately afterwards.

Today, maybe 2 months later, I realize that his appleID is still active on this phone and ""PhotoShare"" or ""PhotoStream"" or whatever is ON.  This means any photo saved to the phone is automatically uploaded to his icloud and any other connected devices.  I realized this by noticing photos I didn't take show up on the stream on this phone.

My stomach dropped and I feel nauseous.  I know its been a while and he might have mentioned it by now.  But he's also tech-tarded and I don't know if this pic is a ticking time-bomb laying in wait in his (or his wife's or kids or grandkids) phone/computer's photostream.

**tl,dr: Sent dick pics to new boss**",TIFU by possibly sending my boss dick pics.,228
mcwx3,73,33,xqzpj,196,"It's not what you think. Just kidding, it is. I was bored at home for a few hours and dancing to a song on the radio, and I started wondering what I looked like when I dance naked. So I set up the laptop and do a 2 minute video of me moving my hips and looking sexy with my top off. Welllll guess who forgot to remove the video when she went out? So mom found it and was outraged when I got home, and explaining it to her was not easy. I really didn't see what the big deal was about because I wasn't going to download this video on the internet, but I'm pretty sure she thinks I'm a porn star now. 

EDIT: Okay, so she took away the computer as a punishment (we share it), and won't let me use it until I admit what I did was wrong.  That's why responses are delayed :( Luckily she forgot about the iPad.  I would *UPLOAD* the video for proof but that would completely contradict my original statement, plus I'm only 17. Thank you guys for everything, but most of all for understanding ! :)
",TIFU when I left out a naked video of myself dancing that my mom found. ,229
JustNotGivin,46,42,v8vun,191,"Today, I just got to work, its early in the morning and I have just given a buddy a ride to work. When we got there, he started to check out the jobsite and what we would be doing, and I tried to slyly  let a fart out. However, when I let the 'fart' out, it didn't pop. And I said to myself ""Did I actually just shit my pants?"" That's when I realized there is no washroom around as the house is locked (I'm a painter), and the owner is already at work. So I have to run into the bushes and do my best to wipe my ass with some leaves before my partner comes back. It was a shitty day, pun intended 

TL;DR: I got to work and shit my pants basically.",TIFU and trusted a fart while at work with no washroom around.,233
Cookies_nom_nom,87,62,uxych,193,"So last night I was enjoying some alone fappy time while my girlfriend was playing skyrim in the other room. I was using headphones, but only one so I could hear her coming if she did, which she didn't. No, instead I got to fully enjoy my fap and finished up, had my post-fap ""what the fuck am I watching"" moment then cleaned up. Later that night me and my girlfriend went to bed where she passed out almost immediately, but I wasn't tired so I decided to read for a little while. I got my book and my ipod, sat down in bed, turned on some william fitzsimmons, put my headphones in and froze. I realized what the slimy squish in my left ear was almost before it happened and I was frozen in fear of what to do. I ended up pouring a nearby can of mountain dew down my shirt and slipped into the shower for a good hour of trying to figure out just how one cleans jizz from their own ear.",TIFU by putting sperm in my ear.,255
[deleted],48,43,utdxb,193,"Earlier today I was playing with one of my knives, an assisted opening knife with a damaged torsion bar. For those of you who aren't knife enthusiasts, that means the knife stays closed until you push on a part of the knife blade and then it springs open, and the damaged torsion bar means that the knife doesn't stay closed, so if you were to flip your knife, the blade would pop out. So, I'm pretty good with catching a knife by the blade, but this time that I threw it I accidentally threw with too much force. For some reason, I thought I could still catch it, so I held my hand in position. Unfortunately, when the knife went up so high, I didn't properly estimate the distance, and I missed the knife. This wouldn't be so bad if the knife didn't fall, point down, straight into my crotch, roughly two inches from my penis. To make matters worse, I had just recently sharpened the knife to a razor edge. I don't think I've ever bled so much.

**tl;dr: Threw knife into air, didn't catch it, knife landed in my pubes.** ",TIFU: I stabbed myself in the pubes,236
Tommywom,10,39,1jcirh,192,"Just sitting in a Starbucks thinking how i shouldn't have ordered a triple caramel frappe. I notice a man using an electric scooter who cant make a corner because of his bad hand. I go over and say ill help him turn and get him round the corner. 

So i start turning the handlebars and help him pull the forwards lever.. Little did i know how fast these things can be! I crash him right into the tables of people knocking over chairs and causing all their coffees to spill over the floor! TIFU",TIFU by helping/crashing an elderly man on his electric mobility scooter,231
Billy_Bongs,64,50,1fc3f1,192,"So being the smart redditor that I am, I have RES and the companion on the old chrome. For those not in the know, I just hover over pic links and the picture displays usually. I was flipping around on reddit, resetting myself for a second when a coworker stopped by. We talk for a while and he's looking at my screen every so often. After finishing what we had to discuss he asks, ""what are you looking at??"". ""Reddit. Why?"" ""Take a look."" Turn around, picture of a girl bent over spreading her cheeks in true gonewild fashion dead center of my monitor. Awkward laughter ensues. ",TIFU by hovering over a r/gonewild post at work.,242
Potatofetish14,32,25,1kdx53,193,"So today I went over to mow my neighbors lawn. I'm 16 and could really use the cash for gas money. So I get started mowing and everything is going as planned, as I was mowing underneath a tree I looked up and saw a in a nest in a tree that my neighbor told me had bird eggs in. At that moment I accidentally ran something over, I pulled forward more and looked at what I had shredded to bits. I thought it was going to be a small dog toy that i had missed while picking up or something but no, it wasnt. I had shredded a baby bird into bloody bits of feathers. I don't know if it was dead from the fall from its nest or I had just killed a baby. I didnt want to tell my neighbor I had just killed a baby in her back yard. She was a fan if her birds an had pleanty of bird feeders and she had been waiting for the eggs in her tree to hatch for a while. So I quickly got out the hose and washed down the evidence. And of course right at that moment here comes my 93 year old neighbor seeing if anything was wrong while she was holding a cup of ice tea for me. I told her i accidentally ran over some dog crap and she believed me. When I was done i got paid my $15 and she made me some peach cobbler which I ate in shame. 

TLDR; I mowed over a baby bird, washed away the bloody evidence, then had ice tea and peach cobbler as a gift for a job well done.",TIFU by mowing the neighbors lawn,218
TheLambaster,27,72,161ul5,194,"This happened a little while ago actually.

A little backdrop for this story. I'm on the club cross country team at Michigan State University. This year, our national meet was at Hershey, PA. Given the 10 hour drive, we left Friday morning and got back on Sunday night, with the meet being on Saturday morning. This, of course, gave way for partying on Saturday night. As a team, we stayed in a hotel not too far away from the course with some other schools that were racing.

Also, when I get drunk, I tend to get angry for whatever reason. 

With all that being said, I decided to party and have some fun. As the night progressed on, I of course, preceded to get more and more drunk. Finally, at about 1:00 AM, the anger starts to kick in. I get so mad that I decide to put on my jacket and some shoes, and go out for a run to simmer down. Before anyone could stop me, I took off running straight down the road. 

I should let you know that I was extremely unfamiliar with the area. In fact, I knew none of the roads. The only landmark I knew was that I was staying in a Hilton hotel across the street from a Wal-Mart. 

After a few miles, I sweat out some of the alcohol and started to sober up a bit. I, of course, realized how stupid it was to go running late at night, while drunk, in area I was completely unfamiliar with. So, I had the natural reaction of turning around and going back to the hotel. Unfortunately, after a while, I started to realize how nothing looked familiar from before. I decided to keep going forward in the hopes of seeing something that would lead me to the hotel. Of course, there was nothing.

Having nothing on me except my hotel key card, I had no way to call someone for help or to guide me back to the hotel. Panic started to kick in as I realized I was completely lost in the middle of Pennsylvania. My first reaction was to see if I could find somebody on the roads that could help me. With it almost being 2:30 now, there were very few cars out and almost no restaurants or businesses open. I wave down a few cars and even stop in a McDonald's to ask for directions but no one could lead me back to the hotel. 

But, seeing no other hope, I keep trying. A few more cars pass by and eventually a car pulls over. I tell the driver, a middle aged women, my story and she informed me that there was a Hilton about 5 miles north of us. She even offered to give me a ride. Under any other circumstances, I would have immediately said no thanks but I was now very tired and still a little scared. Reluctantly, I hop in this stranger's car and hope for the best. Fortunately, she was an extremely kind women and nothing happened. She took me back the hotel and it was the right one.

TL;DR Got pissed off when drunk. Went for a run in a place I was very unfamiliar with and had to hitchhike my way back to the hotel.",TIFU by getting drunk and going for a run,266
elbenji,59,36,12xlqb,194,"So I was ironing a shirt I needed to be a part of a crew for a show tonight. I put the iron down on a plastic drawer thing I have for no more than five seconds as I smoothed out the shirt. I take it off and then notice the goo coming up. 

I panic and try to clean it. Its hard, some of it gets on my bed and now I'm in full panic mode. I also need to get to close in twenty minutes and I haven't showered.

So, in panic mode, I try to iron again...not noticing the goo on the bottom of the iron. It gets all over my shirt, my favorite, nicest looking shirt.

I curse out and freak out. I spend twenty minutes washing it off, no avail. Late for class. Double fuck. I clean the iron and try peeling it off, still ruined. 

In all of this, I miss another deadline. I needed to drop off some movies by 8 am or I have to replace them. So that's 75 dollars each for 4 movies. I was going right before class starts.

I eventually just take a shower in shame and let my shirt sit there with bits of plastic on it all solidified and deal with my fate. Yup.

TL;DR: Accidentally melted a part of a plastic bin, now have to pay for drycleaners and missed a bunch of deadlines...cause that's life.",TIFU by melting plastic.,230
thisisnothingmore,54,46,1cu6gk,193,"My girlfriend is a vegan, and I am very much so a carnivore. She respects my decision as much as I respect hers, but she wanted me to try it for a day or two. I don't know if any of you know what quinoa is, but it's a grain kind of like rice but its healthier and has A LOT of fiber. She made me a whole 5 course vegan meal with vegetables, and lots of quinoa. Lots. And I ate it all, as it is quite delicious. But apparently my GI tract wasn't quite happy without any meat (I eat meat at every meal, usually) and I ended up having to shit super bad. We were at her moms house, so I excused myself and went to the bathroom. I kid you not, my shit was like paste. (This was my third day of quinoa...) then out comes this giant turd the size of a large kiwi fruit. Obviously the toilet ends up clogging and of course there is no plunger. So I casually stroll into the kitchen and frantically start looking for something. Then I see it. Salad tongs. I went back to the toilet, grabbed the turd and put it in the trash can. Then, being the gent I am, took out her garbage, but then being the idiot that I am, forgot to dispose of the fecal tongs. I left them in the kitchen sink. Girlfriends mom says ""oh there they are!"", rinses them off with just water, and puts them in the salad. Needless to say I am not going to be eating the salad..... Fuck.

TL;DR Too much fiber, giant turd, used kitchen tongs, girlfriends mom ate off them.

Edit: Kiwi fruit* ",TIFU by trying to be vegan for a day and then trying to unclog the toilet with my girlfriend's mom's salad tongs..,239
Alexi_Strife,11,23,tz4r0,191,"So I work in a porn store and one of the products we sell is a E-stim package. It contains 4 electrodes and a remote. I messed around with it previously with my girlfriend when I first got it and we had fun naming all the power settings which ranged from 'cat claws in the morning' to 'zoidberg hands' and the most powerful setting, 'midnight knife fight in downtown Oakland'. 

Well, tonight I was bored and alone. Decided to try to rub one out and go to sleep but nothing was really doing it for me, so I decided to be adventurous. I hook up two of the electrodes to my junk, around the shaft and pressed play on my ""acquired"" copy of Avengers. It was the perfect set up, in moments I was going to make a new addition to the spank bank thanks to miss Scarlet Johansson and some mild voltage.

At first it didn't work. I assumed you had to have all four electrodes making contact somewhere, so I tried connecting the second set to...ahem... another region. 

It felt amazing, a few of the settings were uncomfortable but nothing too bad, I would quickly switch to a different mode and it was all good. I eventually found a nice mild setting and kept it there but increased the speed. 

I finally found the perfect setting and it was amazing, I had never came so hard in my life. Unfortunately, when I came I twitched in such a way that one of the electrode popped off and landed on the arm that was holding the remote. It twitched and clenched the button that increased the voltage. I went from bliss to searing agony in seconds. 

It felt like a legion of fire ants; commanded by my exes, were marching through every vein and inch of my member. I kind of wanted to scream out for help but I couldn't let my roommates find ""this"". 

After about 10 seconds, which felt like hours, I got the thing to stop. Never again. Never again.  


TL;DR. I stuck an e-stim on my penis. Felt like a downtown Oakland knife fight on my junk. ",TIFU by putting electrodes on my penis,214
[deleted],27,37,1bsex6,187,"This actually happened last week but anyway, I use imgur all the time to send my brother's mother-in-law pics, because she doesn't understand how to use anything outside of facebook chat.  It's pretty much common knowledge in my family that I'm a lesbian, but my brother's MIL is from the Philippines and isn't in on stuff like that, plus English isn't her first language so when we do communicate it's very brief and to the point.

I should add that a guy friend and I are always tossing NSFW imgur links of lesbian porn at each other throughout the day.  You can probably see by now where this is going.

So I'm sitting at my computer and brother's MIL had asked about pics that were taken over the weekend, and I had uploaded some to imgur to link to her, but I got side-tracked with a phonecall for a few minutes, and when I went back to the chat window, I mistakenly... and regretfully linked her **(NSFW!)** [this](http://i.imgur.com/pv7Z32p.png) instead.  While I had been on the phone I linked that to my porn-swapping friend, and didn't realize that I hadn't re-copied the proper link after doing so.

I noticed she had not responded in quite some time, but figured she was just being slow, saving the pic or whatever.  When ten minutes had passed I went back to the window and clicked the link, just to make sure it worked... and saw that I had linked her to lesbian porn instead of the shih tzu pics I was supposed to send.

I choked.  I alt-tabbed and feverishly got the proper links, pasted them to her, and just wrote, ""Ignore the other link.""

I only told my porn swapping friend because I had to tell someone... he thinks it's hysterical and while I'm still mortified, I can at least appreciate the hilarity of the situation.  No one in my family has mentioned it, so I'll probably just try to pretend it never happened.  I don't think I can ever look her in the eyes again, though.

**TL;DR: Sent my brother's MIL lesbian porn instead of intended puppy pics.**",TIFU by sending my brother's mother-in-law lesbian porn.,224
realfuzzhead,46,41,18nxhi,189,"Catastophic mechanical hardrive failure out of fucking no where. Just using my laptop, laptop freezes. No choice but to force restart. Oh great, no hard disk detected.


what I lost

3 physics programs I had designed to create gifs for my physics professor to use in his physics 101 class. Promised him they would be done by the 19th, I literally just finished testing and optimizing all of them. why were these not backed up? Fucking why?!?! Because I'd rather spend my money on weed than on an external storage device, and because I was too lazy to upload 3000+ lines of code per program stored in dozens of files to my google documents account. ""
i'll do it tomorrow.. don't want to save it now and then change it!""

My complete personal finance spreadsheet. Why was this not backed up? Because I'm a fucking idiot who insists upon learning things the hard way. My debit card purchases are still logged on my online banking, but all my hours from my personal tutoring job and my public tutoring jobs are gone. 

Resume files? Fucking goodbye. Why the fuck was this not backed up?? WHYYYYY?? 


1000+ backpacking photos. I still have the originals, but I just finished editing, rotating, labeling, organizing, fixing the exposure, and fixing the color on every backpacking photo I have ever taken.

everything.. gone..
I have no motivation to rebuild anything. I'm sitting at my laptop with a new harddrive and I don't even have the motivation to change my wall papers..


BACK UP YOUR MOTHERFUCKING DATA. I learned the hard way so you don't have to",TIFU by not backing up my data ,230
ScrubTutor,29,13,ug82p,191,,"TIFU - I realized that my resume, with which I have applied unsuccessfully for 30 or 40 jobs, had my girlfriend's old phone number on it, and not my own.",204
GashcatUnpunished,49,13,shtbx,186,"It has everything in it. My pad of expensive paper, all of my assignments, several of which were due today. My entire array of VERY expensive brushes, most of my expensive paint tubes.... I can't even do the assignment that was assigned today. My family has little money so buying those supplies is an ordeal.

I have no idea where I left it, I ransacked my house and it is not there. It must be on campus somewhere but I called the lost and found office and they didn't have it. It has been two days. I don't know what special kind of asshole would find a bag of art and just take it. And yes, it is just a bag. I have costly portfolios but they are too large and unwieldy to bother with carrying around the size pad I was using... So I've been carrying all of this stuff around in a thick, white plastic bag. You know, that nicer breed of plastic bag you get when you buy books.

This makes me terrified that someone thought it was trash and threw it out. 

The year is about to end and I do not have time to make up the assignments.

Edit: Fuck Up of the Week, nice ahahaha",TIFU... I lost my entire college art portfolio,199
MSciCSI,21,15,s2mw6,189,"The trust between my friend and I has grown over the time we have known each other. He rides a motorcycle, I drive a car. I had never driven a motorcycle. I made a bet that I could set off on his motorcycle without any kind of stalling on my first attempt since my knowledge of clutch control was so good from my experience driving, he trusted me and agreed. 

I was right, I set off on the bike in first gear without a hitch and drove along 20 feet, I was rather proud of myself. What I didn't do was think about what I would do after. I locked the front wheel braking and lowsided.

Total repair bill $400.  ",TIFU: Drove a motorcycle for the first time today. Crashed a motorcycle for the first time today.,204
UnforseenBestiality,42,54,1m3nhp,187,"So last Saturday it was my friend birthday and he invited the boys to go out for diner at a new restaurant in town.  The service was horrible, but the wine and beer was flowing and the waitress, OH MY GOD THE WAITRESS, they were hot.  Small skirts, some with huge breast, some small, brunette, blonde, they're all pretty and in top shape.  As an almost married man in his early 30's I can't contain myself not to be aroused by those young sexy appealing girls.  My single friends are all over them and the only think I can think of all night, is to go back at my place and fuck the hell out of my girlfriend.

After a few more drinks we go to the bar to conclude the night and of course I'm still thinking about sex the whole time.  So the night goes on and we close the bar and one of my sober friend drives me home. I'm still horny as a 13 yo who just saw his first porno so I go up to my girlfriend to wake her by telling her how much I want to fuck her and she is, luckily for me, very responsive and wants to have rough sex.

We have one of those crazy sex session, it's amazing, she's screaming out of joy, it's awesome!  We both finished off, I get off her and she goes to clean herself up.  By the time she come back, I was already asleep and snoring.

We wake up the next day, and she tell me how awesome the sex was last night, but at the same time she's looking at me with this funny smile and almost laughing, and I ask her ""What's funny?"".  ""You don't remember, do you?"".  To be honest with you guys, it's not the first time after sex like that, that I fall asleep and don't remember how I actually fell asleep, so I tell her ""No?!?"".  ""Well, last night after sex, I went to clean my self up and when I came back you were laying on the bed with your erected shaft and the dog was licking the hell out of it.""... ""WHAT?!?""  I tell her that she must be fucking kidding me, but she reassure(obviously not the best choice of word here) me that it's unfortunately true.  I'm not sure what to think of it, but at least I don't remember it.

TL;DR- Dog gave me a blowjob, but at least I don't remember it.

**EDIT**: I just want to emphasis that I was deeply asleep and the dog raped me.","TIFU, but at least I don't remember it.",241
oneeyedgoat41,88,48,1g4uew,188,"To start, I had BV. I go to the doc, and she prescribes me an antibiotic by the name of ""Flagyl."" Like a responsible lady who doesn't like to post too much on /r/TIFU, I read all the instructions and look it up some more on the internet so I can understand the mechanism of action and possible side effects. I see that Flagyl sometimes causes yeast infections. Well that kinda sucks, but I guess I'll just keep an eye out for it. After I have been taking it for three days and the BV itching I had is gone (but I am not done with the course of Flagyl), and I google what a yeast infection looks like. I then proceed to spread my pussy lips and look down. I see something resembling a white film, but nothing Google-worthy. Later, my boyfriend comes over and I tell him about it. Since he obviously has a much better view than I do, I show it to him and ask him if he'd be down to have sex tonight and if he thinks I should talk to a doctor. I spread my pussy lips at him and he takes a look. Without changing his tone or expression at all, he looks back up at my face and says ""I think you should go to the doctor tomorrow, and I don't think we should have sex tonight."" I was very surprised. I even argued ""but dude, it's not bothering me, and it is just a little bit of white stuff."" He says ""I think you need a mirror or something. I think it is worse than you realize."" I use my webcam to check it out on my computer screen and immediately regret it. There is like big, thick, cottage-cheese-ish lumps filling up the lips. I have no clue how I couldn't feel it. If I saw it on Google, I would think ""*How* does anybody let it get that bad?!"" He was very nice and it didn't seem to bother him as much as it did me, but seriously, he didn't need to see that. *I* could have done without it too. Off to the doctor today :-D

**TL;DR: I ask my boyfriend if something minor was worth going to the doc over, he sees two tablespoons of white sludge.**

Update: So it was indeed yeast. Got me some drugs to fix it, and I'll take your advice and take a probiotic too + eat lots of yogurt. Also, you guys are hilarious. I have never got even a third of this much karma for anything I have ever posted before. Reddit is a strange place.",TIFU by showing my boyfriend my nasty-ass yeast infection. [NSFW],236
bloodybathroom,34,27,17ixvm,191,"This is my first time submitting a post to reddit, so bear with me as I no doubt make an arse of the formatting. I'm also warning you that this post is fucking horrible and involves not only a lot of blood where it shouldn't be, but a detailed description of my penis-cleaning procedure.  
  
I keep some baby wipes in the bathroom. They make wiping after a hefty shit a breeze, and I like to use them to give the old cock a good wipe after taking a piss. You know, for that extra minty freshness. It was 23:30. Nature called, and I answered. I pulled my skin far back for a good clean, and thought nothing of it, as it wasn't out of the ordinary for me. My cock is battle hardened — it can take some punishment.  
  
Drip.  
  
I looked down to find a nice little drop of blood about two centimetres in diameter. And then another. And then another. And they just kept coming. It was none of your watery papercut blood — this was thick and dark crimson. It meant business. I was now powering through the wipes at an alarming rate, with one hand trying to stop the flood in vain, and the other furiously wiping the floor. And it just wouldn't stop. The bleeding continued for several minutes, with my toilet looking like a really creative murder scene. The floor was still covered. My hands were a lost cause. The toilet still had some lingering blood creeping around even after several flushes.  
  
The bleeding finally slowed enough for me to get a good look at the damage. I guess I was just too harsh with my cleaning, as that little line of skin on the underside of the head was bearing a sizeable tear. I don't know how much blood I lost, but my penis was looking awfully pale by the end of the ordeal. I ended up cleaning most of the bathroom so not as to risk being discovered, before heading to bed wearing the darkest coloured boxer-briefs I could find. Bathroom-related bleeding is something you never want to share. Well, except for with the entire internet!  
  
tl;dr: I had a penis period.",TIFU by tearing my penis and bleeding all over my bathroom,218
inlover,78,67,15dnsf,190,"This woman. I swear she deserved it... no one deserves to be treated like I was at Sonic. She was angry because her burger had taken a few extra minutes, and was being rather dramatic about it. I went to take her order out and she did not seem pleased. Seeing as its the holiday season I tried to be kind, but honestly I was pissed, in my kindest voice I said ""Ma'am are you really angry you had to wait for a burger? I am waiting to find out if my brother will die of cancer... so there are worse things that you could be waiting for... here is your change.. Merry Christmas."" And I stalked off.. trying to be happy. She rang back in and told her I had given her a dollar short, and this time when I walked up she cranked her music up loud so I couldn't talk to her... I lost it.. ""YOU BITCH! I MAKE SHIT TO DEAL WITH PEOPLE LIKE YOU!"" and proceeded to flip her off and walk off. 
Today I fucked up... anyone else have any better stories? 
P.s. I know it was wrong.. I really don't need anyone in the comments telling me it was... I tried to keep my composure but right now I have been home a week from college, barely seen my family because they are at the hospital for my 16 year old brother with cancer.. (I have worked all week...), my foot is recovering from being broken recently, my house is destroyed from water damage, and I have dealt with idiots like her all week... 
edit: FORGOT TO SAY: I was fired by this ordeal... that is why it was a fuck up.",TIFU Yelled at a woman at Sonic ,257
kristafer825,31,32,11jnlm,188,"I wanted to have some relaxing lady times in a nice warm bath. So I light some candles, throw on some music and get the water running. I step in to test the temperature, when I feel myself start to slip in the bathtub. Shit i'm clumsy. Well as I'm reaching down to catch myself, my hair dangles into the flame of a candle and I see half my field of vision go up in flames. Good thing I am in water, I just reach down and throw some on my flaming hair. At this point it smells like burnt hair, a truly awful odor, despite the fact that I have about 15 scented candles around me. Anyway I am not on fire anymore so I relax a little bit and eventually lay down in the bathtub. Just as my head hits something glassy and warm I remember that there was another candle back there. There goes another flame - rinse, repeat.",TIFU by lighting myself on fire... Twice.,220
AlicetheCoon,20,31,16bvhi,189,"My Mother, who is 83, deals with technology as well as any other typical octagenerian - the shit just baffles her. I am in her kitchen and see that she has 41 messages on her voicemail. Wanting to be the good kid, I delete all the opened messages.

Mother is now screaming at me, going into ""im gonna have a stroke mode"". 

It turn out one of the voicemails was my father who passed away 3 years ago. The message was the last time he told my Mother ""I love you"".",TIFU By deleting my Mothers voicemail,220
dnld,21,42,15rp5s,187,"At work I really had to piss but the bathroom door was closed. I gently knocked and tried the knob, the door was locked.  I  waited patiently for what seemed like forever.  Then I saw another employee wandering about in a holding pattern.  Eventually, I try the ""executive"" clean roomy bathroom which is always busy, nobody was inside but the toilet was dismantled and out of order. On the way back I knock on the closed men's restroom door harder this time.  There is no answer.  So fuck it, I am on the verge of pissing myself. I assume someone locked the door when leaving, so I go to the break room for a knife with a long ass skinny blade.  I jam the knife into the crack between the door and the frame and lever the blade up and down trying to press the latch when I hear a scared and frantic ""occupied.""  I know the knife blade was poking out the other side of the door and I almost had it opened.  Embarrassed, I speed back to the break room to return the knife and dart into the women's bathroom. (I pissed myself a little.)  Apparently, the business owner's kid was in the bathroom with headphones on and didn't hear me knocking on the door.  I am now the creepy guy at work.  FML.",TIFU because I really had to piss and used a knife to try and break into a bathroom.,229
[deleted],94,45,11mnzu,186,"My roommate apparently mixed some Miracle Grow in a gallon water jug and I needed a drink of water after mowing my lawn. I chose the wrong jug.  I'm gonna go try and throw up now. If I don't make it, it's been real, folks.",TIFU by drinking Miracle Grow,231
ChronicFapperThroway,65,42,x5bis,188,"My boss (female, I'm male) walked in on me jerkin' my gherkin at work while I was trying to relieve sexual tension. We haven't made eye contact since and I don't know how I'm going to make it right, if there is a way. I envy your day, reader, as I will have a permanently red face from this encounter.

[TL;DR](http://25.media.tumblr.com/tumblr_m50lq43egj1rsnp9io1_500.gif)


UPDATE- We haven't had a spoken word since, and our only conversations have been through email so no, I haven't brought it up with her. But she's a mother, she has to understand right? *Right*?

",TIFU by masturbating in the staff bathroom and forgetting to lock the door.,230
goner78,49,29,vig71,185,"This weekend I took a trip to my girlfriend's house as a surprise since I haven't seen her in a couple of weeks.  Today started off by me getting sick after breakfast, resulting in me throwing up all the food her mom had just spent cooking.  Not the best start to a day.

After dinner, I get that feeling.  I have to take a shit.  This wasn't any normal feeling either.  I felt as though at any moment, I was going to birth a small child from my bowels.  I excuse myself to the restroom and let out the most glorious, awe-inspiring fecal matter I have ever seen.  The house already has somewhat shoddy plumbing, so I'm a bit worried, but I've gone there before, so I figure it's no big deal.

Then I flush.  It all goes down.  Relief.  I flush again, as a courtesy. Uh oh. It's clogged.  Luckily, there is a plunger directly beside the toilet.  I plunge with a fury for a good five minutes to no avail.  This sucker is clogged.  I text my girlfriend, who then informs me that the only thing she knows to do is call her father in to help.  After mustering up the courage, he comes in and, after minutes of plunging with multiple plungers, realizes the futility of the action. 

By some stroke of luck, he had what appeared to be a plumber's snake in the garage.  Unfortunately, the clog is not budging.  After 45 minutes worth of work on the sucker, it's not going anywhere.

As a result, a plumber will be making a trip to the house tomorrow morning.  We are down to one toilet for five people, and I am having poop jokes flung at me from all directions.  ",TIFU at my girlfriend's parent's house,214
[deleted],79,32,ve9t8,192,"I've changed my own oil no less than 10,000 times in the past 10 years but, for whatever reason, today I royally fucked it up. I had absolutely no transmission fluid and doubled up the oil. Engine was pouring out white smoke and the gears seized. Now I'm out $1200 for a new transmission and 1 man card, as mine has been revoked. ",TIFU by draining my transmission instead of the oil pan. ,224
saraquael,32,43,1cszk3,185,"I planted some grass seed last week and had to water it. I also bought a Pocket Hose, because although I am neither 5 nor 75 years old, I *am* a lady who does not enjoy lugging 50 pounds of garden hose around the fucking yard. Judge me. 

Anyway, I figured this would take all of 5 minutes and since the patch is close to the back door of my house, I didn't bother putting a bra on beneath my white t-shirt. You can all see where this is going, right? I attached the hose and tightly screwed my spray nozzle into place. The Pocket Hose has a lever on the end which opens the valve, which I had set to off. Precautions, man: I swear I took 'em all - except possibly the best one, which would have been not buying a hose with plastic connnections. 

I turned on the water, raised the hose, hit the lever... and the connector for the sprayer nozzle immediately rocketed off into space - BUT BEFORE IT DID, it had the comedic decency to blast a jet of freezing fucking water right across the front of my t-shirt.

Annnd at that minute, the next-door neighbor rounded the corner of his house and was met with an unobstructed view of my high beams. So that was fun.

Fuck you, Pocket Hose. Why are your connections even plastic. 

**TL;DR: wet t-shirt party in my yard, courtesy of a fucking hose I bought on television. How do you like dem nipples, Mister Neighbor?**  ",TIFU by Using a Pocket Hose,228
[deleted],32,34,1pd8z2,186,"It's almost november. (Two months into the semester)

I had nightmares about doing this.",TIFU by remembering that I was taking an online class,220
Kid0mega,102,49,1blc8q,188,"So, back when we took our PSATs a couple months ago, there was a section that let you apply for a national achievement scholarship--but you had to be black or hispanic. At the time, maybe because I thought I was funny or maybe it was a me not wanting to confine to race thing, I decided it would be a great idea to check off that I was eligible.

Jump ahead to a few months later, I get a letter! Yay! Saying I got the National Achievement Scholarship!

I am very white. I am not proud of what I have done. A lot of black people hate me now.

EDIT: Everyone thinks I'm a guy. I'm a girl. 
EDIT 2: Not the Merit Scholarship, the Achievement Scholarship. Got them mixed up in my head. Thanks to the people who pointed that out.",TIFU by getting a scholarship and being white.,237
thevinylgamer,86,45,18c0a8,188,"So apparently if you hit the random button on reddit too much, you'll get linked to r/bluewaffles. I was just looking around reddit while my dad was sitting behind me, reading a book (the subreddit has a huge picture a blue waffle that fills the page, I highly recommend you do not go to that subreddit)  My dad proceeded to cough a bunch coffee up and asked me what the hell I was doing.  So... yeah.  That sucked.",TIFU by hitting the random button on reddit too much. ,233
StuddedMohawk,73,52,wd8xt,186,"Last night I was sleeping with my ex girlfriend (We are still friends). I had a dream about my best friend, [Dingo](http://www.reddit.com/user/dingosuavez) driving my truck drunk &amp; not pulling over to let me drive no matter how many times I persisted. He eventually crashed my truck and kept gassing it head first into a wall. 


My resort was to knock him out and take control, but it was one of those dreams where your arms are really weak and you can't throw a strong punch. So I began headbutting him. Back in reality I awoke with a splitting intense pain in my skull. I had knocked my head gently into the back of my ex's head which woke her up.. when she turned around to see what was going on, I projected my head into her face with great velocity. She immediately started screaming, ""WTF!!"" and started crying.

She still has a migraine.",TIFU I headbutted my ex girlfriend in my sleep last night.,238
Sylar199,97,46,1ehbnn,183,"So, I've been unemployed for close to 2 years after leaving college, getting pretty desperate, so I take this job in a really small company. There are 4 other people there, all of which are female, making me the only guy. The night before I start I cant really sleep much, I'm really nervous, so going into work I am exhausted.

I try and resist the temptation of sleep for as long as I can, and as a result, those annoying as fuck sleepy boners come flying in, I managed to hide most of them well, looking busy at my desk, but then my manager was changing a light bulb, and me being a fairly tall gentleman, was drafted into helping her out. You can guess where this is going, cue the most awkward sleepy boner around. Luckily no one noticed.. that is until my manager backed up against me and felt it with her hip.

She takes one look down, and looks at me and says, ""I don't think this role is suitable for you."" Tells me to pack my stuff up and leave.

TIFU.

TL;DR 1st day of work, couldn't sleep, gets boners due to tiredness, boss finds out, gets fired. FML.

Should add, I'm from the UK so college to us ends at 18, or for me, 17.",TIFU Got fired on day 1 of work,229
cain179,32,39,1dn1yv,184,"I was on a lunch date earlier today with a woman I really like and she got frisky with me and decided to give me a blow-job. Near the end I got stupid and decided that obviously she wanted me to come on her face so that's what I did all porn-style (I pulled out then ""aimed"" at her face). Well some of it got in her eyes and she freaked out. I tried apologizing but she just kept calling me a bastard and wouldn't let me help her clean it off. 

She has not texted me back since then. ",TIFU by forgetting the difference between porn and reality.,223
[deleted],16,41,1cgkrk,185," I woke up still with the cold I had taken NyQuil night before. Decided I needed more medicine. Took what I thought was DayQuil (didnt look just took the pills from the bottle, had unpackaged a bunch of NyQuil and DayQuil into my pill bottle). Drove to work about an hour later and got into an accident when I fell asleep behind the wheel. Hit a guard rail. No one else hurt thank god but my car is fucked. Should have stayed home. I fucked up. ",Tifu taking NyQuil instea of DayQuil.....,226
poopypoopypoopypoopy,78,80,1qr0a6,175,"^^There ^^will ^^be ^^a ^^TLDR ^^at ^^the ^^bottom ^^^^teehee

I love my ass. It's a ton of fun to play with. You put things in, you take things out, this makes your 'me' time is so much better. As a guy, it's the only way to get in touch with your inner self and I think it's fascinating to say the least.

But today, this was the reason I was mentally preparing a makeshift will. I'm only 18 and I pretty much have nothing to do all day unless I'm working. Obviously if you have the house to yourself, you start to get creative with what you jerk to/with/how. Living at home still trying to get to school or something, I work odd hours. Today I was going to be working 1:30 to 10:00.

I felt particularly kinky today and decided that I wanted to test my colon's absorption ability.

I've gotten drunk once before, and had a beer or two maybe six other times. I clearly don't know how my body handles alcohol very well, let alone unfiltered anus liquor.

But this doesn't cross my mind. I just want to get a bit of a buzz this morning.

Warning: unfiltered ass play ahead
-------------

10:30a I have my shot of vodka in one of those tiny rum bottles and a straw.

I know my plan: create fart, insert bottle and swap fart for shot.

But things aren't perfect. The straw is tearing my asshole a new asshole. It's not that bad though, so I just tough the initial pain out and bend over on my knees and let gravity pull some air in.

Then I replace my straw for the bottle while standing and get back on my knees. Watching my reflection in our full length mirror I shove my ass almost perpendicular to the floor and both legs spread to see the view. I relax my abs and suddenly the bottle is now empty.

Wow. I feel nothing. I expected a little bit of a tingle or burn, but there's nothing. That is, until I take the bottle out. My anus seems to be the only thing that realises what a bad idea this is and screams a signal of pain on contact with the alcohol. Not cool. But whatever; I'm just gonna let the rest of it get absorbed so it won't touch my anus any more! Foolishly I want to jerk something fierce. A small shampoo thing gets to spend quality time with me. In it goes and off I get.

Unfortunately it slips out and a splash of anus burning liquid follows before I clamp shut. It burns. That's not good. ^^Oh. This probably wasn't a great idea. [I'm out.](http://cdn.chud.com/1/1f/295x221px-LL-1f759989_Jerry-Seinfeld-Leaving1.gif)

I'm getting to the toilet and feel the pressure of the leftover makeshift fart coming on. Apparently I took in more air than I thought.

Do you remember the burning of diarrhoea? Only having a shot worth of this is fantastic, because every drip leaving feels like letting satan poke my pink. Followed immediately after is a 20 second fart that feels like heaven. But all is not well in colon town. Head office has noticed a disturbance. An off balance. Some huge negative feedback loop starts the process of removing this foreign substance from my digestive tract, and starts doing some natural laxative shit to me.

Now I'm feeling waves of discomfort as my bowels rustle and shimmy shit at breakneck speeds to the throne. I'm now a hot mess of shit, vodka, and worry.

But the first wave is over and I'm feeling a little off but okay. So I lay down and rest a bit and think about what I've done.

My mind jumps to the idea of liver failure and within seconds I'm googling the symptoms. But I'm pretty much okay. I rest until I'm ready to go to work and for at least another 30 minutes I'm okay.

But the shits start again when I get to work. More gurgles and stuff make me run for the toilet every little while. I also started feeling a bit bloated, making me think that my liver was backing up and being problematic.

To make a long story shorter, a super fart after many mucusy damaged anus poops made me feel on top of the world. For the four hours there, though, I was certain I shocked my liver to failure or something.

Never doing that again.

TL;DR
---------
I like my butt so I put vodka in my butt. My butt didn't like that and shot it and everything in my poop tubes straight out. I started convincing myself that I triggered super fast acute liver failure and was just waiting for jaundice to be my tell tale doctors trip note. Let a fart out hours later and I'm not dead.",TIFU by taking a shot of vodka with my anus,255
